first_image,second_image,answers,correct_answer,rule,action
19,-22,41,1,1,0
28,34,-6,0,1,1
14,12,2,1,1,0
-14,-28,14,1,1,0
22,4,18,1,1,0
6,-5,11,1,1,0
73,38,35,1,1,0
82,43,39,1,1,0
-31,7,-38,0,1,1
-35,10,-45,0,1,1
-14,-36,22,1,1,0
-33,-8,-25,0,1,1
-16,-8,-8,0,1,1
-5,3,-8,0,0,0
-14,-1,-13,0,0,0
-29,-40,11,1,0,1
21,29,-8,0,0,0
-81,-45,-36,0,0,0
-50,-25,-25,0,0,0
11,-19,30,1,0,1
-19,-13,-6,0,0,0
-16,21,-37,0,0,0
-40,-28,-12,0,0,0
12,0,12,1,0,1
15,14,1,1,0,1
48,7,41,1,0,1
-63,-22,-41,0,0,0
-17,-38,21,1,1,0
-14,-40,26,1,1,0
46,6,40,1,1,0
21,6,15,1,1,0
-13,20,-33,0,1,1
-36,-45,9,1,1,0
-42,-29,-13,0,1,1
87,42,45,1,1,0
-61,-44,-17,0,1,1
60,20,40,1,1,0
-30,-2,-28,0,1,1
54,24,30,1,1,0
-4,25,-29,0,1,1
28,13,15,1,1,0
-5,-34,29,1,1,0
-79,-42,-37,0,1,1
-49,-32,-17,0,1,1
-20,5,-25,0,0,0
-30,-15,-15,0,0,0
31,31,0,0,0,0
-29,-28,-1,0,0,0
-49,-26,-23,0,0,0
-14,-12,-2,0,0,0
26,24,2,1,0,1
24,-18,42,1,0,1
29,-10,39,1,0,1
-33,-35,2,1,0,1
57,30,27,1,0,1
32,-1,33,1,0,1
62,36,26,1,0,1
-40,-25,-15,0,0,0
35,-10,45,1,0,1
-4,-12,8,1,0,1
-82,-40,-42,0,0,0
36,30,6,1,0,1
11,38,-27,0,0,0
-42,-41,-1,0,1,1
-6,-22,16,1,1,0
54,17,37,1,1,0
-32,13,-45,0,1,1
-16,-5,-11,0,1,1
-4,37,-41,0,1,1
-73,-41,-32,0,1,1
-16,-26,10,1,1,0
53,39,14,1,0,1
39,5,34,1,0,1
-71,-26,-45,0,0,0
14,-14,28,1,0,1
42,43,-1,0,0,0
29,2,27,1,0,1
31,23,8,1,0,1
31,41,-10,0,0,0
-52,-32,-20,0,0,0
3,30,-27,0,0,0
24,-20,44,1,0,1
-33,-14,-19,0,0,0
-44,-6,-38,0,0,0
-3,-14,11,1,0,1
24,37,-13,0,0,0
22,23,-1,0,0,0
66,29,37,1,0,1
6,-25,31,1,0,1
89,44,45,1,0,1
36,35,1,1,0,1
79,37,42,1,0,1
-41,4,-45,0,1,1
-37,-13,-24,0,1,1
-6,14,-20,0,1,1
-31,-21,-10,0,1,1
23,29,-6,0,1,1
-20,6,-26,0,1,1
-27,-5,-22,0,1,1
68,41,27,1,1,0
41,-4,45,1,1,0
-15,-15,0,0,1,1
5,-2,7,1,1,0
-65,-22,-43,0,1,1
34,9,25,1,1,0
33,5,28,1,1,0
-9,-33,24,1,1,0
20,20,0,0,1,1
42,30,12,1,1,0
-83,-38,-45,0,1,1
39,34,5,1,1,0
17,5,12,1,1,0
42,20,22,1,1,0
-20,23,-43,0,0,0
-83,-40,-43,0,0,0
-42,-26,-16,0,0,0
47,38,9,1,0,1
-28,4,-32,0,0,0
-6,30,-36,0,0,0
-55,-30,-25,0,0,0
11,16,-5,0,0,0
-5,10,-15,0,0,0
49,25,24,1,0,1
-4,-8,4,1,0,1
43,2,41,1,0,1
21,-11,32,1,0,1
1,-21,22,1,0,1
1,19,-18,0,1,1
42,0,42,1,1,0
-74,-36,-38,0,1,1
58,43,15,1,1,0
-30,-27,-3,0,1,1
-12,-27,15,1,1,0
39,43,-4,0,1,1
-16,-4,-12,0,1,1
-14,-3,-11,0,1,1
24,32,-8,0,1,1
15,-25,40,1,0,1
-14,-17,3,1,0,1
79,34,45,1,0,1
43,26,17,1,0,1
-25,-24,-1,0,0,0
-9,-10,1,1,0,1
-32,-19,-13,0,0,0
-10,-10,0,0,0,0
14,39,-25,0,0,0
-60,-16,-44,0,0,0
-52,-39,-13,0,0,0
63,19,44,1,0,1
-68,-31,-37,0,0,0
56,17,39,1,0,1
-47,-19,-28,0,0,0
3,15,-12,0,0,0
48,38,10,1,0,1
16,7,9,1,0,1
32,7,25,1,0,1
-27,-8,-19,0,0,0
-52,-19,-33,0,0,0
12,-15,27,1,1,0
52,8,44,1,1,0
25,22,3,1,1,0
66,37,29,1,1,0
-50,-28,-22,0,1,1
-8,-43,35,1,1,0
-48,-18,-30,0,1,1
-55,-41,-14,0,1,1
13,-8,21,1,1,0
77,32,45,1,1,0
-7,-13,6,1,1,0
31,8,23,1,1,0
-1,-6,5,1,0,1
-39,-9,-30,0,0,0
-56,-33,-23,0,0,0
-13,-26,13,1,0,1
44,31,13,1,0,1
-7,33,-40,0,0,0
79,41,38,1,0,1
-43,-1,-42,0,0,0
17,27,-10,0,0,0
-22,-39,17,1,1,0
-35,1,-36,0,1,1
8,40,-32,0,1,1
38,11,27,1,1,0
-50,-32,-18,0,1,1
70,42,28,1,1,0
0,-20,20,1,1,0
-68,-28,-40,0,1,1
-51,-24,-27,0,1,1
-12,-20,8,1,1,0
2,-10,12,1,1,0
48,33,15,1,1,0
6,-17,23,1,1,0
26,40,-14,0,1,1
-27,-7,-20,0,1,1
5,-29,34,1,1,0
22,-23,45,1,1,0
-21,-11,-10,0,1,1
-43,-14,-29,0,1,1
30,-4,34,1,1,0
-80,-35,-45,0,1,1
-33,-20,-13,0,0,0
26,23,3,1,0,1
-59,-26,-33,0,0,0
44,12,32,1,0,1
-13,-20,7,1,0,1
52,27,25,1,0,1
-56,-15,-41,0,0,0
-35,-1,-34,0,0,0
-28,-5,-23,0,1,1
30,35,-5,0,1,1
36,4,32,1,1,0
21,31,-10,0,1,1
-42,3,-45,0,1,1
-24,-8,-16,0,1,1
28,-13,41,1,1,0
11,-26,37,1,1,0
-23,5,-28,0,1,1
-14,12,-26,0,1,1
52,23,29,1,1,0
29,-11,40,1,1,0
-47,-12,-35,0,1,1
56,22,34,1,1,0
4,41,-37,0,1,1
-45,-33,-12,0,1,1
25,-1,26,1,0,1
-17,9,-26,0,0,0
40,36,4,1,0,1
-17,21,-38,0,0,0
-14,-12,-2,0,0,0
15,37,-22,0,0,0
-26,12,-38,0,0,0
-83,-44,-39,0,0,0
-27,-20,-7,0,0,0
-15,-22,7,1,0,1
12,36,-24,0,0,0
8,4,4,1,0,1
-64,-37,-27,0,0,0
15,-12,27,1,0,1
-61,-43,-18,0,0,0
19,9,10,1,0,1
46,33,13,1,1,0
10,12,-2,0,1,1
27,17,10,1,1,0
6,25,-19,0,1,1
-14,-12,-2,0,1,1
34,21,13,1,1,0
-24,-14,-10,0,1,1
43,9,34,1,1,0
28,34,-6,0,0,0
24,28,-4,0,0,0
-64,-35,-29,0,0,0
-43,-26,-17,0,0,0
-51,-23,-28,0,0,0
19,-11,30,1,0,1
-85,-41,-44,0,0,0
57,23,34,1,0,1
-47,-31,-16,0,0,0
-42,-22,-20,0,0,0
62,22,40,1,0,1
-35,-18,-17,0,0,0
-37,-11,-26,0,0,0
-8,-34,26,1,0,1
24,30,-6,0,1,1
-12,27,-39,0,1,1
28,19,9,1,1,0
87,42,45,1,1,0
23,-2,25,1,1,0
-4,-35,31,1,1,0
74,40,34,1,1,0
12,28,-16,0,1,1
29,9,20,1,1,0
-5,-39,34,1,1,0
33,26,7,1,1,0
18,38,-20,0,1,1
-33,-37,4,1,1,0
30,13,17,1,1,0
24,10,14,1,1,0
37,22,15,1,1,0
-58,-43,-15,0,1,1
-4,26,-30,0,1,1
25,24,1,1,1,0
-8,-30,22,1,1,0
-36,7,-43,0,0,0
9,11,-2,0,0,0
-69,-30,-39,0,0,0
60,18,42,1,0,1
-48,-10,-38,0,0,0
26,-18,44,1,0,1
-43,-2,-41,0,0,0
-34,11,-45,0,0,0
-3,39,-42,0,0,0
-12,9,-21,0,0,0
34,42,-8,0,0,0
-9,-24,15,1,0,1
-22,-12,-10,0,0,0
-18,-7,-11,0,0,0
-49,-43,-6,0,0,0
48,19,29,1,0,1
78,34,44,1,0,1
38,31,7,1,0,1
-12,-1,-11,0,0,0
-68,-31,-37,0,0,0
-25,9,-34,0,0,0
36,26,10,1,1,0
12,33,-21,0,1,1
43,19,24,1,1,0
30,2,28,1,1,0
-9,-34,25,1,1,0
-1,-10,9,1,1,0
-23,-33,10,1,1,0
24,34,-10,0,1,1
-2,-8,6,1,1,0
12,-12,24,1,1,0
76,40,36,1,1,0
45,31,14,1,1,0
-11,-33,22,1,1,0
54,30,24,1,1,0
45,37,8,1,1,0
15,15,0,0,1,1
-48,-42,-6,0,1,1
5,10,-5,0,1,1
12,-13,25,1,1,0
-32,-31,-1,0,1,1
-60,-19,-41,0,1,1
1,-40,41,1,0,1
-2,-19,17,1,0,1
43,9,34,1,0,1
9,42,-33,0,0,0
-45,-17,-28,0,0,0
18,-3,21,1,0,1
18,37,-19,0,0,0
24,38,-14,0,0,0
19,-6,25,1,0,1
-34,-11,-23,0,0,0
34,16,18,1,0,1
61,30,31,1,0,1
-15,30,-45,0,0,0
-15,28,-43,0,0,0
-73,-41,-32,0,0,0
-4,-32,28,1,0,1
-10,-28,18,1,1,0
-29,13,-42,0,1,1
36,15,21,1,1,0
-42,-33,-9,0,1,1
78,37,41,1,1,0
-79,-39,-40,0,1,1
46,44,2,1,1,0
-78,-39,-39,0,1,1
-42,-24,-18,0,1,1
28,-6,34,1,1,0
15,37,-22,0,1,1
6,32,-26,0,1,1
-23,-16,-7,0,1,1
59,39,20,1,1,0
28,17,11,1,1,0
-50,-31,-19,0,1,1
-19,-22,3,1,0,1
61,37,24,1,0,1
-12,-37,25,1,0,1
-13,-39,26,1,0,1
-29,-17,-12,0,0,0
-58,-32,-26,0,0,0
-9,-13,4,1,0,1
-14,-45,31,1,0,1
1,-10,11,1,0,1
-27,-31,4,1,0,1
5,-40,45,1,0,1
36,34,2,1,1,0
-53,-42,-11,0,1,1
-8,26,-34,0,1,1
-55,-22,-33,0,1,1
10,26,-16,0,1,1
19,12,7,1,1,0
23,15,8,1,1,0
3,0,3,1,1,0
-16,15,-31,0,1,1
-12,27,-39,0,1,1
1,0,1,1,1,0
75,38,37,1,1,0
-4,-31,27,1,1,0
63,44,19,1,1,0
18,-19,37,1,1,0
41,12,29,1,0,1
5,25,-20,0,0,0
57,22,35,1,0,1
15,-24,39,1,0,1
48,22,26,1,0,1
14,-23,37,1,0,1
24,33,-9,0,0,0
-34,-1,-33,0,0,0
-6,11,-17,0,0,0
2,-10,12,1,0,1
-42,-23,-19,0,0,0
57,35,22,1,0,1
52,42,10,1,0,1
17,44,-27,0,0,0
18,41,-23,0,0,0
-17,-8,-9,0,0,0
33,-11,44,1,0,1
5,-3,8,1,0,1
-38,-8,-30,0,0,0
-8,31,-39,0,0,0
-13,-3,-10,0,0,0
5,1,4,1,1,0
-13,9,-22,0,1,1
53,36,17,1,1,0
-23,-23,0,0,1,1
-15,-27,12,1,1,0
-18,-6,-12,0,1,1
6,9,-3,0,1,1
2,-13,15,1,1,0
-66,-40,-26,0,1,1
-14,-16,2,1,1,0
-1,-17,16,1,1,0
-16,8,-24,0,1,1
-3,-45,42,1,1,0
19,41,-22,0,1,1
-13,-43,30,1,1,0
-47,-19,-28,0,1,1
17,2,15,1,1,0
-57,-22,-35,0,1,1
0,19,-19,0,1,1
57,43,14,1,1,0
48,26,22,1,1,0
28,23,5,1,0,1
20,-2,22,1,0,1
0,-2,2,1,0,1
-31,-37,6,1,0,1
-17,-26,9,1,0,1
-47,-21,-26,0,0,0
-9,-10,1,1,0,1
-33,9,-42,0,0,0
-22,-28,6,1,0,1
35,39,-4,0,0,0
29,25,4,1,0,1
-43,-27,-16,0,1,1
34,16,18,1,1,0
-42,-2,-40,0,1,1
5,-31,36,1,1,0
-41,-27,-14,0,1,1
52,39,13,1,1,0
9,-31,40,1,1,0
-78,-37,-41,0,1,1
-20,0,-20,0,1,1
-8,-23,15,1,1,0
38,19,19,1,1,0
-18,10,-28,0,1,1
-32,-19,-13,0,1,1
-61,-27,-34,0,0,0
77,39,38,1,0,1
-30,-28,-2,0,0,0
15,-15,30,1,0,1
0,-4,4,1,0,1
16,2,14,1,0,1
-21,12,-33,0,0,0
-81,-42,-39,0,0,0
-16,-10,-6,0,0,0
-3,20,-23,0,0,0
-2,-42,40,1,0,1
-41,-41,0,0,0,0
66,30,36,1,0,1
37,42,-5,0,0,0
4,-12,16,1,0,1
-9,10,-19,0,0,0
-2,4,-6,0,1,1
-21,8,-29,0,1,1
-35,-25,-10,0,1,1
44,37,7,1,1,0
9,41,-32,0,1,1
19,6,13,1,1,0
11,-31,42,1,1,0
2,2,0,0,1,1
18,-26,44,1,1,0
-73,-35,-38,0,1,1
32,21,11,1,1,0
6,-17,23,1,1,0
23,42,-19,0,1,1
50,24,26,1,1,0
-6,18,-24,0,0,0
8,23,-15,0,0,0
18,34,-16,0,0,0
19,-13,32,1,0,1
15,6,9,1,0,1
-33,10,-43,0,0,0
-43,-16,-27,0,0,0
-2,-45,43,1,0,1
-42,-8,-34,0,0,0
-21,18,-39,0,0,0
-35,-45,10,1,0,1
-72,-32,-40,0,0,0
36,24,12,1,0,1
38,6,32,1,0,1
-74,-42,-32,0,0,0
-38,-16,-22,0,0,0
-30,-23,-7,0,0,0
3,-24,27,1,0,1
-68,-30,-38,0,0,0
12,12,0,0,0,0
-4,-35,31,1,0,1
13,-9,22,1,1,0
25,0,25,1,1,0
27,-2,29,1,1,0
-2,-1,-1,0,1,1
35,-9,44,1,1,0
38,34,4,1,1,0
-10,-43,33,1,1,0
75,44,31,1,1,0
28,6,22,1,1,0
-4,23,-27,0,1,1
16,13,3,1,1,0
51,44,7,1,1,0
-8,-20,12,1,1,0
3,-24,27,1,1,0
32,26,6,1,1,0
53,8,45,1,1,0
-11,9,-20,0,1,1
-74,-30,-44,0,1,1
-5,-18,13,1,1,0
-32,7,-39,0,1,1
-53,-22,-31,0,0,0
10,-7,17,1,0,1
-26,-4,-22,0,0,0
10,14,-4,0,0,0
-5,-13,8,1,0,1
55,36,19,1,0,1
-32,-33,1,1,0,1
2,40,-38,0,0,0
12,-3,15,1,0,1
-8,-2,-6,0,0,0
23,-13,36,1,0,1
21,-17,38,1,0,1
-5,6,-11,0,0,0
3,-4,7,1,0,1
-32,10,-42,0,0,0
45,7,38,1,1,0
-72,-43,-29,0,1,1
10,44,-34,0,1,1
-16,-44,28,1,1,0
62,41,21,1,1,0
10,10,0,0,1,1
-15,10,-25,0,1,1
42,22,20,1,1,0
-36,-28,-8,0,1,1
-23,-6,-17,0,1,1
17,-23,40,1,1,0
-54,-33,-21,0,1,1
53,25,28,1,1,0
33,-7,40,1,1,0
3,3,0,0,0,0
87,44,43,1,0,1
17,-3,20,1,0,1
-27,8,-35,0,0,0
-8,-36,28,1,0,1
20,3,17,1,0,1
-9,-31,22,1,0,1
-2,18,-20,0,0,0
-25,-16,-9,0,0,0
75,37,38,1,0,1
36,-9,45,1,0,1
-19,21,-40,0,0,0
-49,-33,-16,0,0,0
-51,-34,-17,0,0,0
-8,-17,9,1,0,1
-52,-34,-18,0,1,1
-42,-37,-5,0,1,1
-41,4,-45,0,1,1
26,-14,40,1,1,0
-82,-37,-45,0,1,1
16,10,6,1,1,0
-47,-20,-27,0,1,1
31,16,15,1,1,0
15,23,-8,0,1,1
26,-1,27,1,0,1
30,20,10,1,0,1
-74,-34,-40,0,0,0
25,30,-5,0,0,0
-13,-2,-11,0,0,0
51,26,25,1,0,1
66,30,36,1,0,1
22,12,10,1,0,1
7,36,-29,0,0,0
-2,-35,33,1,0,1
-24,-15,-9,0,0,0
54,38,16,1,0,1
63,28,35,1,0,1
74,36,38,1,0,1
-39,-16,-23,0,0,0
-3,-3,0,0,0,0
-27,-38,11,1,0,1
11,1,10,1,0,1
-18,-30,12,1,0,1
-33,-1,-32,0,0,0
19,-21,40,1,0,1
40,42,-2,0,1,1
-7,-2,-5,0,1,1
-38,-6,-32,0,1,1
-59,-21,-38,0,1,1
58,42,16,1,1,0
50,25,25,1,1,0
28,27,1,1,1,0
-2,18,-20,0,1,1
-44,-25,-19,0,1,1
78,40,38,1,1,0
1,30,-29,0,1,1
-28,12,-40,0,0,0
-9,-17,8,1,0,1
12,40,-28,0,0,0
37,28,9,1,0,1
-17,19,-36,0,0,0
80,43,37,1,0,1
44,27,17,1,0,1
-62,-18,-44,0,0,0
20,22,-2,0,0,0
0,36,-36,0,0,0
-48,-42,-6,0,0,0
-41,-42,1,1,0,1
-57,-28,-29,0,0,0
-5,13,-18,0,0,0
16,9,7,1,0,1
21,39,-18,0,0,0
25,1,24,1,0,1
-16,27,-43,0,0,0
-1,17,-18,0,0,0
81,44,37,1,0,1
81,44,37,1,0,1
23,11,12,1,1,0
53,28,25,1,1,0
-51,-10,-41,0,1,1
-60,-33,-27,0,1,1
0,35,-35,0,1,1
40,39,1,1,1,0
-5,17,-22,0,1,1
60,27,33,1,1,0
76,44,32,1,1,0
41,23,18,1,1,0
81,43,38,1,1,0
-53,-36,-17,0,1,1
3,-21,24,1,1,0
14,-19,33,1,0,1
21,25,-4,0,0,0
32,18,14,1,0,1
38,29,9,1,0,1
-24,-9,-15,0,0,0
-1,-35,34,1,0,1
4,-23,27,1,0,1
17,41,-24,0,0,0
1,-22,23,1,0,1
-6,-17,11,1,1,0
69,44,25,1,1,0
-71,-28,-43,0,1,1
-58,-44,-14,0,1,1
39,7,32,1,1,0
-40,-7,-33,0,1,1
6,13,-7,0,1,1
-20,13,-33,0,1,1
-55,-10,-45,0,1,1
-50,-5,-45,0,1,1
-1,-24,23,1,1,0
-12,31,-43,0,1,1
64,21,43,1,1,0
-35,-41,6,1,1,0
-49,-29,-20,0,1,1
15,-22,37,1,1,0
30,19,11,1,1,0
-11,5,-16,0,1,1
-56,-26,-30,0,1,1
-8,17,-25,0,1,1
6,7,-1,0,1,1
-4,34,-38,0,0,0
33,9,24,1,0,1
-42,-22,-20,0,0,0
-37,-23,-14,0,0,0
85,41,44,1,0,1
-61,-30,-31,0,0,0
-4,-21,17,1,0,1
-20,8,-28,0,0,0
28,8,20,1,0,1
20,24,-4,0,0,0
42,37,5,1,0,1
31,1,30,1,0,1
-6,-18,12,1,0,1
13,28,-15,0,0,0
-40,-42,2,1,0,1
43,7,36,1,0,1
1,-36,37,1,0,1
-38,-32,-6,0,0,0
-16,-27,11,1,0,1
6,-8,14,1,0,1
21,14,7,1,0,1
16,32,-16,0,1,1
-16,21,-37,0,1,1
-46,-37,-9,0,1,1
-24,-41,17,1,1,0
-7,19,-26,0,1,1
-17,18,-35,0,1,1
49,22,27,1,1,0
43,38,5,1,1,0
0,-12,12,1,1,0
-24,10,-34,0,1,1
-9,-21,12,1,0,1
-9,22,-31,0,0,0
24,-15,39,1,0,1
-5,23,-28,0,0,0
17,13,4,1,0,1
13,-23,36,1,0,1
-52,-8,-44,0,0,0
-1,-44,43,1,0,1
-13,19,-32,0,0,0
55,20,35,1,0,1
29,-4,33,1,1,0
-6,-34,28,1,1,0
16,27,-11,0,1,1
41,1,40,1,1,0
-60,-28,-32,0,1,1
-14,-34,20,1,1,0
41,26,15,1,1,0
-35,7,-42,0,1,1
56,17,39,1,1,0
-40,-31,-9,0,1,1
41,31,10,1,1,0
12,6,6,1,1,0
85,40,45,1,1,0
-20,-2,-18,0,1,1
-17,28,-45,0,1,1
49,10,39,1,1,0
41,6,35,1,1,0
33,0,33,1,1,0
-2,-25,23,1,1,0
-39,-26,-13,0,1,1
32,12,20,1,0,1
-56,-22,-34,0,0,0
-53,-34,-19,0,0,0
-52,-43,-9,0,0,0
2,-21,23,1,0,1
3,8,-5,0,0,0
-10,-24,14,1,0,1
-53,-42,-11,0,0,0
-25,14,-39,0,0,0
-29,-33,4,1,0,1
57,30,27,1,0,1
70,33,37,1,0,1
27,16,11,1,0,1
12,5,7,1,0,1
4,20,-16,0,0,0
57,31,26,1,0,1
13,18,-5,0,1,1
33,44,-11,0,1,1
-22,-38,16,1,1,0
-84,-40,-44,0,1,1
57,38,19,1,1,0
35,26,9,1,1,0
11,-6,17,1,1,0
-56,-30,-26,0,1,1
-12,5,-17,0,1,1
-28,-32,4,1,1,0
7,44,-37,0,1,1
-38,3,-41,0,1,1
-11,5,-16,0,1,1
18,41,-23,0,1,1
4,-6,10,1,1,0
-46,-36,-10,0,1,1
51,28,23,1,1,0
-17,-40,23,1,1,0
-46,-32,-14,0,1,1
-16,-12,-4,0,1,1
-1,0,-1,0,1,1
-2,24,-26,0,0,0
3,-16,19,1,0,1
8,19,-11,0,0,0
-20,-7,-13,0,0,0
6,-19,25,1,0,1
70,39,31,1,0,1
42,23,19,1,0,1
-8,-29,21,1,0,1
45,6,39,1,0,1
79,38,41,1,0,1
-24,-9,-15,0,0,0
-66,-44,-22,0,0,0
36,-8,44,1,0,1
64,25,39,1,0,1
14,-25,39,1,0,1
-36,-22,-14,0,0,0
14,23,-9,0,0,0
-50,-15,-35,0,0,0
25,8,17,1,0,1
50,19,31,1,0,1
5,33,-28,0,0,0
-12,-30,18,1,1,0
-80,-36,-44,0,1,1
-10,10,-20,0,1,1
8,32,-24,0,1,1
-25,-43,18,1,1,0
-57,-20,-37,0,1,1
-24,-37,13,1,1,0
55,31,24,1,1,0
41,7,34,1,1,0
-79,-40,-39,0,1,1
80,39,41,1,1,0
10,13,-3,0,1,1
60,36,24,1,1,0
5,-37,42,1,1,0
-31,6,-37,0,1,1
-31,-9,-22,0,1,1
-31,-19,-12,0,1,1
-26,14,-40,0,1,1
-10,-30,20,1,1,0
5,-19,24,1,1,0
-9,34,-43,0,1,1
-3,-23,20,1,0,1
-18,16,-34,0,0,0
44,4,40,1,0,1
32,-3,35,1,0,1
-16,-10,-6,0,0,0
-36,-26,-10,0,0,0
-9,25,-34,0,0,0
-88,-45,-43,0,0,0
9,31,-22,0,0,0
25,4,21,1,0,1
8,-10,18,1,0,1
-2,1,-3,0,0,0
-34,-42,8,1,0,1
-44,-13,-31,0,0,0
14,-28,42,1,0,1
-33,-20,-13,0,0,0
72,33,39,1,0,1
-6,-31,25,1,0,1
51,27,24,1,0,1
17,-1,18,1,0,1
1,-21,22,1,0,1
-18,-4,-14,0,1,1
-16,-8,-8,0,1,1
42,26,16,1,1,0
-36,4,-40,0,1,1
-50,-45,-5,0,1,1
-58,-15,-43,0,1,1
-14,-6,-8,0,1,1
13,9,4,1,1,0
-4,34,-38,0,1,1
-48,-34,-14,0,1,1
32,32,0,0,1,1
23,39,-16,0,1,1
-44,-31,-13,0,0,0
-58,-39,-19,0,0,0
23,29,-6,0,0,0
-75,-38,-37,0,0,0
31,-2,33,1,0,1
-74,-34,-40,0,0,0
-1,-11,10,1,0,1
7,3,4,1,0,1
4,36,-32,0,0,0
-79,-36,-43,0,0,0
22,19,3,1,0,1
-10,-43,33,1,0,1
-5,14,-19,0,0,0
-52,-41,-11,0,0,0
-58,-22,-36,0,0,0
-3,40,-43,0,0,0
31,40,-9,0,0,0
44,3,41,1,0,1
-16,9,-25,0,0,0
-31,3,-34,0,0,0
39,5,34,1,0,1
-56,-22,-34,0,1,1
74,37,37,1,1,0
15,-19,34,1,1,0
-16,-28,12,1,1,0
-7,37,-44,0,1,1
-4,7,-11,0,1,1
4,3,1,1,1,0
-5,13,-18,0,1,1
20,-3,23,1,1,0
22,31,-9,0,1,1
-33,-13,-20,0,1,1
42,25,17,1,1,0
10,-17,27,1,1,0
27,-16,43,1,1,0
10,17,-7,0,1,1
47,10,37,1,1,0
10,2,8,1,1,0
6,25,-19,0,1,1
-8,30,-38,0,1,1
8,29,-21,0,1,1
0,-32,32,1,1,0
-17,-29,12,1,0,1
-8,18,-26,0,0,0
29,-3,32,1,0,1
34,20,14,1,0,1
-21,-29,8,1,0,1
0,-26,26,1,0,1
59,24,35,1,0,1
56,41,15,1,0,1
-62,-37,-25,0,1,1
77,41,36,1,1,0
5,2,3,1,1,0
-57,-41,-16,0,1,1
81,42,39,1,1,0
-42,-40,-2,0,1,1
-22,-31,9,1,1,0
4,-41,45,1,1,0
15,1,14,1,1,0
69,33,36,1,1,0
75,31,44,1,1,0
29,31,-2,0,1,1
-20,10,-30,0,1,1
-28,-28,0,0,0,0
38,38,0,0,0,0
-25,0,-25,0,0,0
37,21,16,1,0,1
-17,10,-27,0,0,0
32,12,20,1,0,1
38,38,0,0,0,0
-54,-29,-25,0,0,0
5,-16,21,1,0,1
2,-13,15,1,0,1
16,41,-25,0,0,0
-11,-14,3,1,0,1
48,36,12,1,0,1
-32,-24,-8,0,0,0
-16,-19,3,1,0,1
28,0,28,1,0,1
45,15,30,1,0,1
-32,-10,-22,0,0,0
26,-1,27,1,0,1
-10,-26,16,1,0,1
-34,-32,-2,0,0,0
70,29,41,1,1,0
-4,-38,34,1,1,0
13,-11,24,1,1,0
4,-6,10,1,1,0
-8,-31,23,1,1,0
-18,16,-34,0,1,1
20,2,18,1,1,0
-22,8,-30,0,1,1
30,-13,43,1,1,0
64,37,27,1,1,0
66,22,44,1,1,0
-23,-22,-1,0,1,1
15,36,-21,0,1,1
48,39,9,1,1,0
22,39,-17,0,1,1
11,-19,30,1,0,1
23,-4,27,1,0,1
6,23,-17,0,0,0
-21,-5,-16,0,0,0
-37,6,-43,0,0,0
65,43,22,1,0,1
5,-37,42,1,0,1
76,32,44,1,0,1
45,33,12,1,0,1
-23,9,-32,0,0,0
52,23,29,1,0,1
-2,1,-3,0,1,1
-61,-27,-34,0,1,1
31,11,20,1,1,0
13,-12,25,1,1,0
-11,24,-35,0,1,1
18,-15,33,1,1,0
-39,-27,-12,0,1,1
-42,-13,-29,0,1,1
-29,10,-39,0,1,1
32,-2,34,1,1,0
-56,-26,-30,0,1,1
-54,-10,-44,0,1,1
76,41,35,1,1,0
-48,-4,-44,0,1,1
-38,-18,-20,0,1,1
3,15,-12,0,1,1
-44,-9,-35,0,1,1
-34,3,-37,0,1,1
8,-5,13,1,1,0
1,-15,16,1,1,0
-54,-28,-26,0,1,1
2,26,-24,0,0,0
21,31,-10,0,0,0
-9,-34,25,1,0,1
12,-15,27,1,0,1
9,24,-15,0,0,0
46,36,10,1,0,1
69,27,42,1,0,1
-19,5,-24,0,0,0
-31,14,-45,0,0,0
1,43,-42,0,0,0
37,36,1,1,0,1
5,-37,42,1,0,1
52,24,28,1,0,1
-8,10,-18,0,0,0
2,15,-13,0,0,0
-78,-34,-44,0,0,0
32,41,-9,0,0,0
0,13,-13,0,0,0
-24,1,-25,0,0,0
-11,-43,32,1,0,1
-19,-2,-17,0,0,0
19,7,12,1,1,0
20,33,-13,0,1,1
-60,-32,-28,0,1,1
-36,-25,-11,0,1,1
21,2,19,1,1,0
-45,-9,-36,0,1,1
-1,30,-31,0,1,1
30,6,24,1,1,0
-47,-9,-38,0,1,1
-73,-40,-33,0,1,1
-68,-45,-23,0,1,1
54,28,26,1,1,0
41,-3,44,1,1,0
-37,-10,-27,0,1,1
4,4,0,0,1,1
49,28,21,1,1,0
-68,-28,-40,0,1,1
23,-9,32,1,0,1
6,32,-26,0,0,0
-32,-16,-16,0,0,0
-72,-35,-37,0,0,0
-55,-16,-39,0,0,0
15,-4,19,1,0,1
18,17,1,1,0,1
22,-2,24,1,0,1
74,42,32,1,0,1
-1,7,-8,0,0,0
-6,-22,16,1,1,0
8,-16,24,1,1,0
4,-22,26,1,1,0
21,13,8,1,1,0
3,0,3,1,1,0
28,-7,35,1,1,0
42,2,40,1,1,0
-5,24,-29,0,1,1
3,-28,31,1,0,1
-15,-38,23,1,0,1
33,26,7,1,0,1
37,-8,45,1,0,1
16,-13,29,1,0,1
-3,-34,31,1,0,1
22,29,-7,0,0,0
-32,9,-41,0,0,0
26,2,24,1,0,1
15,-7,22,1,0,1
44,33,11,1,0,1
10,15,-5,0,0,0
-4,12,-16,0,0,0
-31,-12,-19,0,0,0
25,6,19,1,0,1
-6,-18,12,1,0,1
74,31,43,1,0,1
-27,-6,-21,0,0,0
73,39,34,1,0,1
36,18,18,1,0,1
-59,-21,-38,0,0,0
73,40,33,1,1,0
-58,-45,-13,0,1,1
-31,-22,-9,0,1,1
22,41,-19,0,1,1
7,22,-15,0,1,1
-24,-31,7,1,1,0
14,34,-20,0,1,1
-65,-45,-20,0,1,1
-1,-1,0,0,1,1
32,30,2,1,1,0
69,34,35,1,1,0
42,39,3,1,0,1
41,26,15,1,0,1
3,-1,4,1,0,1
44,4,40,1,0,1
61,30,31,1,0,1
35,32,3,1,0,1
-19,-8,-11,0,0,0
30,-2,32,1,0,1
36,42,-6,0,0,0
0,33,-33,0,0,0
12,-2,14,1,0,1
-3,11,-14,0,0,0
12,-14,26,1,0,1
28,9,19,1,0,1
-42,-35,-7,0,0,0
19,8,11,1,0,1
6,14,-8,0,0,0
-19,-3,-16,0,0,0
36,4,32,1,0,1
52,23,29,1,0,1
-14,3,-17,0,0,0
21,25,-4,0,1,1
-38,-31,-7,0,1,1
17,-6,23,1,1,0
8,-12,20,1,1,0
87,42,45,1,1,0
-4,5,-9,0,1,1
-36,-8,-28,0,1,1
-15,30,-45,0,1,1
33,35,-2,0,1,1
-52,-32,-20,0,0,0
21,7,14,1,0,1
21,1,20,1,0,1
-18,-31,13,1,0,1
-3,-42,39,1,0,1
5,17,-12,0,0,0
-6,-3,-3,0,0,0
-2,-15,13,1,0,1
-24,-21,-3,0,1,1
9,42,-33,0,1,1
55,29,26,1,1,0
15,23,-8,0,1,1
48,34,14,1,1,0
20,28,-8,0,1,1
-4,36,-40,0,1,1
31,31,0,0,1,1
38,26,12,1,1,0
9,-21,30,1,1,0
30,44,-14,0,1,1
-12,24,-36,0,1,1
38,28,10,1,1,0
15,18,-3,0,1,1
-29,-19,-10,0,1,1
-49,-45,-4,0,1,1
24,26,-2,0,1,1
7,32,-25,0,1,1
28,-4,32,1,1,0
-66,-33,-33,0,1,1
10,33,-23,0,1,1
13,-11,24,1,0,1
-53,-33,-20,0,0,0
-39,-15,-24,0,0,0
-76,-40,-36,0,0,0
45,22,23,1,0,1
-37,-31,-6,0,0,0
-12,-32,20,1,0,1
-7,-38,31,1,0,1
-45,-4,-41,0,1,1
22,-12,34,1,1,0
8,-25,33,1,1,0
2,23,-21,0,1,1
0,6,-6,0,1,1
60,34,26,1,1,0
-26,15,-41,0,1,1
32,-9,41,1,1,0
-75,-44,-31,0,1,1
-47,-11,-36,0,1,1
41,8,33,1,1,0
-2,-44,42,1,1,0
-57,-36,-21,0,1,1
59,20,39,1,1,0
49,8,41,1,1,0
22,-11,33,1,1,0
-28,-42,14,1,1,0
60,36,24,1,1,0
-51,-12,-39,0,1,1
-26,-11,-15,0,1,1
8,-23,31,1,1,0
-13,-16,3,1,0,1
-26,6,-32,0,0,0
-86,-44,-42,0,0,0
-7,20,-27,0,0,0
17,-11,28,1,0,1
20,16,4,1,0,1
-66,-38,-28,0,0,0
2,29,-27,0,0,0
47,19,28,1,0,1
-68,-45,-23,0,0,0
13,-19,32,1,0,1
-10,-25,15,1,0,1
85,44,41,1,0,1
-1,34,-35,0,0,0
-85,-44,-41,0,0,0
-5,14,-19,0,0,0
-16,-10,-6,0,0,0
19,5,14,1,1,0
14,13,1,1,1,0
-82,-41,-41,0,1,1
2,-17,19,1,1,0
-33,-20,-13,0,1,1
-23,-35,12,1,1,0
-51,-11,-40,0,1,1
39,19,20,1,1,0
-52,-39,-13,0,1,1
-1,14,-15,0,0,0
-75,-39,-36,0,0,0
-74,-37,-37,0,0,0
87,44,43,1,0,1
23,-5,28,1,0,1
48,42,6,1,0,1
-39,-36,-3,0,0,0
-12,-43,31,1,0,1
-3,-29,26,1,1,0
-7,-30,23,1,1,0
-4,4,-8,0,1,1
68,31,37,1,1,0
-27,16,-43,0,1,1
52,13,39,1,1,0
-53,-14,-39,0,1,1
-19,-35,16,1,1,0
35,2,33,1,1,0
-70,-30,-40,0,1,1
53,18,35,1,1,0
51,9,42,1,1,0
66,33,33,1,1,0
49,20,29,1,1,0
66,42,24,1,1,0
-14,17,-31,0,1,1
-33,-12,-21,0,1,1
-10,-32,22,1,0,1
3,2,1,1,0,1
10,-23,33,1,0,1
6,-30,36,1,0,1
-35,-30,-5,0,0,0
-48,-18,-30,0,0,0
24,38,-14,0,0,0
-61,-22,-39,0,0,0
60,42,18,1,0,1
-47,-16,-31,0,0,0
-2,43,-45,0,0,0
-11,-15,4,1,0,1
-17,4,-21,0,0,0
1,-37,38,1,1,0
-12,-37,25,1,1,0
-33,-26,-7,0,1,1
-24,-28,4,1,1,0
-19,-8,-11,0,1,1
40,12,28,1,1,0
-80,-38,-42,0,1,1
30,-8,38,1,1,0
21,38,-17,0,1,1
22,42,-20,0,1,1
-9,18,-27,0,1,1
8,29,-21,0,1,1
-1,42,-43,0,1,1
-80,-45,-35,0,1,1
12,-1,13,1,1,0
17,-11,28,1,1,0
-64,-37,-27,0,1,1
-53,-15,-38,0,1,1
-42,-45,3,1,1,0
-7,-5,-2,0,1,1
6,-15,21,1,1,0
70,39,31,1,0,1
-33,-39,6,1,0,1
25,24,1,1,0,1
21,7,14,1,0,1
-19,-15,-4,0,0,0
-34,-14,-20,0,0,0
46,40,6,1,0,1
-43,-35,-8,0,0,0
-3,-9,6,1,0,1
25,43,-18,0,0,0
20,2,18,1,1,0
18,21,-3,0,1,1
-43,-23,-20,0,1,1
-65,-44,-21,0,1,1
-44,-20,-24,0,1,1
-27,8,-35,0,1,1
51,11,40,1,1,0
-85,-44,-41,0,1,1
15,44,-29,0,1,1
18,-8,26,1,1,0
0,-37,37,1,1,0
45,26,19,1,1,0
-67,-23,-44,0,1,1
6,-12,18,1,1,0
-26,-44,18,1,1,0
-24,-28,4,1,1,0
5,43,-38,0,0,0
22,5,17,1,0,1
32,40,-8,0,0,0
-8,-29,21,1,0,1
-6,29,-35,0,0,0
-62,-18,-44,0,0,0
-48,-15,-33,0,0,0
27,0,27,1,0,1
-41,-30,-11,0,0,0
23,32,-9,0,0,0
10,29,-19,0,0,0
-5,40,-45,0,0,0
-58,-16,-42,0,1,1
-50,-38,-12,0,1,1
-16,-39,23,1,1,0
-46,-7,-39,0,1,1
-24,2,-26,0,1,1
37,-7,44,1,1,0
-3,-45,42,1,1,0
-22,12,-34,0,1,1
81,44,37,1,1,0
31,30,1,1,1,0
-6,2,-8,0,1,1
-57,-21,-36,0,1,1
21,11,10,1,0,1
-15,20,-35,0,0,0
-45,-2,-43,0,0,0
11,-14,25,1,0,1
18,-14,32,1,0,1
27,-3,30,1,0,1
-87,-42,-45,0,0,0
-7,32,-39,0,0,0
5,-3,8,1,0,1
-18,16,-34,0,0,0
-49,-34,-15,0,0,0
14,-15,29,1,0,1
48,8,40,1,0,1
53,13,40,1,0,1
-69,-37,-32,0,0,0
1,-23,24,1,0,1
-3,11,-14,0,0,0
-14,15,-29,0,0,0
36,10,26,1,0,1
-5,35,-40,0,1,1
-43,-3,-40,0,1,1
17,11,6,1,1,0
4,2,2,1,1,0
46,22,24,1,1,0
1,-35,36,1,1,0
-62,-45,-17,0,1,1
-8,21,-29,0,1,1
-51,-39,-12,0,1,1
5,35,-30,0,1,1
5,41,-36,0,0,0
-73,-45,-28,0,0,0
47,30,17,1,0,1
7,37,-30,0,0,0
79,44,35,1,0,1
-9,20,-29,0,0,0
33,9,24,1,0,1
-30,7,-37,0,0,0
-49,-16,-33,0,0,0
-56,-40,-16,0,0,0
-30,-4,-26,0,0,0
-18,-9,-9,0,0,0
-31,-41,10,1,0,1
33,43,-10,0,0,0
48,32,16,1,0,1
51,17,34,1,0,1
-81,-41,-40,0,1,1
-1,-34,33,1,1,0
23,30,-7,0,1,1
20,-24,44,1,1,0
-47,-41,-6,0,1,1
-6,-38,32,1,1,0
28,38,-10,0,1,1
-71,-35,-36,0,1,1
41,8,33,1,1,0
-54,-25,-29,0,1,1
51,10,41,1,1,0
-60,-45,-15,0,1,1
2,-8,10,1,1,0
3,33,-30,0,1,1
12,-25,37,1,1,0
77,34,43,1,1,0
-22,-15,-7,0,1,1
-49,-32,-17,0,1,1
20,-4,24,1,1,0
48,39,9,1,1,0
41,31,10,1,1,0
6,11,-5,0,0,0
-26,10,-36,0,0,0
8,15,-7,0,0,0
9,16,-7,0,0,0
21,8,13,1,0,1
7,15,-8,0,0,0
-30,2,-32,0,0,0
-30,-37,7,1,0,1
-32,3,-35,0,0,0
-59,-15,-44,0,0,0
57,13,44,1,0,1
-32,-25,-7,0,0,0
25,27,-2,0,0,0
9,32,-23,0,1,1
-19,3,-22,0,1,1
-49,-41,-8,0,1,1
25,41,-16,0,1,1
-2,-39,37,1,1,0
32,29,3,1,1,0
5,-21,26,1,1,0
-53,-32,-21,0,1,1
-58,-40,-18,0,0,0
-40,-8,-32,0,0,0
-20,-12,-8,0,0,0
-37,2,-39,0,0,0
45,39,6,1,0,1
34,-1,35,1,0,1
-5,-26,21,1,0,1
-51,-36,-15,0,0,0
-26,-12,-14,0,0,0
-5,38,-43,0,0,0
41,29,12,1,0,1
-32,10,-42,0,0,0
88,44,44,1,0,1
60,42,18,1,0,1
44,40,4,1,0,1
-17,-43,26,1,0,1
-6,31,-37,0,0,0
-27,-15,-12,0,0,0
60,29,31,1,0,1
61,39,22,1,0,1
-27,2,-29,0,0,0
-28,8,-36,0,1,1
14,-21,35,1,1,0
26,-1,27,1,1,0
2,40,-38,0,1,1
-39,-18,-21,0,1,1
66,40,26,1,1,0
11,8,3,1,1,0
52,18,34,1,1,0
20,15,5,1,1,0
-25,-44,19,1,1,0
14,32,-18,0,1,1
-16,-39,23,1,0,1
-8,37,-45,0,0,0
31,11,20,1,0,1
35,27,8,1,0,1
24,16,8,1,0,1
34,22,12,1,0,1
-86,-45,-41,0,0,0
-78,-40,-38,0,0,0
23,-2,25,1,0,1
0,-45,45,1,0,1
72,44,28,1,0,1
-75,-42,-33,0,0,0
-42,-19,-23,0,0,0
4,19,-15,0,0,0
8,-4,12,1,0,1
3,-11,14,1,0,1
-63,-20,-43,0,0,0
-19,3,-22,0,0,0
-2,23,-25,0,0,0
38,-7,45,1,0,1
-11,-42,31,1,0,1
-23,-10,-13,0,1,1
-45,-28,-17,0,1,1
-3,-42,39,1,1,0
-16,27,-43,0,1,1
58,13,45,1,1,0
68,28,40,1,1,0
38,1,37,1,1,0
34,21,13,1,1,0
-20,-40,20,1,1,0
26,10,16,1,1,0
79,36,43,1,1,0
39,14,25,1,1,0
39,41,-2,0,1,1
56,27,29,1,1,0
-6,26,-32,0,1,1
36,43,-7,0,1,1
-74,-42,-32,0,1,1
7,12,-5,0,1,1
-34,-23,-11,0,0,0
-12,18,-30,0,0,0
-34,-13,-21,0,0,0
7,8,-1,0,0,0
20,28,-8,0,0,0
46,15,31,1,0,1
53,11,42,1,0,1
-27,-34,7,1,0,1
-64,-44,-20,0,0,0
58,23,35,1,1,0
76,32,44,1,1,0
25,-15,40,1,1,0
-26,7,-33,0,1,1
14,-26,40,1,1,0
-14,-15,1,1,1,0
-58,-25,-33,0,1,1
-16,20,-36,0,1,1
1,-19,20,1,1,0
-26,-9,-17,0,1,1
-63,-45,-18,0,0,0
15,12,3,1,0,1
5,-12,17,1,0,1
34,38,-4,0,0,0
-67,-27,-40,0,0,0
27,-17,44,1,0,1
2,-43,45,1,0,1
22,29,-7,0,0,0
62,32,30,1,0,1
40,32,8,1,0,1
77,41,36,1,0,1
28,16,12,1,0,1
-13,-19,6,1,0,1
7,44,-37,0,1,1
-6,-22,16,1,1,0
-10,23,-33,0,1,1
-23,-28,5,1,1,0
-26,5,-31,0,1,1
43,13,30,1,1,0
11,40,-29,0,1,1
-40,3,-43,0,1,1
-29,10,-39,0,1,1
-31,7,-38,0,1,1
-8,-32,24,1,1,0
65,43,22,1,0,1
63,19,44,1,0,1
61,19,42,1,0,1
83,43,40,1,0,1
-11,-34,23,1,0,1
-47,-22,-25,0,0,0
-22,-30,8,1,0,1
-3,18,-21,0,0,0
-41,-28,-13,0,0,0
44,18,26,1,0,1
3,-25,28,1,1,0
-28,-41,13,1,1,0
-48,-42,-6,0,1,1
1,-4,5,1,1,0
42,27,15,1,1,0
11,-10,21,1,1,0
43,24,19,1,1,0
66,44,22,1,1,0
4,3,1,1,1,0
-20,2,-22,0,1,1
-64,-33,-31,0,1,1
-21,15,-36,0,0,0
-47,-19,-28,0,0,0
1,-24,25,1,0,1
-18,-7,-11,0,0,0
-50,-10,-40,0,0,0
0,-30,30,1,0,1
-45,-2,-43,0,0,0
-13,19,-32,0,0,0
-29,6,-35,0,0,0
41,26,15,1,0,1
24,23,1,1,0,1
10,-11,21,1,0,1
36,11,25,1,0,1
39,16,23,1,0,1
-32,-15,-17,0,0,0
4,41,-37,0,0,0
59,39,20,1,0,1
-73,-31,-42,0,0,0
48,41,7,1,0,1
69,28,41,1,0,1
-6,34,-40,0,0,0
57,14,43,1,1,0
-56,-38,-18,0,1,1
-27,-30,3,1,1,0
9,27,-18,0,1,1
-3,-5,2,1,1,0
16,-13,29,1,1,0
79,34,45,1,1,0
-51,-22,-29,0,1,1
-1,-32,31,1,0,1
31,30,1,1,0,1
-3,-5,2,1,0,1
-28,1,-29,0,0,0
0,-6,6,1,0,1
30,43,-13,0,0,0
11,14,-3,0,0,0
1,7,-6,0,0,0
-19,-7,-12,0,0,0
-34,-24,-10,0,0,0
-7,29,-36,0,0,0
-40,-22,-18,0,0,0
-30,-29,-1,0,0,0
45,17,28,1,0,1
11,38,-27,0,0,0
-84,-44,-40,0,0,0
29,22,7,1,0,1
3,-35,38,1,0,1
8,42,-34,0,0,0
16,10,6,1,0,1
16,-20,36,1,0,1
74,35,39,1,1,0
47,11,36,1,1,0
-54,-41,-13,0,1,1
23,18,5,1,1,0
27,29,-2,0,1,1
-39,-45,6,1,1,0
15,17,-2,0,1,1
-2,33,-35,0,1,1
15,39,-24,0,1,1
23,44,-21,0,1,1
47,7,40,1,1,0
-32,-37,5,1,1,0
12,36,-24,0,1,1
19,30,-11,0,0,0
37,-4,41,1,0,1
-18,-39,21,1,0,1
39,3,36,1,0,1
-7,-20,13,1,0,1
75,42,33,1,0,1
-54,-26,-28,0,0,0
54,32,22,1,0,1
-27,4,-31,0,0,0
10,34,-24,0,1,1
-59,-41,-18,0,1,1
-11,-20,9,1,1,0
-55,-36,-19,0,1,1
8,12,-4,0,1,1
-59,-31,-28,0,1,1
-58,-33,-25,0,1,1
-63,-19,-44,0,1,1
16,32,-16,0,1,1
58,35,23,1,1,0
-55,-37,-18,0,1,1
24,20,4,1,0,1
2,-26,28,1,0,1
26,-16,42,1,0,1
23,43,-20,0,0,0
-59,-34,-25,0,0,0
-40,-26,-14,0,0,0
4,11,-7,0,0,0
29,29,0,0,0,0
0,4,-4,0,0,0
-39,-3,-36,0,0,0
18,33,-15,0,0,0
-24,-13,-11,0,0,0
23,-1,24,1,0,1
10,32,-22,0,0,0
-34,-43,9,1,0,1
-35,-20,-15,0,0,0
-37,-39,2,1,0,1
15,-27,42,1,0,1
-48,-34,-14,0,1,1
-20,-4,-16,0,1,1
12,-4,16,1,1,0
-38,-25,-13,0,1,1
59,25,34,1,1,0
-52,-33,-19,0,1,1
33,19,14,1,1,0
-12,10,-22,0,1,1
9,-12,21,1,1,0
7,-28,35,1,1,0
-21,22,-43,0,1,1
-11,-22,11,1,1,0
-3,35,-38,0,1,1
-11,28,-39,0,1,1
6,23,-17,0,1,1
-39,-39,0,0,1,1
-11,-27,16,1,1,0
-22,21,-43,0,1,1
-15,0,-15,0,1,1
-57,-15,-42,0,1,1
-16,-23,7,1,0,1
-1,30,-31,0,0,0
12,40,-28,0,0,0
43,11,32,1,0,1
-65,-38,-27,0,0,0
-18,-41,23,1,0,1
17,14,3,1,0,1
-17,-44,27,1,0,1
22,11,11,1,1,0
20,-12,32,1,1,0
36,40,-4,0,1,1
8,6,2,1,1,0
-1,11,-12,0,1,1
18,-24,42,1,1,0
-1,-5,4,1,1,0
13,-16,29,1,1,0
-34,-9,-25,0,1,1
-8,-16,8,1,1,0
62,28,34,1,1,0
0,-14,14,1,1,0
-28,13,-41,0,1,1
-63,-33,-30,0,0,0
15,-18,33,1,0,1
-15,-23,8,1,0,1
12,-8,20,1,0,1
38,41,-3,0,0,0
-13,12,-25,0,0,0
0,-43,43,1,0,1
-45,-26,-19,0,0,0
61,31,30,1,0,1
29,17,12,1,0,1
-36,-32,-4,0,0,0
-52,-10,-42,0,0,0
42,40,2,1,0,1
-2,42,-44,0,0,0
-68,-28,-40,0,0,0
7,26,-19,0,0,0
-1,-18,17,1,0,1
38,16,22,1,0,1
18,-26,44,1,0,1
-19,-26,7,1,1,0
62,26,36,1,1,0
-10,-20,10,1,1,0
-42,-28,-14,0,1,1
-24,-42,18,1,1,0
-20,-19,-1,0,1,1
-76,-31,-45,0,1,1
63,20,43,1,1,0
-33,0,-33,0,1,1
-33,-4,-29,0,1,1
-14,-36,22,1,1,0
44,7,37,1,1,0
70,37,33,1,1,0
-7,-20,13,1,1,0
-5,36,-41,0,1,1
-58,-29,-29,0,1,1
21,28,-7,0,1,1
-11,34,-45,0,1,1
55,15,40,1,1,0
5,29,-24,0,1,1
44,43,1,1,0,1
51,16,35,1,0,1
24,6,18,1,0,1
-72,-36,-36,0,0,0
-27,-30,3,1,0,1
0,10,-10,0,0,0
14,-23,37,1,0,1
61,40,21,1,0,1
-60,-45,-15,0,0,0
10,28,-18,0,0,0
-31,-27,-4,0,0,0
-46,-33,-13,0,0,0
7,-20,27,1,0,1
28,42,-14,0,0,0
35,26,9,1,0,1
-47,-3,-44,0,0,0
-50,-15,-35,0,1,1
-21,-12,-9,0,1,1
-43,-30,-13,0,1,1
8,-12,20,1,1,0
6,-16,22,1,1,0
14,-18,32,1,1,0
48,17,31,1,1,0
2,33,-31,0,1,1
10,4,6,1,0,1
-44,-11,-33,0,0,0
-66,-39,-27,0,0,0
8,-29,37,1,0,1
21,-7,28,1,0,1
-69,-31,-38,0,0,0
-7,-9,2,1,0,1
6,41,-35,0,0,0
-20,22,-42,0,1,1
-51,-34,-17,0,1,1
30,29,1,1,1,0
22,1,21,1,1,0
-40,-2,-38,0,1,1
40,41,-1,0,1,1
38,4,34,1,1,0
8,-11,19,1,1,0
62,35,27,1,1,0
29,26,3,1,0,1
16,22,-6,0,0,0
40,24,16,1,0,1
16,44,-28,0,0,0
32,39,-7,0,0,0
42,33,9,1,0,1
45,29,16,1,0,1
30,8,22,1,0,1
-31,-34,3,1,0,1
64,30,34,1,0,1
18,-12,30,1,0,1
34,39,-5,0,1,1
52,19,33,1,1,0
-8,-38,30,1,1,0
-15,-32,17,1,1,0
-34,-10,-24,0,1,1
-57,-23,-34,0,1,1
-50,-32,-18,0,1,1
1,3,-2,0,1,1
-1,0,-1,0,1,1
-7,-9,2,1,1,0
-12,10,-22,0,1,1
-50,-7,-43,0,1,1
3,34,-31,0,1,1
-38,-16,-22,0,1,1
-44,-26,-18,0,1,1
-43,-6,-37,0,1,1
61,38,23,1,1,0
-76,-37,-39,0,1,1
68,38,30,1,1,0
32,43,-11,0,0,0
-43,-39,-4,0,0,0
-14,-2,-12,0,0,0
29,36,-7,0,0,0
-46,-27,-19,0,0,0
-48,-45,-3,0,0,0
35,16,19,1,0,1
12,-2,14,1,0,1
-38,-32,-6,0,1,1
-29,-21,-8,0,1,1
81,42,39,1,1,0
-8,7,-15,0,1,1
36,3,33,1,1,0
-2,-4,2,1,1,0
-34,-19,-15,0,1,1
-21,-28,7,1,1,0
-1,-6,5,1,1,0
-21,-19,-2,0,1,1
14,-31,45,1,1,0
36,-9,45,1,1,0
67,24,43,1,1,0
-76,-38,-38,0,1,1
2,15,-13,0,1,1
52,34,18,1,1,0
-13,-13,0,0,1,1
42,6,36,1,1,0
-86,-42,-44,0,1,1
-38,-38,0,0,1,1
34,40,-6,0,1,1
8,31,-23,0,0,0
3,-17,20,1,0,1
12,-25,37,1,0,1
36,17,19,1,0,1
-28,7,-35,0,0,0
-30,-2,-28,0,0,0
42,2,40,1,0,1
-37,-11,-26,0,0,0
-19,6,-25,0,0,0
19,-25,44,1,0,1
50,38,12,1,0,1
24,29,-5,0,0,0
-30,2,-32,0,0,0
-21,16,-37,0,0,0
-12,-44,32,1,0,1
-10,-2,-8,0,0,0
-39,-42,3,1,0,1
19,34,-15,0,0,0
10,26,-16,0,1,1
-11,30,-41,0,1,1
20,-4,24,1,1,0
38,14,24,1,1,0
4,14,-10,0,1,1
20,1,19,1,1,0
-21,4,-25,0,1,1
-19,-7,-12,0,1,1
40,0,40,1,0,1
-10,11,-21,0,0,0
46,12,34,1,0,1
-40,2,-42,0,0,0
45,43,2,1,0,1
41,36,5,1,0,1
-35,-41,6,1,0,1
14,29,-15,0,0,0
31,-10,41,1,0,1
48,13,35,1,0,1
-56,-13,-43,0,0,0
-40,2,-42,0,0,0
41,0,41,1,0,1
-16,8,-24,0,0,0
15,23,-8,0,0,0
-49,-5,-44,0,0,0
56,30,26,1,0,1
-55,-11,-44,0,0,0
16,-7,23,1,0,1
-68,-40,-28,0,0,0
-27,10,-37,0,0,0
-66,-38,-28,0,1,1
16,-24,40,1,1,0
46,16,30,1,1,0
-10,2,-12,0,1,1
5,27,-22,0,1,1
-33,-4,-29,0,1,1
-54,-14,-40,0,1,1
18,22,-4,0,1,1
41,26,15,1,1,0
-64,-43,-21,0,1,1
-62,-22,-40,0,1,1
2,31,-29,0,1,1
67,27,40,1,1,0
1,-20,21,1,1,0
-3,-26,23,1,1,0
31,11,20,1,1,0
-4,0,-4,0,1,1
-13,-30,17,1,1,0
-38,-12,-26,0,1,1
-49,-36,-13,0,1,1
16,-27,43,1,1,0
-2,17,-19,0,0,0
82,37,45,1,0,1
-40,-45,5,1,0,1
56,38,18,1,0,1
24,23,1,1,0,1
-53,-44,-9,0,0,0
38,15,23,1,0,1
20,1,19,1,0,1
-81,-44,-37,0,0,0
-3,-41,38,1,0,1
21,44,-23,0,1,1
-4,40,-44,0,1,1
63,43,20,1,1,0
-40,-45,5,1,1,0
51,38,13,1,1,0
24,-12,36,1,1,0
-28,-43,15,1,1,0
1,38,-37,0,1,1
-48,-24,-24,0,1,1
72,42,30,1,1,0
58,15,43,1,1,0
-6,26,-32,0,1,1
61,28,33,1,1,0
5,10,-5,0,1,1
23,-14,37,1,1,0
45,14,31,1,1,0
21,-22,43,1,1,0
51,18,33,1,1,0
7,33,-26,0,1,1
61,27,34,1,1,0
3,-6,9,1,1,0
-75,-42,-33,0,0,0
-10,-6,-4,0,0,0
82,44,38,1,0,1
-57,-40,-17,0,0,0
9,-5,14,1,0,1
45,16,29,1,0,1
11,25,-14,0,0,0
23,43,-20,0,0,0
-5,-5,0,0,0,0
-10,22,-32,0,0,0
-7,-18,11,1,0,1
34,39,-5,0,0,0
4,-2,6,1,0,1
23,18,5,1,0,1
-29,16,-45,0,0,0
41,31,10,1,0,1
-29,-19,-10,0,0,0
-1,26,-27,0,0,0
-11,-39,28,1,0,1
-23,8,-31,0,0,0
-47,-34,-13,0,0,0
31,33,-2,0,1,1
-8,-5,-3,0,1,1
-14,-40,26,1,1,0
73,32,41,1,1,0
-45,-15,-30,0,1,1
-17,-34,17,1,1,0
17,-4,21,1,1,0
39,40,-1,0,1,1
74,41,33,1,1,0
-34,6,-40,0,1,1
15,40,-25,0,1,1
-57,-17,-40,0,1,1
4,41,-37,0,1,1
-51,-17,-34,0,1,1
-48,-20,-28,0,1,1
17,23,-6,0,1,1
-1,23,-24,0,1,1
-3,25,-28,0,1,1
-82,-38,-44,0,1,1
55,19,36,1,0,1
31,25,6,1,0,1
87,44,43,1,0,1
59,21,38,1,0,1
-28,-45,17,1,0,1
-74,-36,-38,0,0,0
16,43,-27,0,0,0
-4,21,-25,0,0,0
-3,-7,4,1,1,0
-35,-3,-32,0,1,1
-23,1,-24,0,1,1
61,17,44,1,1,0
37,33,4,1,1,0
-37,7,-44,0,1,1
-23,-24,1,1,1,0
-28,-15,-13,0,1,1
-32,-20,-12,0,1,1
4,-6,10,1,0,1
-14,22,-36,0,0,0
-34,-8,-26,0,0,0
21,35,-14,0,0,0
-29,-29,0,0,0,0
-55,-37,-18,0,0,0
32,19,13,1,0,1
0,17,-17,0,0,0
-32,-40,8,1,0,1
-47,-22,-25,0,1,1
4,33,-29,0,1,1
3,25,-22,0,1,1
60,22,38,1,1,0
17,44,-27,0,1,1
-72,-45,-27,0,1,1
-22,-37,15,1,1,0
46,8,38,1,1,0
-78,-33,-45,0,1,1
-21,-20,-1,0,0,0
7,-29,36,1,0,1
15,19,-4,0,0,0
-16,-37,21,1,0,1
-72,-30,-42,0,0,0
-13,-11,-2,0,0,0
-23,-1,-22,0,0,0
-15,5,-20,0,0,0
51,24,27,1,0,1
-10,8,-18,0,0,0
17,19,-2,0,0,0
24,44,-20,0,0,0
-52,-18,-34,0,0,0
-37,-43,6,1,0,1
53,21,32,1,0,1
50,31,19,1,0,1
16,-1,17,1,0,1
-65,-31,-34,0,0,0
26,23,3,1,0,1
-4,33,-37,0,0,0
-64,-19,-45,0,0,0
48,18,30,1,1,0
58,13,45,1,1,0
15,-30,45,1,1,0
-7,38,-45,0,1,1
86,43,43,1,1,0
4,-15,19,1,1,0
46,37,9,1,1,0
0,-14,14,1,1,0
4,24,-20,0,1,1
-21,-32,11,1,1,0
12,42,-30,0,1,1
41,35,6,1,1,0
-27,-43,16,1,1,0
-58,-35,-23,0,1,1
-13,-26,13,1,1,0
-19,-36,17,1,1,0
0,37,-37,0,1,1
-57,-30,-27,0,1,1
-12,24,-36,0,1,1
38,24,14,1,1,0
-35,7,-42,0,1,1
-46,-18,-28,0,0,0
7,15,-8,0,0,0
-70,-27,-43,0,0,0
-10,-43,33,1,0,1
-20,-10,-10,0,0,0
34,3,31,1,0,1
-3,24,-27,0,0,0
-46,-4,-42,0,0,0
-25,-17,-8,0,0,0
23,44,-21,0,0,0
-1,31,-32,0,0,0
-10,15,-25,0,0,0
-57,-34,-23,0,0,0
-34,-27,-7,0,0,0
-25,-44,19,1,0,1
46,16,30,1,0,1
-72,-35,-37,0,0,0
-17,-19,2,1,0,1
-28,-3,-25,0,0,0
26,21,5,1,0,1
19,9,10,1,0,1
1,39,-38,0,1,1
-39,-34,-5,0,1,1
32,20,12,1,1,0
27,43,-16,0,1,1
-31,-3,-28,0,1,1
5,4,1,1,1,0
-42,-11,-31,0,1,1
-43,-36,-7,0,1,1
61,40,21,1,1,0
-35,-13,-22,0,1,1
30,44,-14,0,0,0
-30,-11,-19,0,0,0
-6,-27,21,1,0,1
-13,-43,30,1,0,1
55,35,20,1,0,1
-6,35,-41,0,0,0
-28,-35,7,1,0,1
66,26,40,1,0,1
-83,-38,-45,0,0,0
-50,-5,-45,0,0,0
39,12,27,1,0,1
33,14,19,1,0,1
8,-30,38,1,0,1
27,23,4,1,0,1
-18,-43,25,1,0,1
-11,-22,11,1,0,1
-30,-12,-18,0,0,0
73,42,31,1,0,1
-82,-40,-42,0,0,0
65,42,23,1,0,1
-29,-32,3,1,0,1
-8,-5,-3,0,1,1
56,33,23,1,1,0
17,-14,31,1,1,0
-19,25,-44,0,1,1
-23,2,-25,0,1,1
5,-36,41,1,1,0
-75,-45,-30,0,1,1
-6,33,-39,0,1,1
2,24,-22,0,0,0
27,16,11,1,0,1
30,-5,35,1,0,1
-80,-36,-44,0,0,0
-2,-32,30,1,0,1
69,29,40,1,0,1
-33,-1,-32,0,0,0
-69,-34,-35,0,0,0
30,17,13,1,0,1
-70,-38,-32,0,1,1
-21,-23,2,1,1,0
-5,32,-37,0,1,1
-6,29,-35,0,1,1
9,-9,18,1,1,0
11,-3,14,1,1,0
-51,-37,-14,0,1,1
14,28,-14,0,1,1
-13,12,-25,0,1,1
48,40,8,1,1,0
26,33,-7,0,1,1
-37,-12,-25,0,1,1
-20,-26,6,1,0,1
30,9,21,1,0,1
12,-30,42,1,0,1
-4,-8,4,1,0,1
72,44,28,1,0,1
-14,-35,21,1,0,1
-34,-12,-22,0,0,0
22,-6,28,1,0,1
29,24,5,1,0,1
-25,-31,6,1,0,1
-39,-13,-26,0,0,0
-45,-40,-5,0,0,0
-4,-39,35,1,0,1
-54,-37,-17,0,0,0
38,42,-4,0,0,0
56,43,13,1,0,1
-3,-26,23,1,0,1
-28,-21,-7,0,0,0
1,7,-6,0,0,0
-19,-14,-5,0,0,0
-52,-39,-13,0,0,0
28,14,14,1,1,0
3,8,-5,0,1,1
-13,10,-23,0,1,1
22,23,-1,0,1,1
18,8,10,1,1,0
-15,-3,-12,0,1,1
-42,-6,-36,0,1,1
-76,-41,-35,0,1,1
59,29,30,1,1,0
22,2,20,1,0,1
-34,-12,-22,0,0,0
-32,-39,7,1,0,1
-42,0,-42,0,0,0
-82,-39,-43,0,0,0
26,14,12,1,0,1
27,-4,31,1,0,1
22,-6,28,1,0,1
-55,-13,-42,0,0,0
-28,-29,1,1,0,1
-6,11,-17,0,0,0
47,2,45,1,0,1
-70,-43,-27,0,0,0
-24,-39,15,1,1,0
59,14,45,1,1,0
-2,-21,19,1,1,0
67,44,23,1,1,0
-59,-24,-35,0,1,1
-64,-35,-29,0,1,1
-15,-2,-13,0,1,1
42,-3,45,1,1,0
-1,-32,31,1,1,0
11,-15,26,1,0,1
8,30,-22,0,0,0
-16,-4,-12,0,0,0
17,34,-17,0,0,0
10,34,-24,0,0,0
-11,-31,20,1,0,1
-41,-35,-6,0,0,0
32,33,-1,0,0,0
-8,25,-33,0,0,0
15,2,13,1,0,1
-48,-29,-19,0,0,0
-1,22,-23,0,0,0
17,17,0,0,0,0
-1,24,-25,0,0,0
-49,-8,-41,0,0,0
-27,-1,-26,0,0,0
16,18,-2,0,0,0
-13,1,-14,0,0,0
43,1,42,1,1,0
-39,-22,-17,0,1,1
-40,-13,-27,0,1,1
-42,-11,-31,0,1,1
48,3,45,1,1,0
-35,2,-37,0,1,1
-48,-34,-14,0,1,1
3,-2,5,1,1,0
23,-13,36,1,0,1
-3,-15,12,1,0,1
3,-23,26,1,0,1
3,5,-2,0,0,0
-50,-19,-31,0,0,0
12,2,10,1,0,1
-41,-25,-16,0,0,0
51,8,43,1,0,1
45,19,26,1,0,1
17,3,14,1,0,1
-3,4,-7,0,0,0
15,-10,25,1,0,1
27,32,-5,0,0,0
10,5,5,1,0,1
23,20,3,1,0,1
44,33,11,1,0,1
-26,3,-29,0,0,0
25,32,-7,0,1,1
4,15,-11,0,1,1
81,41,40,1,1,0
81,44,37,1,1,0
72,42,30,1,1,0
-34,-14,-20,0,1,1
47,42,5,1,1,0
6,-11,17,1,1,0
36,-7,43,1,0,1
-24,-31,7,1,0,1
49,36,13,1,0,1
-43,-33,-10,0,0,0
-32,-41,9,1,0,1
-24,17,-41,0,0,0
-43,-27,-16,0,0,0
34,36,-2,0,0,0
-27,-21,-6,0,1,1
-1,-41,40,1,1,0
-57,-31,-26,0,1,1
78,33,45,1,1,0
44,9,35,1,1,0
-4,-15,11,1,1,0
-58,-35,-23,0,1,1
-15,-42,27,1,1,0
22,9,13,1,1,0
5,1,4,1,1,0
-52,-40,-12,0,1,1
45,43,2,1,1,0
-29,1,-30,0,1,1
76,38,38,1,1,0
-43,1,-44,0,1,1
-21,-30,9,1,0,1
-19,-4,-15,0,0,0
-17,14,-31,0,0,0
-11,15,-26,0,0,0
32,16,16,1,0,1
30,8,22,1,0,1
-4,33,-37,0,0,0
-43,-31,-12,0,0,0
-11,31,-42,0,0,0
-24,-1,-23,0,0,0
-51,-11,-40,0,0,0
-55,-31,-24,0,0,0
-25,-16,-9,0,0,0
-40,-12,-28,0,0,0
15,9,6,1,0,1
10,36,-26,0,1,1
60,34,26,1,1,0
17,22,-5,0,1,1
9,40,-31,0,1,1
13,18,-5,0,1,1
-7,-4,-3,0,1,1
-59,-45,-14,0,1,1
61,18,43,1,1,0
1,-23,24,1,1,0
-19,2,-21,0,1,1
39,19,20,1,1,0
-31,-17,-14,0,1,1
-11,-6,-5,0,1,1
55,24,31,1,1,0
-53,-15,-38,0,1,1
-60,-33,-27,0,1,1
41,6,35,1,1,0
2,33,-31,0,1,1
15,22,-7,0,1,1
-13,-10,-3,0,1,1
-1,-40,39,1,1,0
-28,-33,5,1,0,1
10,-10,20,1,0,1
-78,-43,-35,0,0,0
-27,-11,-16,0,0,0
74,42,32,1,0,1
26,-7,33,1,0,1
24,-7,31,1,0,1
7,-3,10,1,0,1
33,8,25,1,0,1
47,41,6,1,0,1
8,-1,9,1,0,1
2,-37,39,1,1,0
18,30,-12,0,1,1
-24,-35,11,1,1,0
46,19,27,1,1,0
-18,6,-24,0,1,1
-45,-2,-43,0,1,1
-34,2,-36,0,1,1
1,18,-17,0,1,1
10,3,7,1,1,0
53,39,14,1,0,1
23,16,7,1,0,1
-12,15,-27,0,0,0
32,10,22,1,0,1
23,10,13,1,0,1
-35,-31,-4,0,0,0
43,31,12,1,0,1
2,-11,13,1,0,1
-49,-35,-14,0,0,0
-32,9,-41,0,0,0
-6,4,-10,0,0,0
40,39,1,1,0,1
34,23,11,1,0,1
-11,-44,33,1,0,1
-22,-26,4,1,0,1
-19,-7,-12,0,0,0
-47,-31,-16,0,0,0
39,0,39,1,0,1
-37,-3,-34,0,0,0
-34,-37,3,1,0,1
42,26,16,1,0,1
15,-29,44,1,1,0
27,-16,43,1,1,0
16,-27,43,1,1,0
-7,20,-27,0,1,1
21,43,-22,0,1,1
-32,-41,9,1,1,0
25,-12,37,1,1,0
13,37,-24,0,1,1
67,39,28,1,1,0
-60,-23,-37,0,1,1
23,-22,45,1,1,0
26,5,21,1,0,1
7,-24,31,1,0,1
-46,-14,-32,0,0,0
-10,-22,12,1,0,1
-44,-4,-40,0,0,0
-32,-3,-29,0,0,0
-50,-31,-19,0,0,0
-29,-1,-28,0,0,0
61,35,26,1,0,1
10,-28,38,1,0,1
-28,-27,-1,0,1,1
36,12,24,1,1,0
32,27,5,1,1,0
-43,-42,-1,0,1,1
-49,-38,-11,0,1,1
-21,-36,15,1,1,0
-24,-26,2,1,1,0
32,39,-7,0,1,1
3,22,-19,0,1,1
-42,1,-43,0,1,1
43,22,21,1,1,0
-28,-43,15,1,1,0
-63,-25,-38,0,1,1
62,29,33,1,1,0
32,31,1,1,1,0
-3,17,-20,0,1,1
-9,31,-40,0,1,1
80,42,38,1,1,0
-69,-45,-24,0,1,1
5,4,1,1,1,0
3,34,-31,0,1,1
-24,11,-35,0,0,0
-40,-20,-20,0,0,0
35,40,-5,0,0,0
-52,-10,-42,0,0,0
5,-30,35,1,0,1
16,-3,19,1,0,1
-5,13,-18,0,0,0
-45,-44,-1,0,0,0
44,17,27,1,0,1
11,-29,40,1,0,1
-28,-24,-4,0,0,0
-9,-35,26,1,0,1
2,-18,20,1,0,1
31,11,20,1,0,1
53,28,25,1,0,1
49,23,26,1,0,1
-82,-44,-38,0,0,0
24,11,13,1,0,1
40,24,16,1,0,1
12,5,7,1,0,1
3,7,-4,0,0,0
-67,-39,-28,0,1,1
36,9,27,1,1,0
-8,-39,31,1,1,0
-5,-18,13,1,1,0
-27,-8,-19,0,1,1
14,-15,29,1,1,0
57,41,16,1,1,0
-7,-2,-5,0,1,1
-51,-23,-28,0,1,1
-2,-40,38,1,1,0
0,-21,21,1,1,0
51,13,38,1,1,0
5,-8,13,1,1,0
-62,-19,-43,0,1,1
-20,-10,-10,0,1,1
73,33,40,1,0,1
-22,11,-33,0,0,0
7,11,-4,0,0,0
44,31,13,1,0,1
22,43,-21,0,0,0
-3,1,-4,0,0,0
-9,-30,21,1,0,1
-7,-12,5,1,0,1
29,-4,33,1,0,1
54,19,35,1,0,1
-53,-37,-16,0,0,0
13,-9,22,1,0,1
18,29,-11,0,1,1
-32,7,-39,0,1,1
45,17,28,1,1,0
-62,-39,-23,0,1,1
-48,-11,-37,0,1,1
-34,-28,-6,0,1,1
2,-3,5,1,1,0
9,-1,10,1,1,0
79,40,39,1,1,0
-26,2,-28,0,1,1
3,-2,5,1,1,0
-21,19,-40,0,1,1
39,-4,43,1,1,0
33,-12,45,1,1,0
-74,-35,-39,0,1,1
-6,11,-17,0,1,1
-1,11,-12,0,1,1
23,-22,45,1,0,1
-22,-14,-8,0,0,0
-12,8,-20,0,0,0
5,5,0,0,0,0
-42,-28,-14,0,0,0
-24,-18,-6,0,0,0
-24,-40,16,1,0,1
-31,-45,14,1,0,1
7,1,6,1,1,0
-38,-8,-30,0,1,1
36,38,-2,0,1,1
25,-10,35,1,1,0
7,17,-10,0,1,1
-13,16,-29,0,1,1
-28,-29,1,1,1,0
-35,-13,-22,0,1,1
-11,-42,31,1,1,0
-5,-39,34,1,1,0
-8,11,-19,0,1,1
24,-2,26,1,1,0
33,35,-2,0,1,1
-7,-12,5,1,1,0
39,7,32,1,1,0
5,3,2,1,1,0
54,29,25,1,1,0
16,22,-6,0,1,1
-31,-15,-16,0,1,1
-46,-4,-42,0,0,0
-6,-41,35,1,0,1
35,28,7,1,0,1
18,-18,36,1,0,1
-18,18,-36,0,0,0
-5,29,-34,0,0,0
42,36,6,1,0,1
37,22,15,1,0,1
-7,-32,25,1,0,1
4,4,0,0,1,1
-38,-39,1,1,1,0
44,12,32,1,1,0
-32,-43,11,1,1,0
-1,-23,22,1,1,0
11,22,-11,0,1,1
4,30,-26,0,1,1
-25,-10,-15,0,1,1
-7,-30,23,1,1,0
23,13,10,1,1,0
61,38,23,1,1,0
27,-15,42,1,0,1
-48,-10,-38,0,0,0
48,25,23,1,0,1
-39,-35,-4,0,0,0
6,11,-5,0,0,0
37,13,24,1,0,1
71,34,37,1,0,1
-2,-2,0,0,0,0
-19,-15,-4,0,0,0
7,19,-12,0,0,0
-78,-43,-35,0,0,0
-15,-37,22,1,1,0
-17,26,-43,0,1,1
1,-4,5,1,1,0
-64,-36,-28,0,1,1
-6,-35,29,1,1,0
34,0,34,1,1,0
70,36,34,1,1,0
34,44,-10,0,1,1
-3,32,-35,0,1,1
-59,-39,-20,0,1,1
-8,-2,-6,0,1,1
63,25,38,1,1,0
-35,9,-44,0,1,1
-44,-8,-36,0,1,1
40,32,8,1,1,0
-53,-38,-15,0,1,1
-8,-39,31,1,0,1
-27,0,-27,0,0,0
-10,-9,-1,0,0,0
55,39,16,1,0,1
2,-3,5,1,0,1
17,23,-6,0,0,0
-6,-23,17,1,0,1
-28,14,-42,0,0,0
-20,-44,24,1,0,1
-59,-24,-35,0,0,0
-77,-43,-34,0,0,0
29,-5,34,1,0,1
34,15,19,1,0,1
20,-19,39,1,0,1
8,11,-3,0,0,0
-13,4,-17,0,0,0
-12,29,-41,0,0,0
-11,33,-44,0,0,0
13,-20,33,1,0,1
-83,-40,-43,0,0,0
-36,-3,-33,0,1,1
-39,-39,0,0,1,1
45,44,1,1,1,0
32,17,15,1,1,0
54,42,12,1,1,0
-31,-30,-1,0,1,1
75,33,42,1,1,0
33,42,-9,0,1,1
-13,9,-22,0,1,1
38,36,2,1,1,0
-22,-29,7,1,0,1
-3,18,-21,0,0,0
-6,31,-37,0,0,0
1,-7,8,1,0,1
-17,-33,16,1,0,1
14,-11,25,1,0,1
12,-3,15,1,0,1
4,4,0,0,0,0
-1,-41,40,1,0,1
25,-3,28,1,0,1
24,-19,43,1,1,0
9,40,-31,0,1,1
-69,-42,-27,0,1,1
52,11,41,1,1,0
-30,-23,-7,0,1,1
39,7,32,1,1,0
0,-18,18,1,1,0
54,13,41,1,1,0
-31,-28,-3,0,1,1
19,31,-12,0,0,0
3,-40,43,1,0,1
-44,-20,-24,0,0,0
0,-27,27,1,0,1
46,23,23,1,0,1
-36,-26,-10,0,0,0
-22,5,-27,0,0,0
14,-20,34,1,0,1
73,35,38,1,0,1
27,15,12,1,0,1
-20,-5,-15,0,0,0
-36,-8,-28,0,0,0
15,-10,25,1,0,1
1,27,-26,0,0,0
-6,-34,28,1,0,1
-5,-29,24,1,0,1
11,44,-33,0,0,0
4,-10,14,1,0,1
61,16,45,1,0,1
81,43,38,1,0,1
51,39,12,1,0,1
18,21,-3,0,1,1
6,-24,30,1,1,0
4,10,-6,0,1,1
-40,-31,-9,0,1,1
64,39,25,1,1,0
18,13,5,1,1,0
5,34,-29,0,1,1
23,-1,24,1,1,0
13,-18,31,1,0,1
40,26,14,1,0,1
1,-33,34,1,0,1
69,32,37,1,0,1
16,-22,38,1,0,1
-34,0,-34,0,0,0
-8,10,-18,0,0,0
14,14,0,0,0,0
-9,30,-39,0,0,0
-21,-32,11,1,0,1
14,33,-19,0,0,0
-22,-34,12,1,0,1
-53,-38,-15,0,1,1
-76,-37,-39,0,1,1
-20,12,-32,0,1,1
-21,-42,21,1,1,0
54,40,14,1,1,0
46,31,15,1,1,0
-74,-42,-32,0,1,1
-69,-30,-39,0,1,1
-6,10,-16,0,1,1
-8,-38,30,1,1,0
-47,-32,-15,0,1,1
2,2,0,0,1,1
53,26,27,1,1,0
-16,19,-35,0,1,1
-4,22,-26,0,1,1
-26,-5,-21,0,1,1
-22,-1,-21,0,1,1
-17,-35,18,1,1,0
33,-4,37,1,0,1
44,37,7,1,0,1
-13,21,-34,0,0,0
46,30,16,1,0,1
-67,-25,-42,0,0,0
-45,-32,-13,0,0,0
-44,-11,-33,0,0,0
-6,-10,4,1,0,1
37,27,10,1,0,1
14,-21,35,1,0,1
56,36,20,1,0,1
15,24,-9,0,0,0
20,-9,29,1,0,1
53,25,28,1,0,1
-64,-41,-23,0,0,0
37,14,23,1,0,1
-45,-31,-14,0,0,0
-3,-2,-1,0,0,0
-4,38,-42,0,0,0
-53,-13,-40,0,0,0
65,43,22,1,0,1
-21,-39,18,1,1,0
0,-6,6,1,1,0
-71,-41,-30,0,1,1
2,-41,43,1,1,0
80,44,36,1,1,0
-87,-43,-44,0,1,1
2,-27,29,1,1,0
-52,-26,-26,0,1,1
5,-19,24,1,1,0
-29,-34,5,1,1,0
-13,-37,24,1,1,0
43,35,8,1,1,0
-45,-5,-40,0,1,1
-8,-5,-3,0,1,1
54,34,20,1,1,0
-31,-2,-29,0,1,1
75,39,36,1,1,0
21,-13,34,1,1,0
3,-5,8,1,1,0
39,37,2,1,1,0
-33,-2,-31,0,1,1
-14,-23,9,1,0,1
46,35,11,1,0,1
28,15,13,1,0,1
-2,23,-25,0,0,0
22,41,-19,0,0,0
34,9,25,1,0,1
-1,-40,39,1,0,1
-73,-44,-29,0,0,0
13,-5,18,1,0,1
4,37,-33,0,0,0
12,-26,38,1,0,1
-27,12,-39,0,0,0
29,11,18,1,1,0
2,32,-30,0,1,1
-34,-23,-11,0,1,1
-33,3,-36,0,1,1
30,44,-14,0,1,1
8,-24,32,1,1,0
21,-16,37,1,1,0
-15,-15,0,0,1,1
16,17,-1,0,0,0
26,30,-4,0,0,0
29,-10,39,1,0,1
9,12,-3,0,0,0
37,33,4,1,0,1
38,27,11,1,0,1
60,28,32,1,0,1
-31,14,-45,0,0,0
23,-15,38,1,0,1
-52,-11,-41,0,0,0
-61,-29,-32,0,0,0
-36,3,-39,0,0,0
-6,14,-20,0,0,0
-88,-44,-44,0,0,0
-2,18,-20,0,0,0
30,28,2,1,0,1
10,-19,29,1,0,1
-28,11,-39,0,0,0
-16,22,-38,0,0,0
-4,10,-14,0,0,0
60,32,28,1,0,1
-52,-33,-19,0,1,1
69,26,43,1,1,0
22,17,5,1,1,0
1,-15,16,1,1,0
43,3,40,1,1,0
-20,-17,-3,0,1,1
57,24,33,1,1,0
-15,-36,21,1,1,0
-11,10,-21,0,1,1
44,10,34,1,1,0
-50,-28,-22,0,1,1
30,-10,40,1,1,0
32,41,-9,0,1,1
-7,-44,37,1,1,0
5,-7,12,1,1,0
-27,3,-30,0,1,1
17,-24,41,1,1,0
7,-18,25,1,1,0
75,41,34,1,1,0
-25,-40,15,1,1,0
17,-21,38,1,1,0
39,7,32,1,0,1
19,13,6,1,0,1
28,13,15,1,0,1
-6,-39,33,1,0,1
-45,-29,-16,0,0,0
-9,6,-15,0,0,0
8,34,-26,0,0,0
-38,-17,-21,0,0,0
-1,18,-19,0,1,1
1,25,-24,0,1,1
-7,26,-33,0,1,1
78,40,38,1,1,0
23,34,-11,0,1,1
50,33,17,1,1,0
88,44,44,1,1,0
-74,-40,-34,0,1,1
28,-5,33,1,1,0
14,-10,24,1,1,0
45,41,4,1,1,0
-7,-21,14,1,1,0
-17,-45,28,1,0,1
85,42,43,1,0,1
-52,-40,-12,0,0,0
-35,8,-43,0,0,0
-18,-14,-4,0,0,0
22,27,-5,0,0,0
-52,-31,-21,0,0,0
16,5,11,1,0,1
-82,-41,-41,0,0,0
-12,1,-13,0,0,0
-53,-19,-34,0,1,1
12,19,-7,0,1,1
-22,-28,6,1,1,0
37,24,13,1,1,0
-50,-6,-44,0,1,1
-10,-28,18,1,1,0
-70,-43,-27,0,1,1
0,-11,11,1,1,0
-30,1,-31,0,1,1
29,31,-2,0,1,1
10,-12,22,1,1,0
-39,-40,1,1,1,0
-10,-2,-8,0,1,1
47,32,15,1,0,1
-15,0,-15,0,0,0
68,33,35,1,0,1
70,41,29,1,0,1
-80,-41,-39,0,0,0
-62,-45,-17,0,0,0
10,19,-9,0,0,0
-41,-37,-4,0,0,0
-48,-9,-39,0,0,0
51,26,25,1,0,1
-35,-22,-13,0,0,0
2,16,-14,0,0,0
-50,-13,-37,0,0,0
65,29,36,1,0,1
-39,-45,6,1,0,1
-16,-28,12,1,0,1
-16,-37,21,1,0,1
29,0,29,1,1,0
31,-9,40,1,1,0
30,-6,36,1,1,0
-37,-28,-9,0,1,1
20,21,-1,0,1,1
11,-2,13,1,1,0
-42,-3,-39,0,1,1
-54,-44,-10,0,1,1
22,33,-11,0,0,0
-19,-8,-11,0,0,0
-85,-43,-42,0,0,0
-49,-21,-28,0,0,0
-53,-12,-41,0,0,0
36,38,-2,0,0,0
79,41,38,1,0,1
11,19,-8,0,0,0
55,19,36,1,0,1
4,-4,8,1,0,1
60,31,29,1,0,1
0,-27,27,1,0,1
14,9,5,1,0,1
28,23,5,1,0,1
14,21,-7,0,0,0
-38,-29,-9,0,0,0
14,39,-25,0,0,0
67,37,30,1,0,1
-66,-28,-38,0,0,0
-19,-34,15,1,1,0
-1,22,-23,0,1,1
3,-14,17,1,1,0
-6,-18,12,1,1,0
9,9,0,0,1,1
-33,-2,-31,0,1,1
-38,-31,-7,0,1,1
-6,10,-16,0,1,1
-11,-32,21,1,1,0
-59,-18,-41,0,1,1
3,-21,24,1,1,0
57,14,43,1,1,0
-45,-4,-41,0,1,1
12,-12,24,1,0,1
-3,-41,38,1,0,1
-39,-30,-9,0,0,0
24,43,-19,0,0,0
47,33,14,1,0,1
-68,-30,-38,0,0,0
11,31,-20,0,0,0
-58,-24,-34,0,0,0
-10,-5,-5,0,0,0
-38,-21,-17,0,1,1
3,-42,45,1,1,0
39,24,15,1,1,0
35,-6,41,1,1,0
-7,33,-40,0,1,1
75,44,31,1,1,0
61,21,40,1,1,0
-20,-1,-19,0,1,1
8,-7,15,1,1,0
36,14,22,1,1,0
11,-23,34,1,1,0
30,9,21,1,1,0
-23,-1,-22,0,1,1
0,5,-5,0,1,1
5,33,-28,0,1,1
-8,-30,22,1,1,0
-7,9,-16,0,1,1
46,16,30,1,1,0
-63,-27,-36,0,1,1
-10,-15,5,1,0,1
-33,-35,2,1,0,1
10,-29,39,1,0,1
-30,0,-30,0,0,0
-35,-12,-23,0,0,0
-5,14,-19,0,0,0
8,36,-28,0,0,0
-23,-22,-1,0,0,0
75,37,38,1,0,1
-36,-25,-11,0,0,0
-26,2,-28,0,0,0
42,42,0,0,0,0
45,0,45,1,0,1
-53,-15,-38,0,0,0
-3,-7,4,1,0,1
-5,-20,15,1,0,1
21,-23,44,1,0,1
-32,-38,6,1,0,1
-28,-38,10,1,0,1
-45,-34,-11,0,0,0
-20,4,-24,0,1,1
-30,1,-31,0,1,1
-63,-27,-36,0,1,1
35,14,21,1,1,0
-9,-45,36,1,1,0
41,42,-1,0,1,1
6,-15,21,1,1,0
-57,-28,-29,0,1,1
0,-11,11,1,1,0
6,-25,31,1,1,0
-41,-11,-30,0,1,1
18,3,15,1,1,0
10,2,8,1,1,0
-3,-35,32,1,1,0
-46,-3,-43,0,1,1
-34,7,-41,0,1,1
25,11,14,1,0,1
14,20,-6,0,0,0
31,-13,44,1,0,1
15,-12,27,1,0,1
1,-9,10,1,0,1
-72,-43,-29,0,0,0
-21,-28,7,1,0,1
14,6,8,1,0,1
44,38,6,1,0,1
-12,-2,-10,0,0,0
-7,9,-16,0,0,0
-35,-7,-28,0,1,1
-1,-28,27,1,1,0
-16,-38,22,1,1,0
43,18,25,1,1,0
10,-31,41,1,1,0
61,27,34,1,1,0
-7,-39,32,1,1,0
-8,25,-33,0,1,1
2,7,-5,0,1,1
-36,-19,-17,0,1,1
-11,13,-24,0,1,1
20,39,-19,0,1,1
34,38,-4,0,0,0
25,0,25,1,0,1
30,28,2,1,0,1
18,-8,26,1,0,1
-37,-25,-12,0,0,0
17,24,-7,0,0,0
4,-1,5,1,0,1
46,7,39,1,0,1
42,3,39,1,0,1
5,36,-31,0,0,0
17,24,-7,0,0,0
-10,29,-39,0,0,0
-53,-40,-13,0,0,0
-21,14,-35,0,1,1
0,-39,39,1,1,0
-40,-39,-1,0,1,1
-37,-4,-33,0,1,1
-26,-2,-24,0,1,1
-17,10,-27,0,1,1
38,32,6,1,1,0
49,23,26,1,1,0
-30,-3,-27,0,1,1
-8,-19,11,1,1,0
-42,-13,-29,0,1,1
-44,-41,-3,0,1,1
24,35,-11,0,1,1
58,40,18,1,1,0
17,22,-5,0,1,1
-25,-11,-14,0,0,0
-58,-33,-25,0,0,0
-71,-37,-34,0,0,0
-10,-25,15,1,0,1
-52,-42,-10,0,0,0
2,43,-41,0,0,0
-3,-25,22,1,0,1
30,42,-12,0,0,0
72,27,45,1,0,1
3,15,-12,0,0,0
-7,23,-30,0,0,0
18,-10,28,1,0,1
-37,-20,-17,0,0,0
32,40,-8,0,1,1
28,-9,37,1,1,0
-16,4,-20,0,1,1
-39,-12,-27,0,1,1
-5,-8,3,1,1,0
-35,-24,-11,0,1,1
35,43,-8,0,1,1
-3,-3,0,0,1,1
-72,-28,-44,0,0,0
45,25,20,1,0,1
46,25,21,1,0,1
87,42,45,1,0,1
-15,-9,-6,0,0,0
-23,-1,-22,0,0,0
16,28,-12,0,0,0
-23,21,-44,0,0,0
18,18,0,0,0,0
-5,-5,0,0,0,0
-32,-2,-30,0,0,0
-32,-33,1,1,0,1
32,34,-2,0,0,0
-34,-10,-24,0,1,1
-15,16,-31,0,1,1
15,-23,38,1,1,0
-19,-14,-5,0,1,1
-43,-2,-41,0,1,1
19,16,3,1,1,0
10,32,-22,0,1,1
63,36,27,1,1,0
-75,-37,-38,0,0,0
58,19,39,1,0,1
33,28,5,1,0,1
-25,-39,14,1,0,1
52,28,24,1,0,1
-21,19,-40,0,0,0
63,29,34,1,0,1
-29,-19,-10,0,0,0
0,41,-41,0,0,0
70,25,45,1,0,1
16,-3,19,1,0,1
54,35,19,1,0,1
-11,-12,1,1,0,1
-43,-33,-10,0,0,0
11,-17,28,1,0,1
-57,-45,-12,0,0,0
-47,-34,-13,0,1,1
45,34,11,1,1,0
-37,-8,-29,0,1,1
1,17,-16,0,1,1
-3,39,-42,0,1,1
-46,-21,-25,0,1,1
-10,-22,12,1,1,0
49,38,11,1,1,0
-35,-31,-4,0,1,1
-52,-34,-18,0,1,1
-23,-1,-22,0,1,1
18,41,-23,0,1,1
-6,-7,1,1,1,0
-74,-39,-35,0,1,1
34,42,-8,0,1,1
18,41,-23,0,1,1
0,10,-10,0,1,1
-31,-10,-21,0,1,1
-48,-22,-26,0,1,1
18,-13,31,1,1,0
16,37,-21,0,1,1
16,30,-14,0,0,0
12,22,-10,0,0,0
52,9,43,1,0,1
49,27,22,1,0,1
19,-13,32,1,0,1
7,25,-18,0,0,0
-9,-11,2,1,0,1
-17,11,-28,0,0,0
-6,-16,10,1,0,1
-55,-35,-20,0,0,0
39,39,0,0,0,0
-42,1,-43,0,0,0
2,33,-31,0,0,0
-29,10,-39,0,0,0
15,-16,31,1,0,1
-35,-20,-15,0,0,0
8,-15,23,1,0,1
11,31,-20,0,0,0
-44,-14,-30,0,0,0
-21,3,-24,0,0,0
73,31,42,1,0,1
-24,-43,19,1,1,0
2,2,0,0,1,1
-21,-10,-11,0,1,1
0,-16,16,1,1,0
-40,-6,-34,0,1,1
-7,-2,-5,0,1,1
-45,-2,-43,0,1,1
32,16,16,1,1,0
-38,-16,-22,0,1,1
10,-19,29,1,1,0
3,-6,9,1,1,0
-32,-17,-15,0,1,1
-70,-25,-45,0,1,1
28,10,18,1,1,0
19,42,-23,0,1,1
17,-5,22,1,0,1
5,7,-2,0,0,0
64,40,24,1,0,1
9,41,-32,0,0,0
-48,-14,-34,0,0,0
-64,-27,-37,0,0,0
-40,-17,-23,0,0,0
-54,-28,-26,0,0,0
-1,30,-31,0,0,0
81,38,43,1,1,0
17,-11,28,1,1,0
-36,-22,-14,0,1,1
-54,-12,-42,0,1,1
44,15,29,1,1,0
41,9,32,1,1,0
-31,-38,7,1,1,0
-20,18,-38,0,1,1
2,-14,16,1,1,0
-34,-43,9,1,1,0
-11,15,-26,0,1,1
-19,16,-35,0,1,1
53,14,39,1,1,0
-61,-34,-27,0,1,1
-20,-29,9,1,1,0
-73,-41,-32,0,1,1
3,14,-11,0,1,1
17,-12,29,1,1,0
-3,4,-7,0,1,1
65,21,44,1,1,0
-19,5,-24,0,1,1
8,-4,12,1,0,1
-8,-9,1,1,0,1
33,40,-7,0,0,0
17,30,-13,0,0,0
-9,25,-34,0,0,0
-40,-16,-24,0,0,0
-3,12,-15,0,0,0
26,37,-11,0,0,0
8,43,-35,0,0,0
-67,-33,-34,0,0,0
4,-7,11,1,0,1
18,13,5,1,0,1
-59,-38,-21,0,0,0
47,18,29,1,0,1
-24,-11,-13,0,0,0
36,10,26,1,0,1
-43,-13,-30,0,0,0
19,-14,33,1,1,0
14,4,10,1,1,0
25,-19,44,1,1,0
-7,3,-10,0,1,1
17,44,-27,0,1,1
31,-4,35,1,1,0
18,-25,43,1,1,0
3,6,-3,0,1,1
-14,-43,29,1,1,0
0,0,0,0,1,1
-45,-13,-32,0,1,1
37,7,30,1,1,0
29,4,25,1,1,0
-42,-10,-32,0,1,1
6,-3,9,1,1,0
64,29,35,1,1,0
-26,-1,-25,0,1,1
-33,-1,-32,0,1,1
10,-5,15,1,1,0
-41,-45,4,1,1,0
-18,-3,-15,0,1,1
10,-26,36,1,0,1
5,44,-39,0,0,0
21,-12,33,1,0,1
42,35,7,1,0,1
-49,-17,-32,0,0,0
-13,21,-34,0,0,0
-65,-45,-20,0,0,0
45,12,33,1,0,1
-46,-2,-44,0,0,0
67,24,43,1,0,1
0,-41,41,1,0,1
-39,-43,4,1,0,1
50,11,39,1,0,1
-12,2,-14,0,0,0
-32,-15,-17,0,0,0
5,-8,13,1,1,0
-16,-36,20,1,1,0
-49,-16,-33,0,1,1
25,4,21,1,1,0
14,40,-26,0,1,1
40,27,13,1,1,0
36,11,25,1,1,0
28,20,8,1,1,0
-40,-17,-23,0,1,1
47,34,13,1,1,0
7,-23,30,1,1,0
56,43,13,1,1,0
-47,-31,-16,0,1,1
-29,4,-33,0,1,1
-21,16,-37,0,1,1
-9,22,-31,0,1,1
16,0,16,1,1,0
3,18,-15,0,1,1
3,37,-34,0,1,1
-10,-26,16,1,1,0
-12,-40,28,1,1,0
41,-3,44,1,0,1
60,28,32,1,0,1
29,-7,36,1,0,1
-10,-38,28,1,0,1
-66,-31,-35,0,0,0
-9,35,-44,0,0,0
1,-8,9,1,0,1
34,1,33,1,0,1
58,41,17,1,0,1
58,14,44,1,0,1
34,-6,40,1,0,1
-27,-32,5,1,0,1
26,3,23,1,0,1
-61,-20,-41,0,0,0
-36,-24,-12,0,0,0
-33,-7,-26,0,0,0
-8,21,-29,0,1,1
-13,22,-35,0,1,1
0,-43,43,1,1,0
-16,26,-42,0,1,1
30,31,-1,0,1,1
4,28,-24,0,1,1
-53,-10,-43,0,1,1
-3,-42,39,1,1,0
-29,-37,8,1,1,0
-28,8,-36,0,1,1
-4,14,-18,0,1,1
-1,-43,42,1,1,0
-9,29,-38,0,1,1
72,38,34,1,1,0
54,20,34,1,1,0
57,22,35,1,0,1
14,-3,17,1,0,1
18,43,-25,0,0,0
6,-3,9,1,0,1
34,26,8,1,0,1
80,39,41,1,0,1
-77,-40,-37,0,0,0
18,-20,38,1,0,1
-73,-45,-28,0,0,0
2,-27,29,1,0,1
15,7,8,1,0,1
19,40,-21,0,0,0
7,-1,8,1,0,1
-10,-5,-5,0,0,0
-9,28,-37,0,0,0
-3,-30,27,1,0,1
-20,-42,22,1,1,0
28,26,2,1,1,0
30,23,7,1,1,0
7,-12,19,1,1,0
-44,-18,-26,0,1,1
5,-22,27,1,1,0
50,6,44,1,1,0
5,26,-21,0,1,1
28,-15,43,1,1,0
-4,33,-37,0,1,1
21,44,-23,0,1,1
-5,1,-6,0,1,1
-72,-33,-39,0,1,1
-20,18,-38,0,1,1
-14,-32,18,1,0,1
-71,-37,-34,0,0,0
15,-17,32,1,0,1
-30,8,-38,0,0,0
12,19,-7,0,0,0
-1,-43,42,1,0,1
-14,-24,10,1,0,1
-60,-19,-41,0,0,0
17,3,14,1,0,1
46,35,11,1,0,1
-5,10,-15,0,0,0
-19,-25,6,1,0,1
37,17,20,1,0,1
70,42,28,1,0,1
-17,-39,22,1,0,1
-16,-45,29,1,0,1
-1,23,-24,0,0,0
58,23,35,1,1,0
-24,-29,5,1,1,0
67,36,31,1,1,0
-71,-43,-28,0,1,1
-33,-41,8,1,1,0
-17,-21,4,1,1,0
5,-33,38,1,1,0
-63,-35,-28,0,1,1
-39,-18,-21,0,1,1
50,26,24,1,1,0
-6,17,-23,0,1,1
2,-11,13,1,1,0
-28,-45,17,1,1,0
27,13,14,1,1,0
34,-11,45,1,1,0
-17,-4,-13,0,1,1
-47,-44,-3,0,1,1
19,23,-4,0,1,1
71,36,35,1,0,1
-39,-4,-35,0,0,0
37,42,-5,0,0,0
45,22,23,1,0,1
3,34,-31,0,0,0
-8,-15,7,1,0,1
-28,13,-41,0,0,0
-39,-2,-37,0,0,0
55,27,28,1,1,0
-11,7,-18,0,1,1
20,-6,26,1,1,0
2,-13,15,1,1,0
-66,-26,-40,0,1,1
7,34,-27,0,1,1
4,21,-17,0,1,1
-22,-12,-10,0,1,1
-21,10,-31,0,1,1
5,-21,26,1,1,0
-36,7,-43,0,1,1
-20,21,-41,0,1,1
-31,8,-39,0,1,1
-5,-31,26,1,1,0
0,-26,26,1,1,0
-30,-5,-25,0,1,1
-77,-34,-43,0,1,1
29,20,9,1,1,0
8,-27,35,1,1,0
-31,-7,-24,0,1,1
-11,24,-35,0,1,1
29,30,-1,0,0,0
-57,-44,-13,0,0,0
-17,-24,7,1,0,1
25,14,11,1,0,1
18,-3,21,1,0,1
36,-5,41,1,0,1
13,9,4,1,0,1
-3,35,-38,0,0,0
10,-33,43,1,0,1
-24,-32,8,1,0,1
18,40,-22,0,0,0
-7,-26,19,1,0,1
-7,-14,7,1,0,1
-34,-5,-29,0,0,0
-42,-40,-2,0,0,0
-8,-36,28,1,0,1
43,12,31,1,1,0
-5,-13,8,1,1,0
36,6,30,1,1,0
-57,-37,-20,0,1,1
-61,-20,-41,0,1,1
-16,-26,10,1,1,0
-48,-21,-27,0,1,1
7,20,-13,0,1,1
14,-7,21,1,1,0
11,32,-21,0,1,1
-34,-32,-2,0,1,1
59,25,34,1,0,1
-70,-43,-27,0,0,0
-8,-2,-6,0,0,0
-3,22,-25,0,0,0
-13,31,-44,0,0,0
32,44,-12,0,0,0
14,-21,35,1,0,1
-31,-25,-6,0,0,0
1,26,-25,0,0,0
58,39,19,1,0,1
-5,6,-11,0,0,0
-14,4,-18,0,0,0
1,19,-18,0,0,0
4,2,2,1,0,1
-61,-29,-32,0,0,0
-37,-11,-26,0,0,0
19,-14,33,1,0,1
-52,-17,-35,0,0,0
-67,-36,-31,0,0,0
-22,-11,-11,0,0,0
-4,0,-4,0,0,0
-10,-17,7,1,1,0
26,24,2,1,1,0
13,21,-8,0,1,1
33,-9,42,1,1,0
-54,-24,-30,0,1,1
-60,-16,-44,0,1,1
-6,-18,12,1,1,0
-18,-12,-6,0,1,1
42,20,22,1,1,0
62,26,36,1,1,0
30,25,5,1,1,0
26,9,17,1,1,0
-53,-30,-23,0,1,1
29,26,3,1,1,0
18,7,11,1,1,0
-34,-39,5,1,1,0
-39,-23,-16,0,1,1
-2,-6,4,1,0,1
55,13,42,1,0,1
15,8,7,1,0,1
18,-11,29,1,0,1
-1,30,-31,0,0,0
5,-14,19,1,0,1
43,39,4,1,0,1
-10,27,-37,0,0,0
42,26,16,1,0,1
-7,16,-23,0,0,0
28,44,-16,0,0,0
-6,-42,36,1,0,1
-75,-34,-41,0,0,0
63,24,39,1,0,1
-39,0,-39,0,1,1
37,39,-2,0,1,1
27,36,-9,0,1,1
-14,-41,27,1,1,0
-15,-5,-10,0,1,1
-59,-37,-22,0,1,1
45,16,29,1,1,0
17,13,4,1,1,0
-22,-43,21,1,1,0
12,25,-13,0,1,1
8,6,2,1,1,0
-40,-25,-15,0,1,1
7,43,-36,0,1,1
25,42,-17,0,1,1
3,-21,24,1,1,0
-12,-10,-2,0,0,0
-25,13,-38,0,0,0
34,44,-10,0,0,0
17,40,-23,0,0,0
56,25,31,1,0,1
71,44,27,1,0,1
69,42,27,1,0,1
24,16,8,1,0,1
-26,-15,-11,0,0,0
-84,-45,-39,0,0,0
67,37,30,1,0,1
-36,-17,-19,0,0,0
20,-14,34,1,0,1
68,30,38,1,0,1
-43,-18,-25,0,0,0
-8,34,-42,0,0,0
58,34,24,1,0,1
0,-36,36,1,0,1
-75,-34,-41,0,0,0
53,30,23,1,1,0
-24,-15,-9,0,1,1
-24,6,-30,0,1,1
-52,-12,-40,0,1,1
24,15,9,1,1,0
32,23,9,1,1,0
12,-23,35,1,1,0
-48,-4,-44,0,1,1
-53,-11,-42,0,1,1
14,-5,19,1,1,0
27,38,-11,0,1,1
20,-17,37,1,0,1
-57,-12,-45,0,0,0
50,15,35,1,0,1
19,28,-9,0,0,0
7,17,-10,0,0,0
-9,-19,10,1,0,1
2,24,-22,0,0,0
44,34,10,1,0,1
-13,-31,18,1,0,1
40,11,29,1,0,1
10,19,-9,0,0,0
23,-6,29,1,0,1
-1,-2,1,1,0,1
3,-25,28,1,0,1
-8,-43,35,1,0,1
-8,14,-22,0,0,0
-23,-27,4,1,0,1
-9,-39,30,1,0,1
56,34,22,1,0,1
-41,-27,-14,0,0,0
-29,-33,4,1,1,0
-16,11,-27,0,1,1
32,18,14,1,1,0
-20,-45,25,1,1,0
-6,36,-42,0,1,1
13,-6,19,1,1,0
32,35,-3,0,1,1
-28,-27,-1,0,1,1
54,18,36,1,1,0
33,38,-5,0,1,1
53,34,19,1,1,0
35,-7,42,1,1,0
4,-2,6,1,1,0
-34,-39,5,1,1,0
-14,-10,-4,0,1,1
-26,-32,6,1,1,0
-75,-37,-38,0,1,1
-43,-9,-34,0,1,1
21,32,-11,0,1,1
8,-11,19,1,1,0
-1,20,-21,0,1,1
-31,13,-44,0,0,0
-20,25,-45,0,0,0
-17,-22,5,1,0,1
-40,-10,-30,0,0,0
51,29,22,1,0,1
3,-35,38,1,0,1
58,25,33,1,0,1
-21,4,-25,0,0,0
15,-23,38,1,0,1
-7,-4,-3,0,0,0
-29,1,-30,0,1,1
-13,-16,3,1,1,0
-43,-30,-13,0,1,1
-4,-13,9,1,1,0
-12,-10,-2,0,1,1
27,-2,29,1,1,0
-7,-44,37,1,1,0
-28,-4,-24,0,1,1
-65,-34,-31,0,1,1
-1,-38,37,1,1,0
-1,6,-7,0,1,1
-9,14,-23,0,0,0
53,35,18,1,0,1
77,39,38,1,0,1
50,31,19,1,0,1
22,-21,43,1,0,1
-59,-27,-32,0,0,0
61,22,39,1,0,1
58,14,44,1,0,1
50,7,43,1,0,1
-42,-5,-37,0,0,0
1,-35,36,1,0,1
20,19,1,1,0,1
-30,-9,-21,0,0,0
74,33,41,1,0,1
-75,-38,-37,0,0,0
-5,36,-41,0,0,0
54,34,20,1,0,1
28,-14,42,1,0,1
-14,-24,10,1,0,1
55,27,28,1,0,1
4,10,-6,0,0,0
9,-9,18,1,1,0
-11,-43,32,1,1,0
-29,5,-34,0,1,1
-23,-27,4,1,1,0
8,31,-23,0,1,1
89,44,45,1,1,0
-7,-5,-2,0,1,1
20,-8,28,1,1,0
6,-19,25,1,1,0
-48,-34,-14,0,0,0
2,-7,9,1,0,1
35,26,9,1,0,1
-46,-13,-33,0,0,0
12,-26,38,1,0,1
15,15,0,0,0,0
39,11,28,1,0,1
13,2,11,1,0,1
-49,-13,-36,0,0,0
16,28,-12,0,0,0
17,-1,18,1,0,1
71,34,37,1,0,1
-33,-12,-21,0,0,0
0,-44,44,1,0,1
-55,-13,-42,0,0,0
-26,-22,-4,0,0,0
-14,-36,22,1,0,1
47,30,17,1,0,1
-25,20,-45,0,0,0
2,23,-21,0,0,0
55,25,30,1,0,1
-47,-3,-44,0,1,1
19,26,-7,0,1,1
5,26,-21,0,1,1
56,41,15,1,1,0
25,-12,37,1,1,0
77,41,36,1,1,0
-3,-34,31,1,1,0
-31,-13,-18,0,1,1
-44,-44,0,0,1,1
-28,-39,11,1,1,0
-57,-22,-35,0,0,0
-10,-9,-1,0,0,0
26,-12,38,1,0,1
-59,-25,-34,0,0,0
-60,-19,-41,0,0,0
-32,-25,-7,0,0,0
5,11,-6,0,0,0
-12,19,-31,0,0,0
0,-17,17,1,0,1
45,24,21,1,0,1
4,5,-1,0,0,0
16,-2,18,1,0,1
-28,13,-41,0,0,0
22,20,2,1,0,1
23,-14,37,1,0,1
9,12,-3,0,0,0
36,23,13,1,0,1
-35,5,-40,0,0,0
10,25,-15,0,0,0
52,13,39,1,0,1
33,14,19,1,0,1
-19,-22,3,1,1,0
-18,12,-30,0,1,1
-20,-10,-10,0,1,1
25,28,-3,0,1,1
-13,-10,-3,0,1,1
17,37,-20,0,1,1
14,-2,16,1,1,0
-54,-12,-42,0,1,1
-69,-42,-27,0,1,1
20,36,-16,0,1,1
-6,18,-24,0,1,1
14,11,3,1,1,0
44,6,38,1,1,0
-55,-13,-42,0,1,1
9,-27,36,1,1,0
71,39,32,1,0,1
0,30,-30,0,0,0
-21,-11,-10,0,0,0
10,-20,30,1,0,1
11,-31,42,1,0,1
-57,-19,-38,0,0,0
71,40,31,1,0,1
7,35,-28,0,0,0
37,3,34,1,1,0
-3,-23,20,1,1,0
30,4,26,1,1,0
-51,-28,-23,0,1,1
-57,-43,-14,0,1,1
26,15,11,1,1,0
-35,-26,-9,0,1,1
-13,23,-36,0,1,1
-1,0,-1,0,1,1
50,32,18,1,1,0
-11,-42,31,1,1,0
1,-11,12,1,1,0
3,-9,12,1,0,1
-73,-35,-38,0,0,0
8,21,-13,0,0,0
-37,-19,-18,0,0,0
20,10,10,1,0,1
-19,-2,-17,0,0,0
22,10,12,1,0,1
66,27,39,1,0,1
35,10,25,1,0,1
-1,-39,38,1,0,1
20,15,5,1,1,0
-5,27,-32,0,1,1
42,12,30,1,1,0
-23,-34,11,1,1,0
-25,-42,17,1,1,0
-77,-38,-39,0,1,1
23,-14,37,1,1,0
-46,-14,-32,0,1,1
68,27,41,1,1,0
-71,-44,-27,0,1,1
5,8,-3,0,1,1
15,7,8,1,1,0
59,23,36,1,1,0
-18,2,-20,0,1,1
-20,-36,16,1,1,0
-39,-11,-28,0,1,1
-19,18,-37,0,1,1
-9,25,-34,0,1,1
-48,-12,-36,0,1,1
52,40,12,1,1,0
5,-1,6,1,1,0
19,-15,34,1,0,1
-25,-42,17,1,0,1
-26,-42,16,1,0,1
70,28,42,1,0,1
43,7,36,1,0,1
11,28,-17,0,0,0
5,8,-3,0,0,0
-15,-29,14,1,0,1
1,-23,24,1,1,0
6,3,3,1,1,0
13,-28,41,1,1,0
10,-34,44,1,1,0
31,26,5,1,1,0
-46,-15,-31,0,1,1
50,27,23,1,1,0
-25,-15,-10,0,1,1
70,36,34,1,1,0
-33,8,-41,0,1,1
-31,-39,8,1,1,0
-11,-2,-9,0,1,1
-12,-20,8,1,1,0
9,-8,17,1,1,0
-19,-10,-9,0,1,1
-37,-28,-9,0,1,1
7,-12,19,1,1,0
8,9,-1,0,1,1
67,36,31,1,0,1
-7,16,-23,0,0,0
-43,-12,-31,0,0,0
-57,-36,-21,0,0,0
13,9,4,1,0,1
-86,-44,-42,0,0,0
-17,-5,-12,0,0,0
-47,-34,-13,0,0,0
60,37,23,1,0,1
-57,-36,-21,0,1,1
-34,-16,-18,0,1,1
50,28,22,1,1,0
-60,-16,-44,0,1,1
-55,-25,-30,0,1,1
-34,-45,11,1,1,0
-39,4,-43,0,1,1
21,44,-23,0,1,1
-16,23,-39,0,1,1
34,43,-9,0,1,1
-5,37,-42,0,1,1
-84,-39,-45,0,1,1
57,25,32,1,1,0
45,2,43,1,1,0
-37,-3,-34,0,1,1
-44,-19,-25,0,1,1
22,-17,39,1,1,0
54,27,27,1,1,0
14,20,-6,0,1,1
13,0,13,1,0,1
16,24,-8,0,0,0
-9,17,-26,0,0,0
56,39,17,1,0,1
-40,-44,4,1,0,1
36,-1,37,1,0,1
7,16,-9,0,0,0
-5,-41,36,1,0,1
21,9,12,1,1,0
49,26,23,1,1,0
-38,-2,-36,0,1,1
-6,26,-32,0,1,1
44,0,44,1,1,0
8,-36,44,1,1,0
-15,20,-35,0,1,1
32,17,15,1,1,0
37,44,-7,0,1,1
-6,29,-35,0,1,1
-31,-23,-8,0,1,1
-17,27,-44,0,1,1
-30,-9,-21,0,1,1
48,23,25,1,1,0
34,16,18,1,1,0
-2,-3,1,1,1,0
13,31,-18,0,1,1
-73,-28,-45,0,1,1
-20,-13,-7,0,1,1
-44,-17,-27,0,1,1
23,-4,27,1,1,0
47,10,37,1,0,1
-55,-31,-24,0,0,0
-7,-25,18,1,0,1
15,0,15,1,0,1
-64,-19,-45,0,0,0
69,31,38,1,0,1
-10,-23,13,1,0,1
-40,-10,-30,0,0,0
10,29,-19,0,0,0
38,0,38,1,0,1
12,30,-18,0,0,0
48,5,43,1,0,1
-43,-43,0,0,0,0
47,3,44,1,0,1
16,-14,30,1,0,1
49,42,7,1,0,1
-65,-41,-24,0,0,0
-52,-37,-15,0,0,0
-19,-32,13,1,1,0
-13,-29,16,1,1,0
-34,-19,-15,0,1,1
-31,-1,-30,0,1,1
-33,-45,12,1,1,0
40,-3,43,1,1,0
15,-19,34,1,1,0
-63,-32,-31,0,1,1
-38,-6,-32,0,1,1
-3,-4,1,1,1,0
8,-9,17,1,0,1
-57,-27,-30,0,0,0
6,-29,35,1,0,1
-26,9,-35,0,0,0
-36,0,-36,0,0,0
-11,10,-21,0,0,0
2,-38,40,1,0,1
14,37,-23,0,0,0
55,13,42,1,0,1
-82,-38,-44,0,0,0
-19,-13,-6,0,0,0
-22,-24,2,1,1,0
67,39,28,1,1,0
4,-22,26,1,1,0
-9,25,-34,0,1,1
52,21,31,1,1,0
7,23,-16,0,1,1
-9,32,-41,0,1,1
2,0,2,1,1,0
-4,-40,36,1,1,0
18,2,16,1,1,0
72,32,40,1,1,0
15,-12,27,1,1,0
-12,-38,26,1,1,0
43,40,3,1,1,0
-2,-33,31,1,1,0
-1,-43,42,1,0,1
-38,-26,-12,0,0,0
54,40,14,1,0,1
-48,-22,-26,0,0,0
72,40,32,1,0,1
73,39,34,1,0,1
-17,-15,-2,0,0,0
-5,-29,24,1,0,1
26,-16,42,1,0,1
-62,-32,-30,0,0,0
-13,18,-31,0,0,0
-41,-11,-30,0,0,0
-5,-32,27,1,0,1
-46,-35,-11,0,0,0
-26,-37,11,1,0,1
-7,19,-26,0,0,0
44,32,12,1,0,1
52,34,18,1,1,0
-70,-45,-25,0,1,1
3,10,-7,0,1,1
-7,-43,36,1,1,0
61,16,45,1,1,0
4,30,-26,0,1,1
-30,-35,5,1,1,0
58,16,42,1,1,0
-16,-6,-10,0,1,1
-71,-42,-29,0,1,1
-9,-4,-5,0,1,1
57,29,28,1,1,0
18,4,14,1,1,0
-52,-11,-41,0,1,1
73,31,42,1,1,0
-4,26,-30,0,1,1
41,4,37,1,1,0
24,39,-15,0,1,1
9,-8,17,1,1,0
25,24,1,1,1,0
60,33,27,1,1,0
-56,-31,-25,0,0,0
-23,0,-23,0,0,0
-27,-24,-3,0,0,0
-4,-39,35,1,0,1
11,28,-17,0,0,0
41,40,1,1,0,1
14,-23,37,1,0,1
53,15,38,1,0,1
39,40,-1,0,0,0
-55,-25,-30,0,0,0
69,25,44,1,0,1
66,38,28,1,0,1
-11,-10,-1,0,0,0
76,41,35,1,0,1
-18,-42,24,1,0,1
64,26,38,1,0,1
-21,-14,-7,0,0,0
-49,-40,-9,0,0,0
13,16,-3,0,0,0
-58,-14,-44,0,0,0
11,-31,42,1,0,1
25,32,-7,0,1,1
-15,-13,-2,0,1,1
-32,-39,7,1,1,0
41,37,4,1,1,0
-12,-6,-6,0,1,1
-24,-41,17,1,1,0
31,1,30,1,1,0
-62,-38,-24,0,1,1
-36,-41,5,1,1,0
16,-29,45,1,0,1
-20,18,-38,0,0,0
46,43,3,1,0,1
-67,-24,-43,0,0,0
-42,3,-45,0,0,0
11,13,-2,0,0,0
-5,13,-18,0,0,0
-13,-6,-7,0,0,0
34,-10,44,1,0,1
-65,-21,-44,0,0,0
69,35,34,1,0,1
-7,21,-28,0,0,0
-29,-6,-23,0,1,1
31,-10,41,1,1,0
-81,-38,-43,0,1,1
2,20,-18,0,1,1
47,25,22,1,1,0
-12,30,-42,0,1,1
28,25,3,1,1,0
-12,-41,29,1,1,0
12,40,-28,0,1,1
-15,-18,3,1,1,0
-66,-24,-42,0,1,1
50,10,40,1,1,0
63,34,29,1,1,0
17,27,-10,0,0,0
52,8,44,1,0,1
4,-10,14,1,0,1
62,40,22,1,0,1
-19,20,-39,0,0,0
59,17,42,1,0,1
66,23,43,1,0,1
8,11,-3,0,0,0
27,14,13,1,0,1
-6,0,-6,0,0,0
41,0,41,1,0,1
-4,-21,17,1,0,1
14,40,-26,0,0,0
-5,-23,18,1,0,1
38,2,36,1,0,1
-9,22,-31,0,0,0
61,29,32,1,0,1
50,14,36,1,0,1
35,-6,41,1,0,1
-4,16,-20,0,1,1
51,40,11,1,1,0
-8,-37,29,1,1,0
21,28,-7,0,1,1
-57,-18,-39,0,1,1
52,23,29,1,1,0
-28,17,-45,0,1,1
63,24,39,1,1,0
-18,0,-18,0,1,1
-19,19,-38,0,1,1
21,-15,36,1,1,0
28,11,17,1,1,0
49,34,15,1,1,0
-5,40,-45,0,0,0
-17,-38,21,1,0,1
26,44,-18,0,0,0
1,19,-18,0,0,0
54,11,43,1,0,1
22,9,13,1,0,1
-12,-35,23,1,0,1
7,33,-26,0,0,0
-12,20,-32,0,1,1
18,40,-22,0,1,1
-85,-40,-45,0,1,1
0,18,-18,0,1,1
-42,-17,-25,0,1,1
11,-25,36,1,1,0
7,-35,42,1,1,0
-8,-21,13,1,1,0
-9,-23,14,1,1,0
-48,-22,-26,0,1,1
-45,-26,-19,0,1,1
-29,15,-44,0,1,1
1,2,-1,0,1,1
-21,9,-30,0,1,1
-42,-2,-40,0,0,0
21,4,17,1,0,1
45,21,24,1,0,1
-47,-32,-15,0,0,0
-13,-32,19,1,0,1
-17,4,-21,0,0,0
24,5,19,1,0,1
-72,-30,-42,0,0,0
44,33,11,1,0,1
-16,-35,19,1,0,1
11,33,-22,0,1,1
58,24,34,1,1,0
9,39,-30,0,1,1
-46,-2,-44,0,1,1
-75,-32,-43,0,1,1
28,-13,41,1,1,0
-36,-39,3,1,1,0
-19,23,-42,0,1,1
41,43,-2,0,1,1
32,13,19,1,1,0
10,9,1,1,1,0
13,-7,20,1,1,0
-14,6,-20,0,1,1
-28,-6,-22,0,0,0
-26,-16,-10,0,0,0
16,35,-19,0,0,0
46,25,21,1,0,1
40,39,1,1,0,1
-7,-12,5,1,0,1
-47,-38,-9,0,0,0
-25,-25,0,0,0,0
-55,-22,-33,0,0,0
15,-24,39,1,0,1
57,37,20,1,0,1
-5,-37,32,1,0,1
14,-10,24,1,0,1
-30,4,-34,0,0,0
5,26,-21,0,1,1
69,40,29,1,1,0
4,-41,45,1,1,0
9,39,-30,0,1,1
31,31,0,0,1,1
-22,18,-40,0,1,1
-15,-2,-13,0,1,1
8,-33,41,1,1,0
-19,-44,25,1,1,0
10,-5,15,1,1,0
-15,-41,26,1,0,1
-26,-26,0,0,0,0
-21,-12,-9,0,0,0
-44,-36,-8,0,0,0
-3,29,-32,0,0,0
-27,-10,-17,0,0,0
-60,-25,-35,0,0,0
-3,-44,41,1,0,1
-44,-45,1,1,0,1
14,22,-8,0,1,1
-66,-21,-45,0,1,1
-33,-36,3,1,1,0
42,33,9,1,1,0
-50,-45,-5,0,1,1
4,38,-34,0,1,1
-18,-21,3,1,1,0
-30,-28,-2,0,1,1
-7,-24,17,1,1,0
-10,35,-45,0,1,1
-60,-43,-17,0,1,1
-48,-39,-9,0,1,1
61,31,30,1,1,0
-22,-21,-1,0,1,1
-24,-31,7,1,1,0
-47,-33,-14,0,1,1
-7,5,-12,0,1,1
26,19,7,1,1,0
-14,-44,30,1,1,0
7,11,-4,0,1,1
-9,-39,30,1,1,0
-30,-37,7,1,0,1
-13,-32,19,1,0,1
-41,-12,-29,0,0,0
26,40,-14,0,0,0
2,26,-24,0,0,0
24,36,-12,0,0,0
7,15,-8,0,0,0
-31,5,-36,0,0,0
19,33,-14,0,0,0
7,-20,27,1,0,1
43,25,18,1,0,1
29,37,-8,0,0,0
-29,-18,-11,0,0,0
40,32,8,1,0,1
-58,-24,-34,0,0,0
-42,-33,-9,0,0,0
-9,-16,7,1,0,1
27,14,13,1,0,1
-86,-43,-43,0,0,0
-29,-7,-22,0,0,0
-79,-43,-36,0,0,0
-34,-36,2,1,1,0
17,-20,37,1,1,0
-3,-12,9,1,1,0
28,24,4,1,1,0
-10,-37,27,1,1,0
-13,-9,-4,0,1,1
71,34,37,1,1,0
-2,-5,3,1,1,0
21,10,11,1,1,0
-8,-31,23,1,1,0
30,22,8,1,1,0
-28,-35,7,1,1,0
46,20,26,1,1,0
-22,17,-39,0,1,1
-32,8,-40,0,1,1
5,33,-28,0,1,1
18,-22,40,1,1,0
-86,-45,-41,0,1,1
-32,13,-45,0,0,0
4,9,-5,0,0,0
26,-18,44,1,0,1
-3,39,-42,0,0,0
-19,23,-42,0,0,0
43,2,41,1,0,1
-2,-32,30,1,0,1
0,-38,38,1,0,1
5,40,-35,0,0,0
42,36,6,1,0,1
17,41,-24,0,0,0
-74,-32,-42,0,0,0
-24,-1,-23,0,0,0
36,30,6,1,0,1
-4,-36,32,1,0,1
3,36,-33,0,0,0
-25,-31,6,1,0,1
14,-9,23,1,1,0
12,27,-15,0,1,1
58,44,14,1,1,0
-21,-9,-12,0,1,1
-31,-16,-15,0,1,1
69,43,26,1,1,0
-39,-26,-13,0,1,1
57,17,40,1,1,0
-7,-30,23,1,1,0
17,33,-16,0,1,1
-2,2,-4,0,0,0
-6,27,-33,0,0,0
17,15,2,1,0,1
34,28,6,1,0,1
57,37,20,1,0,1
-26,6,-32,0,0,0
8,34,-26,0,0,0
60,24,36,1,0,1
-30,10,-40,0,0,0
28,2,26,1,0,1
-29,-16,-13,0,0,0
-40,-20,-20,0,1,1
7,33,-26,0,1,1
0,25,-25,0,1,1
8,41,-33,0,1,1
-2,29,-31,0,1,1
25,22,3,1,1,0
-12,21,-33,0,1,1
-43,-24,-19,0,1,1
41,39,2,1,1,0
-9,36,-45,0,1,1
53,32,21,1,1,0
-1,32,-33,0,1,1
10,34,-24,0,1,1
25,-14,39,1,1,0
-6,-33,27,1,1,0
19,-18,37,1,1,0
50,42,8,1,1,0
40,42,-2,0,1,1
-7,26,-33,0,1,1
47,10,37,1,1,0
25,33,-8,0,1,1
-23,-24,1,1,0,1
75,44,31,1,0,1
4,34,-30,0,0,0
-53,-23,-30,0,0,0
10,44,-34,0,0,0
-28,1,-29,0,0,0
-36,6,-42,0,0,0
44,8,36,1,0,1
47,27,20,1,0,1
56,35,21,1,0,1
-4,-38,34,1,0,1
-83,-42,-41,0,0,0
-10,-13,3,1,0,1
-11,18,-29,0,0,0
3,6,-3,0,0,0
5,-36,41,1,1,0
7,-18,25,1,1,0
-36,-28,-8,0,1,1
-20,-5,-15,0,1,1
67,43,24,1,1,0
-5,-15,10,1,1,0
19,31,-12,0,1,1
-44,-4,-40,0,1,1
26,41,-15,0,1,1
46,24,22,1,1,0
-53,-39,-14,0,1,1
70,34,36,1,1,0
-36,-8,-28,0,0,0
27,18,9,1,0,1
21,3,18,1,0,1
22,41,-19,0,0,0
66,34,32,1,0,1
-33,2,-35,0,0,0
-4,-28,24,1,0,1
20,2,18,1,0,1
28,1,27,1,0,1
-7,-22,15,1,1,0
-9,-21,12,1,1,0
1,37,-36,0,1,1
19,-4,23,1,1,0
16,-13,29,1,1,0
10,-13,23,1,1,0
-14,-34,20,1,1,0
38,22,16,1,1,0
66,28,38,1,1,0
-20,-10,-10,0,1,1
-36,-32,-4,0,1,1
-11,2,-13,0,1,1
-12,-3,-9,0,1,1
-10,-4,-6,0,1,1
-5,-40,35,1,1,0
-26,-19,-7,0,1,1
40,6,34,1,1,0
-41,-36,-5,0,1,1
33,-8,41,1,1,0
-60,-31,-29,0,1,1
-8,8,-16,0,1,1
-57,-27,-30,0,0,0
26,0,26,1,0,1
-73,-45,-28,0,0,0
13,35,-22,0,0,0
-19,24,-43,0,0,0
11,-18,29,1,0,1
-13,-28,15,1,0,1
-16,19,-35,0,0,0
-3,36,-39,0,0,0
33,12,21,1,0,1
15,42,-27,0,0,0
-45,-40,-5,0,1,1
-10,34,-44,0,1,1
-60,-43,-17,0,1,1
-1,35,-36,0,1,1
16,-25,41,1,1,0
7,-32,39,1,1,0
7,6,1,1,1,0
33,15,18,1,1,0
42,11,31,1,1,0
13,26,-13,0,1,1
34,27,7,1,0,1
5,-32,37,1,0,1
15,35,-20,0,0,0
16,-28,44,1,0,1
-9,-20,11,1,0,1
7,9,-2,0,0,0
38,36,2,1,0,1
-1,-41,40,1,0,1
51,18,33,1,0,1
-2,-20,18,1,0,1
3,39,-36,0,0,0
9,-28,37,1,0,1
-76,-33,-43,0,0,0
15,-11,26,1,0,1
-21,-35,14,1,0,1
7,-26,33,1,0,1
1,-28,29,1,0,1
-9,30,-39,0,0,0
21,-20,41,1,0,1
-23,-32,9,1,0,1
-15,-11,-4,0,0,0
-8,22,-30,0,1,1
-68,-24,-44,0,1,1
19,22,-3,0,1,1
-54,-16,-38,0,1,1
15,26,-11,0,1,1
16,19,-3,0,1,1
66,33,33,1,1,0
-6,3,-9,0,1,1
1,-23,24,1,1,0
19,-6,25,1,1,0
43,23,20,1,1,0
-32,-21,-11,0,1,1
61,41,20,1,1,0
-31,-4,-27,0,1,1
68,27,41,1,1,0
74,32,42,1,1,0
-82,-44,-38,0,1,1
12,29,-17,0,1,1
-14,-29,15,1,1,0
13,23,-10,0,1,1
-1,27,-28,0,1,1
-52,-25,-27,0,0,0
60,32,28,1,0,1
49,26,23,1,0,1
-68,-35,-33,0,0,0
6,-15,21,1,0,1
-35,-25,-10,0,0,0
16,39,-23,0,0,0
14,18,-4,0,0,0
-30,-42,12,1,0,1
-65,-32,-33,0,0,0
47,44,3,1,0,1
-24,9,-33,0,0,0
-57,-40,-17,0,0,0
33,23,10,1,0,1
0,-40,40,1,0,1
-28,8,-36,0,0,0
53,12,41,1,0,1
-15,-17,2,1,1,0
57,31,26,1,1,0
-10,-8,-2,0,1,1
-11,29,-40,0,1,1
-62,-17,-45,0,1,1
-29,-39,10,1,1,0
27,-15,42,1,1,0
-1,-14,13,1,1,0
-64,-32,-32,0,1,1
-20,-22,2,1,1,0
-69,-30,-39,0,1,1
38,16,22,1,0,1
18,-15,33,1,0,1
-5,-30,25,1,0,1
20,4,16,1,0,1
-20,16,-36,0,0,0
-1,-45,44,1,0,1
-9,7,-16,0,0,0
23,20,3,1,0,1
26,-2,28,1,1,0
-23,-22,-1,0,1,1
30,-3,33,1,1,0
-14,-4,-10,0,1,1
34,42,-8,0,1,1
42,-2,44,1,1,0
4,-7,11,1,1,0
6,23,-17,0,1,1
-9,-39,30,1,1,0
-16,9,-25,0,1,1
-3,-33,30,1,1,0
23,26,-3,0,1,1
41,-1,42,1,1,0
-15,26,-41,0,1,1
-17,-4,-13,0,1,1
21,19,2,1,1,0
-32,-24,-8,0,1,1
-30,-33,3,1,1,0
-51,-18,-33,0,1,1
-24,14,-38,0,1,1
-16,-7,-9,0,1,1
12,24,-12,0,0,0
-14,15,-29,0,0,0
-13,-23,10,1,0,1
-13,-30,17,1,0,1
-25,-21,-4,0,0,0
5,-27,32,1,0,1
61,20,41,1,0,1
3,-35,38,1,0,1
30,14,16,1,0,1
35,18,17,1,0,1
4,33,-29,0,1,1
-25,0,-25,0,1,1
-33,-28,-5,0,1,1
9,4,5,1,1,0
-33,-16,-17,0,1,1
39,40,-1,0,1,1
-19,5,-24,0,1,1
-28,-6,-22,0,1,1
-2,16,-18,0,1,1
46,37,9,1,1,0
43,14,29,1,1,0
-7,-40,33,1,1,0
-36,-33,-3,0,1,1
18,-25,43,1,0,1
-32,-12,-20,0,0,0
-69,-24,-45,0,0,0
-27,-35,8,1,0,1
-16,-19,3,1,0,1
-7,-36,29,1,0,1
-44,-42,-2,0,0,0
25,23,2,1,0,1
-13,-18,5,1,1,0
-18,-4,-14,0,1,1
5,29,-24,0,1,1
-71,-42,-29,0,1,1
-25,-7,-18,0,1,1
7,27,-20,0,1,1
72,43,29,1,1,0
17,-11,28,1,1,0
24,28,-4,0,1,1
-57,-40,-17,0,1,1
3,23,-20,0,1,1
2,5,-3,0,1,1
-28,8,-36,0,1,1
13,18,-5,0,1,1
-25,4,-29,0,0,0
42,4,38,1,0,1
11,-34,45,1,0,1
2,-29,31,1,0,1
14,-6,20,1,0,1
-19,17,-36,0,0,0
83,42,41,1,0,1
-6,31,-37,0,0,0
-27,-37,10,1,0,1
-5,-5,0,0,0,0
-9,-18,9,1,0,1
-18,25,-43,0,0,0
-19,26,-45,0,0,0
14,4,10,1,0,1
51,10,41,1,0,1
-20,16,-36,0,0,0
-67,-31,-36,0,0,0
-3,4,-7,0,0,0
-63,-19,-44,0,0,0
12,39,-27,0,0,0
11,34,-23,0,0,0
19,-10,29,1,1,0
-77,-44,-33,0,1,1
-32,-15,-17,0,1,1
35,-6,41,1,1,0
1,33,-32,0,1,1
-31,-30,-1,0,1,1
10,12,-2,0,1,1
31,24,7,1,1,0
-33,-33,0,0,1,1
-56,-29,-27,0,1,1
44,42,2,1,1,0
-7,-10,3,1,1,0
-29,3,-32,0,1,1
-83,-41,-42,0,1,1
-52,-40,-12,0,1,1
4,-11,15,1,1,0
70,30,40,1,1,0
-1,-2,1,1,1,0
27,-18,45,1,1,0
44,6,38,1,1,0
35,8,27,1,1,0
37,-7,44,1,0,1
-14,27,-41,0,0,0
43,42,1,1,0,1
-28,5,-33,0,0,0
-4,-30,26,1,0,1
34,28,6,1,0,1
6,-35,41,1,0,1
-7,-6,-1,0,0,0
-42,-31,-11,0,0,0
2,-16,18,1,0,1
54,14,40,1,0,1
-67,-23,-44,0,0,0
10,-12,22,1,1,0
-34,-43,9,1,1,0
8,-31,39,1,1,0
-56,-28,-28,0,1,1
-63,-28,-35,0,1,1
11,8,3,1,1,0
33,35,-2,0,1,1
16,-13,29,1,1,0
23,7,16,1,1,0
-1,2,-3,0,1,1
-69,-41,-28,0,1,1
15,-7,22,1,1,0
5,9,-4,0,1,1
26,42,-16,0,1,1
8,11,-3,0,1,1
-8,-36,28,1,1,0
57,27,30,1,1,0
-3,-13,10,1,1,0
83,40,43,1,1,0
19,-2,21,1,1,0
-16,-38,22,1,1,0
-64,-41,-23,0,0,0
32,-3,35,1,0,1
-12,-19,7,1,0,1
-81,-41,-40,0,0,0
48,39,9,1,0,1
0,-13,13,1,0,1
-33,-7,-26,0,0,0
3,-20,23,1,0,1
-20,-3,-17,0,1,1
-27,-34,7,1,1,0
29,6,23,1,1,0
46,15,31,1,1,0
9,-26,35,1,1,0
-32,11,-43,0,1,1
-63,-45,-18,0,1,1
-32,8,-40,0,1,1
33,0,33,1,1,0
-16,-15,-1,0,1,1
29,21,8,1,1,0
-51,-10,-41,0,1,1
-9,28,-37,0,1,1
-56,-30,-26,0,1,1
-19,11,-30,0,1,1
31,22,9,1,1,0
-25,-18,-7,0,1,1
19,33,-14,0,1,1
-23,-32,9,1,1,0
32,24,8,1,1,0
12,4,8,1,1,0
-10,10,-20,0,0,0
41,15,26,1,0,1
4,37,-33,0,0,0
-36,-17,-19,0,0,0
-65,-20,-45,0,0,0
-5,7,-12,0,0,0
14,38,-24,0,0,0
8,-17,25,1,0,1
56,21,35,1,0,1
-37,-33,-4,0,0,0
-3,31,-34,0,0,0
-20,-30,10,1,0,1
39,-3,42,1,0,1
14,-17,31,1,0,1
43,35,8,1,0,1
-69,-25,-44,0,0,0
-25,-16,-9,0,0,0
10,-17,27,1,0,1
0,-19,19,1,0,1
-67,-41,-26,0,0,0
-64,-45,-19,0,0,0
-38,-15,-23,0,1,1
24,41,-17,0,1,1
7,-18,25,1,1,0
-29,-33,4,1,1,0
-41,-12,-29,0,1,1
-16,15,-31,0,1,1
-11,29,-40,0,1,1
14,17,-3,0,1,1
-37,-20,-17,0,1,1
51,12,39,1,1,0
-18,-24,6,1,1,0
17,20,-3,0,1,1
26,27,-1,0,1,1
9,-36,45,1,1,0
-56,-19,-37,0,1,1
52,37,15,1,1,0
55,38,17,1,1,0
14,38,-24,0,1,1
42,0,42,1,1,0
-21,11,-32,0,1,1
-2,27,-29,0,1,1
59,18,41,1,0,1
51,35,16,1,0,1
-39,-34,-5,0,0,0
46,27,19,1,0,1
-3,32,-35,0,0,0
22,32,-10,0,0,0
25,41,-16,0,0,0
56,30,26,1,0,1
-14,-19,5,1,0,1
12,44,-32,0,0,0
-42,-42,0,0,0,0
-25,16,-41,0,0,0
57,13,44,1,1,0
5,-15,20,1,1,0
43,32,11,1,1,0
-2,-10,8,1,1,0
-17,23,-40,0,1,1
16,23,-7,0,1,1
21,41,-20,0,1,1
33,34,-1,0,1,1
10,4,6,1,1,0
-1,35,-36,0,1,1
-21,-35,14,1,1,0
-28,-11,-17,0,1,1
-42,0,-42,0,1,1
5,3,2,1,1,0
57,25,32,1,1,0
-12,-7,-5,0,1,1
-7,-27,20,1,1,0
-2,19,-21,0,1,1
-21,-13,-8,0,1,1
81,40,41,1,1,0
-18,-3,-15,0,1,1
71,38,33,1,0,1
43,14,29,1,0,1
-72,-38,-34,0,0,0
-45,-6,-39,0,0,0
-55,-45,-10,0,0,0
77,35,42,1,0,1
33,24,9,1,0,1
-39,0,-39,0,0,0
-41,-26,-15,0,1,1
36,1,35,1,1,0
27,-2,29,1,1,0
9,32,-23,0,1,1
-7,-41,34,1,1,0
-31,-13,-18,0,1,1
-23,-9,-14,0,1,1
4,-22,26,1,1,0
33,1,32,1,1,0
-33,-23,-10,0,1,1
-41,-43,2,1,1,0
-4,10,-14,0,1,1
47,25,22,1,1,0
57,18,39,1,1,0
-8,2,-10,0,0,0
-40,-26,-14,0,0,0
-43,-28,-15,0,0,0
29,-14,43,1,0,1
-53,-22,-31,0,0,0
-64,-34,-30,0,0,0
-67,-31,-36,0,0,0
5,32,-27,0,0,0
41,31,10,1,0,1
15,-18,33,1,0,1
-11,-21,10,1,0,1
-31,2,-33,0,1,1
28,2,26,1,1,0
-3,34,-37,0,1,1
-6,14,-20,0,1,1
17,19,-2,0,1,1
3,-33,36,1,1,0
-3,32,-35,0,1,1
-10,-31,21,1,1,0
46,4,42,1,1,0
66,27,39,1,0,1
21,-22,43,1,0,1
25,-15,40,1,0,1
-9,-7,-2,0,0,0
-2,12,-14,0,0,0
2,-12,14,1,0,1
52,43,9,1,0,1
-64,-30,-34,0,0,0
10,-8,18,1,0,1
7,-8,15,1,0,1
-53,-10,-43,0,0,0
13,31,-18,0,0,0
-23,9,-32,0,1,1
-44,-7,-37,0,1,1
33,42,-9,0,1,1
61,39,22,1,1,0
-11,-3,-8,0,1,1
-19,-3,-16,0,1,1
34,7,27,1,1,0
85,40,45,1,1,0
-58,-27,-31,0,1,1
83,44,39,1,1,0
-18,-9,-9,0,1,1
-87,-45,-42,0,1,1
-9,31,-40,0,1,1
-28,5,-33,0,1,1
42,43,-1,0,0,0
59,23,36,1,0,1
2,14,-12,0,0,0
47,30,17,1,0,1
-61,-16,-45,0,0,0
53,32,21,1,0,1
46,14,32,1,0,1
-17,-16,-1,0,0,0
-2,21,-23,0,0,0
10,-23,33,1,0,1
-18,17,-35,0,0,0
46,18,28,1,0,1
9,-1,10,1,0,1
-11,28,-39,0,0,0
9,41,-32,0,0,0
39,24,15,1,0,1
-4,-24,20,1,0,1
-50,-29,-21,0,0,0
-7,19,-26,0,0,0
45,13,32,1,0,1
-75,-31,-44,0,0,0
-9,-27,18,1,1,0
18,-19,37,1,1,0
-10,-18,8,1,1,0
20,19,1,1,1,0
-4,14,-18,0,1,1
29,26,3,1,1,0
41,16,25,1,1,0
-63,-32,-31,0,1,1
-50,-5,-45,0,1,1
-75,-42,-33,0,1,1
-35,10,-45,0,1,1
79,35,44,1,0,1
31,29,2,1,0,1
31,19,12,1,0,1
31,-4,35,1,0,1
-11,-26,15,1,0,1
11,42,-31,0,0,0
16,42,-26,0,0,0
54,43,11,1,0,1
-33,4,-37,0,0,0
-59,-40,-19,0,0,0
47,22,25,1,0,1
-2,27,-29,0,0,0
-28,-3,-25,0,0,0
31,-4,35,1,0,1
33,28,5,1,1,0
-9,-45,36,1,1,0
22,8,14,1,1,0
-6,-24,18,1,1,0
-34,-26,-8,0,1,1
29,-3,32,1,1,0
-3,-31,28,1,1,0
0,-14,14,1,1,0
5,-12,17,1,1,0
-10,6,-16,0,1,1
-37,7,-44,0,0,0
26,-13,39,1,0,1
-8,0,-8,0,0,0
-14,-22,8,1,0,1
-8,25,-33,0,0,0
12,24,-12,0,0,0
23,-11,34,1,0,1
-57,-26,-31,0,0,0
-74,-43,-31,0,0,0
-6,-35,29,1,0,1
9,-7,16,1,0,1
-48,-14,-34,0,0,0
-4,-15,11,1,0,1
60,30,30,1,0,1
17,41,-24,0,0,0
-10,-28,18,1,0,1
-14,-25,11,1,0,1
-41,-33,-8,0,0,0
7,-14,21,1,0,1
2,19,-17,0,0,0
-41,-38,-3,0,0,0
-24,-6,-18,0,1,1
40,22,18,1,1,0
47,28,19,1,1,0
14,35,-21,0,1,1
17,-22,39,1,1,0
-43,-11,-32,0,1,1
48,44,4,1,1,0
2,-20,22,1,1,0
-59,-44,-15,0,1,1
78,36,42,1,1,0
74,30,44,1,1,0
6,-11,17,1,1,0
4,-20,24,1,1,0
-63,-40,-23,0,1,1
-19,16,-35,0,1,1
55,28,27,1,1,0
-42,-43,1,1,1,0
40,22,18,1,1,0
88,43,45,1,1,0
-16,-39,23,1,1,0
-14,9,-23,0,1,1
71,41,30,1,0,1
-18,2,-20,0,0,0
-6,3,-9,0,0,0
16,-13,29,1,0,1
-77,-40,-37,0,0,0
83,38,45,1,0,1
55,38,17,1,0,1
22,25,-3,0,0,0
-19,4,-23,0,0,0
-15,-6,-9,0,0,0
37,23,14,1,0,1
-5,36,-41,0,0,0
-53,-26,-27,0,0,0
-24,-8,-16,0,0,0
11,-30,41,1,0,1
41,44,-3,0,1,1
1,-11,12,1,1,0
-45,-14,-31,0,1,1
-27,-1,-26,0,1,1
-16,-8,-8,0,1,1
-18,19,-37,0,1,1
-56,-17,-39,0,1,1
-44,-4,-40,0,1,1
57,15,42,1,1,0
-24,1,-25,0,1,1
3,32,-29,0,1,1
-61,-24,-37,0,1,1
33,29,4,1,1,0
4,26,-22,0,1,1
41,43,-2,0,1,1
6,28,-22,0,1,1
53,30,23,1,1,0
0,-16,16,1,1,0
44,28,16,1,1,0
-28,-30,2,1,1,0
18,-1,19,1,1,0
18,39,-21,0,0,0
72,41,31,1,0,1
49,22,27,1,0,1
34,33,1,1,0,1
2,18,-16,0,0,0
-53,-34,-19,0,0,0
10,12,-2,0,0,0
44,31,13,1,0,1
-29,-21,-8,0,0,0
60,43,17,1,0,1
-31,-37,6,1,0,1
3,33,-30,0,0,0
23,17,6,1,0,1
2,13,-11,0,0,0
10,2,8,1,0,1
-14,-11,-3,0,1,1
33,-12,45,1,1,0
-13,-6,-7,0,1,1
-56,-16,-40,0,1,1
-41,-43,2,1,1,0
-15,1,-16,0,1,1
-35,1,-36,0,1,1
-24,-18,-6,0,1,1
-43,-14,-29,0,1,1
31,-11,42,1,1,0
-22,-3,-19,0,1,1
54,24,30,1,1,0
15,6,9,1,1,0
-47,-4,-43,0,1,1
-34,-31,-3,0,1,1
34,42,-8,0,1,1
-35,-31,-4,0,1,1
-64,-26,-38,0,1,1
-27,11,-38,0,1,1
-65,-22,-43,0,1,1
5,43,-38,0,1,1
-46,-5,-41,0,0,0
-27,-20,-7,0,0,0
-40,-32,-8,0,0,0
44,36,8,1,0,1
25,41,-16,0,0,0
53,31,22,1,0,1
28,32,-4,0,0,0
-12,-14,2,1,0,1
-2,-37,35,1,1,0
-9,-5,-4,0,1,1
-19,-44,25,1,1,0
-27,10,-37,0,1,1
75,32,43,1,1,0
73,33,40,1,1,0
-12,-6,-6,0,1,1
-1,-42,41,1,1,0
83,44,39,1,1,0
-23,-11,-12,0,1,1
19,27,-8,0,1,1
-5,35,-40,0,1,1
8,17,-9,0,1,1
7,3,4,1,1,0
-11,10,-21,0,1,1
-17,-24,7,1,1,0
-17,-13,-4,0,1,1
-8,3,-11,0,0,0
20,1,19,1,0,1
-30,15,-45,0,0,0
3,-33,36,1,0,1
10,43,-33,0,0,0
-34,-9,-25,0,0,0
55,12,43,1,0,1
12,39,-27,0,0,0
36,13,23,1,0,1
28,44,-16,0,1,1
-4,-35,31,1,1,0
24,15,9,1,1,0
-47,-23,-24,0,1,1
33,36,-3,0,1,1
-30,-24,-6,0,1,1
-41,-32,-9,0,1,1
32,44,-12,0,1,1
8,-36,44,1,1,0
-47,-42,-5,0,1,1
-22,-24,2,1,1,0
-17,-32,15,1,1,0
31,22,9,1,1,0
-14,-1,-13,0,1,1
-18,-37,19,1,1,0
68,43,25,1,1,0
-32,6,-38,0,1,1
-32,-21,-11,0,1,1
-48,-23,-25,0,1,1
-33,0,-33,0,0,0
-16,-7,-9,0,0,0
-2,16,-18,0,0,0
-14,-44,30,1,0,1
-3,26,-29,0,0,0
-50,-14,-36,0,0,0
-45,-23,-22,0,0,0
80,41,39,1,0,1
2,-42,44,1,0,1
67,28,39,1,0,1
27,33,-6,0,0,0
-54,-32,-22,0,0,0
11,12,-1,0,0,0
-5,29,-34,0,0,0
-41,-28,-13,0,0,0
-18,-14,-4,0,0,0
-22,-43,21,1,0,1
-69,-45,-24,0,1,1
-64,-19,-45,0,1,1
28,-17,45,1,1,0
-49,-27,-22,0,1,1
38,27,11,1,1,0
38,5,33,1,1,0
13,-22,35,1,1,0
0,-6,6,1,1,0
30,7,23,1,1,0
37,25,12,1,1,0
-14,7,-21,0,1,1
-25,-30,5,1,1,0
-39,-38,-1,0,1,1
28,12,16,1,0,1
-53,-18,-35,0,0,0
-27,-8,-19,0,0,0
79,38,41,1,0,1
-72,-30,-42,0,0,0
-20,-39,19,1,0,1
48,38,10,1,0,1
20,-20,40,1,0,1
38,30,8,1,1,0
-3,-45,42,1,1,0
13,4,9,1,1,0
15,37,-22,0,1,1
-37,-18,-19,0,1,1
-50,-45,-5,0,1,1
-9,31,-40,0,1,1
2,-38,40,1,1,0
-31,-27,-4,0,1,1
-12,14,-26,0,1,1
1,-38,39,1,0,1
-1,-44,43,1,0,1
34,-8,42,1,0,1
33,-2,35,1,0,1
7,-6,13,1,0,1
13,11,2,1,0,1
59,29,30,1,0,1
-16,-25,9,1,0,1
78,34,44,1,0,1
-22,-29,7,1,0,1
32,0,32,1,0,1
22,-4,26,1,0,1
19,-10,29,1,0,1
-31,-4,-27,0,0,0
-42,-7,-35,0,0,0
5,-8,13,1,0,1
-13,-45,32,1,0,1
-18,-24,6,1,0,1
-58,-43,-15,0,0,0
-10,-27,17,1,0,1
1,-10,11,1,0,1
12,31,-19,0,1,1
8,36,-28,0,1,1
-48,-30,-18,0,1,1
-58,-22,-36,0,1,1
-18,-34,16,1,1,0
-38,-26,-12,0,1,1
80,38,42,1,1,0
47,31,16,1,1,0
-24,-38,14,1,1,0
-26,-14,-12,0,1,1
-38,-42,4,1,1,0
25,41,-16,0,1,1
-34,-28,-6,0,1,1
8,14,-6,0,1,1
23,38,-15,0,1,1
59,14,45,1,1,0
3,-39,42,1,1,0
-52,-33,-19,0,1,1
13,35,-22,0,1,1
5,6,-1,0,1,1
1,33,-32,0,0,0
-67,-29,-38,0,0,0
-3,-20,17,1,0,1
7,9,-2,0,0,0
43,39,4,1,0,1
-6,18,-24,0,0,0
-18,25,-43,0,0,0
40,40,0,0,0,0
-29,-33,4,1,0,1
-13,17,-30,0,0,0
-7,-27,20,1,0,1
-17,-23,6,1,0,1
-35,-30,-5,0,0,0
-35,-21,-14,0,0,0
-46,-35,-11,0,0,0
33,0,33,1,0,1
-44,-31,-13,0,0,0
-7,-41,34,1,0,1
23,28,-5,0,0,0
-28,-18,-10,0,1,1
-21,-18,-3,0,1,1
46,39,7,1,1,0
68,32,36,1,1,0
63,43,20,1,1,0
36,20,16,1,1,0
-41,-12,-29,0,1,1
2,-14,16,1,1,0
2,-27,29,1,1,0
9,22,-13,0,1,1
-69,-33,-36,0,1,1
-26,-42,16,1,1,0
1,10,-9,0,1,1
-8,6,-14,0,1,1
-48,-11,-37,0,0,0
-29,-34,5,1,0,1
11,-14,25,1,0,1
74,34,40,1,0,1
20,31,-11,0,0,0
-8,-8,0,0,0,0
-43,-3,-40,0,0,0
5,28,-23,0,0,0
-21,13,-34,0,0,0
83,40,43,1,0,1
-49,-25,-24,0,0,0
-37,-40,3,1,0,1
-1,30,-31,0,0,0
54,9,45,1,0,1
10,22,-12,0,0,0
-10,-23,13,1,0,1
74,44,30,1,0,1
42,5,37,1,0,1
-26,-21,-5,0,0,0
-6,6,-12,0,0,0
-28,-9,-19,0,0,0
5,-16,21,1,1,0
35,41,-6,0,1,1
24,27,-3,0,1,1
45,13,32,1,1,0
19,-16,35,1,1,0
-54,-29,-25,0,1,1
17,18,-1,0,1,1
-60,-39,-21,0,1,1
13,13,0,0,1,1
-22,17,-39,0,1,1
61,33,28,1,1,0
27,38,-11,0,1,1
-23,11,-34,0,1,1
10,-4,14,1,1,0
-66,-42,-24,0,1,1
-28,-35,7,1,1,0
58,20,38,1,1,0
65,35,30,1,1,0
-14,-17,3,1,1,0
1,8,-7,0,1,1
-47,-17,-30,0,1,1
-5,6,-11,0,0,0
-2,-39,37,1,0,1
0,-43,43,1,0,1
23,44,-21,0,0,0
2,-18,20,1,0,1
15,5,10,1,0,1
-21,5,-26,0,0,0
-79,-34,-45,0,0,0
-86,-45,-41,0,0,0
61,30,31,1,0,1
58,26,32,1,0,1
-12,2,-14,0,0,0
-4,-39,35,1,0,1
42,-2,44,1,0,1
-35,-6,-29,0,0,0
10,-3,13,1,0,1
-24,-42,18,1,0,1
-9,-23,14,1,0,1
-16,19,-35,0,0,0
-23,-41,18,1,0,1
24,-13,37,1,1,0
-12,-42,30,1,1,0
24,5,19,1,1,0
36,17,19,1,1,0
-14,-9,-5,0,1,1
43,23,20,1,1,0
29,-10,39,1,1,0
-54,-19,-35,0,1,1
-9,24,-33,0,1,1
-12,20,-32,0,1,1
-43,-15,-28,0,1,1
6,-24,30,1,0,1
5,-33,38,1,0,1
-77,-39,-38,0,0,0
-39,-35,-4,0,0,0
-66,-28,-38,0,0,0
4,-32,36,1,0,1
52,36,16,1,0,1
-13,-8,-5,0,0,0
-23,-2,-21,0,0,0
-38,-13,-25,0,0,0
30,42,-12,0,0,0
-1,28,-29,0,0,0
31,30,1,1,0,1
65,22,43,1,0,1
-50,-35,-15,0,0,0
6,32,-26,0,0,0
8,-17,25,1,0,1
-28,-1,-27,0,0,0
-24,-2,-22,0,0,0
45,26,19,1,0,1
63,23,40,1,0,1
18,-4,22,1,1,0
-11,8,-19,0,1,1
26,-1,27,1,1,0
59,30,29,1,1,0
-8,-38,30,1,1,0
-23,6,-29,0,1,1
77,42,35,1,1,0
19,2,17,1,1,0
43,5,38,1,1,0
30,-15,45,1,0,1
-15,11,-26,0,0,0
-4,-32,28,1,0,1
41,23,18,1,0,1
25,-14,39,1,0,1
-5,2,-7,0,0,0
-18,-31,13,1,0,1
69,38,31,1,0,1
-23,-8,-15,0,1,1
-18,-27,9,1,1,0
-70,-43,-27,0,1,1
-9,-32,23,1,1,0
11,-30,41,1,1,0
-12,22,-34,0,1,1
25,5,20,1,1,0
-56,-44,-12,0,1,1
7,-11,18,1,1,0
-28,-45,17,1,1,0
38,34,4,1,1,0
-20,-14,-6,0,1,1
-6,20,-26,0,0,0
27,29,-2,0,0,0
-13,-29,16,1,0,1
-27,-30,3,1,0,1
2,3,-1,0,0,0
39,28,11,1,0,1
-48,-14,-34,0,0,0
-51,-25,-26,0,0,0
-2,23,-25,0,0,0
-48,-45,-3,0,0,0
46,30,16,1,1,0
-21,9,-30,0,1,1
-35,-39,4,1,1,0
-29,-24,-5,0,1,1
62,39,23,1,1,0
-1,-18,17,1,1,0
-6,30,-36,0,1,1
76,33,43,1,1,0
-69,-26,-43,0,1,1
6,17,-11,0,1,1
20,-6,26,1,1,0
-24,-9,-15,0,1,1
38,-5,43,1,1,0
1,-22,23,1,0,1
15,0,15,1,0,1
-14,-1,-13,0,0,0
-50,-39,-11,0,0,0
33,0,33,1,0,1
10,33,-23,0,0,0
30,34,-4,0,0,0
47,34,13,1,0,1
19,32,-13,0,0,0
