first_image,second_image,answers,correct_answer,rule,action
-16,29,-45,0,1,1
56,35,21,1,1,0
17,21,-4,0,1,1
-63,-40,-23,0,1,1
-47,-17,-30,0,1,1
16,28,-12,0,1,1
9,-34,43,1,1,0
64,35,29,1,1,0
29,24,5,1,1,0
33,29,4,1,1,0
-10,35,-45,0,1,1
30,30,0,0,1,1
-11,-7,-4,0,1,1
-16,-14,-2,0,0,0
3,6,-3,0,0,0
-40,-14,-26,0,0,0
35,20,15,1,0,1
-53,-36,-17,0,0,0
0,26,-26,0,0,0
-20,-22,2,1,0,1
28,-7,35,1,0,1
8,-28,36,1,0,1
13,10,3,1,0,1
-46,-29,-17,0,0,0
-10,-30,20,1,0,1
-26,-29,3,1,0,1
0,-44,44,1,0,1
-50,-6,-44,0,0,0
80,39,41,1,0,1
-38,-1,-37,0,1,1
-7,18,-25,0,1,1
9,-6,15,1,1,0
-10,-18,8,1,1,0
22,7,15,1,1,0
78,42,36,1,1,0
12,-25,37,1,1,0
6,-1,7,1,1,0
57,33,24,1,1,0
77,40,37,1,1,0
-45,-10,-35,0,1,1
-7,24,-31,0,1,1
-17,-13,-4,0,1,1
-39,-38,-1,0,1,1
-57,-24,-33,0,1,1
-41,-7,-34,0,1,1
-32,11,-43,0,1,1
30,41,-11,0,1,1
16,10,6,1,1,0
-1,-24,23,1,1,0
26,-17,43,1,1,0
55,25,30,1,0,1
-41,-24,-17,0,0,0
-46,-17,-29,0,0,0
31,-12,43,1,0,1
22,34,-12,0,0,0
-31,-45,14,1,0,1
8,12,-4,0,0,0
-82,-42,-40,0,0,0
15,-18,33,1,0,1
4,-4,8,1,0,1
42,8,34,1,0,1
35,21,14,1,0,1
42,41,1,1,0,1
-15,-45,30,1,0,1
-69,-35,-34,0,0,0
24,-13,37,1,1,0
-33,-1,-32,0,1,1
-7,-33,26,1,1,0
-24,-34,10,1,1,0
-14,7,-21,0,1,1
4,-32,36,1,1,0
-15,-25,10,1,1,0
-64,-43,-21,0,1,1
-6,-20,14,1,1,0
-9,12,-21,0,1,1
-3,40,-43,0,1,1
50,38,12,1,1,0
-25,-23,-2,0,1,1
10,-27,37,1,1,0
-29,-44,15,1,1,0
-19,9,-28,0,1,1
-1,28,-29,0,1,1
64,21,43,1,1,0
-20,-28,8,1,0,1
-13,-20,7,1,0,1
-80,-40,-40,0,0,0
-5,1,-6,0,0,0
-19,-4,-15,0,0,0
-6,-15,9,1,0,1
-68,-42,-26,0,0,0
20,-14,34,1,0,1
-12,-17,5,1,0,1
1,33,-32,0,0,0
28,24,4,1,0,1
-13,-16,3,1,1,0
38,-2,40,1,1,0
-12,-27,15,1,1,0
-35,-38,3,1,1,0
3,-21,24,1,1,0
40,2,38,1,1,0
-77,-45,-32,0,1,1
-17,-39,22,1,1,0
-72,-40,-32,0,1,1
14,-17,31,1,1,0
-16,-27,11,1,1,0
32,17,15,1,1,0
25,-6,31,1,1,0
20,41,-21,0,1,1
28,23,5,1,1,0
-53,-38,-15,0,1,1
-6,-13,7,1,1,0
-72,-28,-44,0,1,1
8,15,-7,0,1,1
-8,33,-41,0,1,1
-18,-29,11,1,0,1
-51,-8,-43,0,0,0
-10,-15,5,1,0,1
-24,-43,19,1,0,1
-19,-45,26,1,0,1
-20,-36,16,1,0,1
59,33,26,1,0,1
-21,-5,-16,0,0,0
-5,39,-44,0,1,1
-28,-34,6,1,1,0
-1,12,-13,0,1,1
35,26,9,1,1,0
-24,8,-32,0,1,1
13,-23,36,1,1,0
64,35,29,1,1,0
47,7,40,1,1,0
-33,-3,-30,0,1,1
16,42,-26,0,1,1
-42,-42,0,0,0,0
14,-25,39,1,0,1
-45,-33,-12,0,0,0
0,-5,5,1,0,1
19,40,-21,0,0,0
63,29,34,1,0,1
25,-4,29,1,0,1
-12,29,-41,0,0,0
27,39,-12,0,0,0
-26,-32,6,1,0,1
-28,8,-36,0,0,0
0,40,-40,0,0,0
-8,30,-38,0,0,0
-5,-17,12,1,0,1
-33,-13,-20,0,0,0
17,26,-9,0,1,1
-43,-15,-28,0,1,1
-13,16,-29,0,1,1
25,8,17,1,1,0
-60,-31,-29,0,1,1
-65,-22,-43,0,1,1
23,-10,33,1,1,0
-24,-5,-19,0,1,1
-11,-16,5,1,1,0
-5,-38,33,1,1,0
-6,14,-20,0,1,1
-29,10,-39,0,1,1
38,6,32,1,1,0
-13,20,-33,0,1,1
40,10,30,1,1,0
20,-23,43,1,1,0
-56,-40,-16,0,1,1
7,11,-4,0,1,1
-33,-27,-6,0,1,1
-87,-44,-43,0,1,1
-31,-17,-14,0,1,1
-4,-7,3,1,0,1
-50,-41,-9,0,0,0
-37,-17,-20,0,0,0
4,33,-29,0,0,0
-31,-19,-12,0,0,0
-25,14,-39,0,0,0
-4,-4,0,0,0,0
-28,-33,5,1,0,1
77,44,33,1,0,1
-52,-41,-11,0,0,0
-55,-32,-23,0,0,0
8,22,-14,0,0,0
-18,4,-22,0,0,0
-43,-39,-4,0,0,0
-7,27,-34,0,0,0
36,5,31,1,0,1
-22,9,-31,0,1,1
-58,-42,-16,0,1,1
77,36,41,1,1,0
88,43,45,1,1,0
40,2,38,1,1,0
-63,-40,-23,0,1,1
-37,-5,-32,0,1,1
-49,-8,-41,0,1,1
-44,-3,-41,0,1,1
-10,24,-34,0,1,1
-11,10,-21,0,1,1
-40,-15,-25,0,1,1
22,41,-19,0,1,1
-44,-19,-25,0,1,1
-16,-7,-9,0,1,1
65,22,43,1,1,0
-35,-18,-17,0,1,1
10,3,7,1,1,0
0,-21,21,1,1,0
-16,-29,13,1,1,0
1,-19,20,1,1,0
-40,-18,-22,0,0,0
9,-9,18,1,0,1
-37,-41,4,1,0,1
32,42,-10,0,0,0
-29,-21,-8,0,0,0
-55,-10,-45,0,0,0
16,-4,20,1,0,1
-27,-2,-25,0,0,0
75,36,39,1,0,1
48,7,41,1,0,1
8,-32,40,1,0,1
-33,-26,-7,0,0,0
42,3,39,1,0,1
16,-5,21,1,0,1
63,44,19,1,0,1
-1,18,-19,0,0,0
65,34,31,1,0,1
16,34,-18,0,0,0
29,29,0,0,0,0
66,28,38,1,0,1
0,-40,40,1,0,1
-64,-27,-37,0,1,1
-55,-31,-24,0,1,1
85,44,41,1,1,0
-40,-25,-15,0,1,1
35,18,17,1,1,0
-71,-30,-41,0,1,1
-6,-35,29,1,1,0
-21,-35,14,1,1,0
-16,-6,-10,0,1,1
-14,27,-41,0,1,1
-44,-28,-16,0,0,0
-13,-29,16,1,0,1
-1,-2,1,1,0,1
-38,-2,-36,0,0,0
57,14,43,1,0,1
1,30,-29,0,0,0
85,41,44,1,0,1
-12,0,-12,0,0,0
1,-38,39,1,0,1
-26,-38,12,1,0,1
21,6,15,1,0,1
-17,-45,28,1,0,1
80,41,39,1,1,0
78,34,44,1,1,0
34,-8,42,1,1,0
-35,-24,-11,0,1,1
57,24,33,1,1,0
48,42,6,1,1,0
-56,-18,-38,0,1,1
-26,-38,12,1,1,0
-72,-35,-37,0,1,1
9,14,-5,0,1,1
-34,9,-43,0,1,1
-2,-21,19,1,1,0
3,33,-30,0,1,1
32,29,3,1,1,0
-24,-25,1,1,1,0
-20,-25,5,1,1,0
30,30,0,0,1,1
-21,-6,-15,0,1,1
25,-3,28,1,1,0
29,17,12,1,0,1
38,33,5,1,0,1
-81,-43,-38,0,0,0
5,-19,24,1,0,1
-48,-8,-40,0,0,0
54,32,22,1,0,1
-15,0,-15,0,0,0
-36,-4,-32,0,0,0
-22,-13,-9,0,0,0
29,24,5,1,0,1
26,-17,43,1,0,1
-38,7,-45,0,0,0
-32,11,-43,0,0,0
22,-16,38,1,0,1
-59,-32,-27,0,1,1
-44,-39,-5,0,1,1
-33,-26,-7,0,1,1
39,42,-3,0,1,1
47,39,8,1,1,0
-15,10,-25,0,1,1
-45,-17,-28,0,1,1
-56,-23,-33,0,1,1
-18,16,-34,0,1,1
15,18,-3,0,1,1
40,40,0,0,1,1
47,36,11,1,1,0
8,23,-15,0,1,1
-41,-28,-13,0,1,1
41,7,34,1,1,0
3,33,-30,0,1,1
74,32,42,1,0,1
-47,-29,-18,0,0,0
-1,29,-30,0,0,0
4,-11,15,1,0,1
-16,-12,-4,0,0,0
-8,-43,35,1,0,1
49,7,42,1,0,1
2,-3,5,1,0,1
-63,-38,-25,0,0,0
-18,-4,-14,0,0,0
66,35,31,1,1,0
1,-28,29,1,1,0
-6,-45,39,1,1,0
-17,-4,-13,0,1,1
28,32,-4,0,1,1
-56,-25,-31,0,1,1
20,-8,28,1,1,0
-30,-37,7,1,1,0
-2,12,-14,0,1,1
9,20,-11,0,1,1
-88,-43,-45,0,0,0
-28,-18,-10,0,0,0
-15,2,-17,0,0,0
-57,-26,-31,0,0,0
4,-28,32,1,0,1
-66,-44,-22,0,0,0
-29,9,-38,0,0,0
14,37,-23,0,0,0
-71,-45,-26,0,0,0
-22,-15,-7,0,0,0
-1,15,-16,0,0,0
35,7,28,1,0,1
13,14,-1,0,0,0
4,-21,25,1,0,1
-4,4,-8,0,0,0
28,43,-15,0,0,0
15,-23,38,1,0,1
-75,-37,-38,0,0,0
-80,-37,-43,0,0,0
57,28,29,1,1,0
-23,4,-27,0,1,1
79,38,41,1,1,0
-53,-42,-11,0,1,1
-71,-27,-44,0,1,1
17,3,14,1,1,0
16,-27,43,1,1,0
0,22,-22,0,1,1
12,23,-11,0,1,1
-13,20,-33,0,1,1
31,-9,40,1,1,0
5,24,-19,0,1,1
53,18,35,1,1,0
-5,-40,35,1,1,0
-39,-20,-19,0,1,1
-8,6,-14,0,1,1
-47,-2,-45,0,1,1
22,-8,30,1,1,0
34,-1,35,1,1,0
-20,-20,0,0,1,1
32,5,27,1,1,0
-24,8,-32,0,0,0
31,20,11,1,0,1
-67,-43,-24,0,0,0
-3,-7,4,1,0,1
35,19,16,1,0,1
-40,-12,-28,0,0,0
-7,28,-35,0,0,0
-40,-32,-8,0,0,0
-31,-10,-21,0,0,0
-52,-22,-30,0,0,0
22,15,7,1,0,1
-2,8,-10,0,0,0
-34,-41,7,1,0,1
69,43,26,1,0,1
-61,-22,-39,0,0,0
0,38,-38,0,0,0
-9,-45,36,1,0,1
-77,-34,-43,0,0,0
-27,-2,-25,0,0,0
64,44,20,1,0,1
-5,30,-35,0,0,0
23,-14,37,1,1,0
-16,4,-20,0,1,1
-68,-23,-45,0,1,1
26,36,-10,0,1,1
59,42,17,1,1,0
-8,17,-25,0,1,1
20,25,-5,0,1,1
81,40,41,1,1,0
-50,-40,-10,0,1,1
-70,-37,-33,0,1,1
40,5,35,1,1,0
-16,27,-43,0,1,1
15,7,8,1,1,0
45,10,35,1,1,0
-83,-38,-45,0,1,1
-30,6,-36,0,0,0
-9,-5,-4,0,0,0
-14,-31,17,1,0,1
71,29,42,1,0,1
-50,-10,-40,0,0,0
-75,-35,-40,0,0,0
-17,-2,-15,0,0,0
-26,-14,-12,0,0,0
-7,-24,17,1,0,1
-44,-7,-37,0,0,0
-20,-38,18,1,0,1
-2,-10,8,1,0,1
-38,-19,-19,0,0,0
38,36,2,1,0,1
75,32,43,1,0,1
-11,-6,-5,0,0,0
-24,18,-42,0,0,0
14,32,-18,0,0,0
60,32,28,1,0,1
8,4,4,1,0,1
-37,4,-41,0,0,0
7,-26,33,1,1,0
53,43,10,1,1,0
-7,-30,23,1,1,0
50,26,24,1,1,0
-61,-37,-24,0,1,1
29,25,4,1,1,0
55,12,43,1,1,0
17,22,-5,0,1,1
36,28,8,1,1,0
-9,-16,7,1,1,0
-55,-22,-33,0,1,1
12,44,-32,0,1,1
29,31,-2,0,1,1
-68,-26,-42,0,1,1
42,23,19,1,1,0
-74,-40,-34,0,1,1
-30,-13,-17,0,1,1
-69,-42,-27,0,1,1
-20,-13,-7,0,1,1
-38,-9,-29,0,1,1
12,43,-31,0,1,1
-39,-43,4,1,0,1
16,-13,29,1,0,1
67,39,28,1,0,1
-22,-44,22,1,0,1
-42,-2,-40,0,0,0
3,-1,4,1,0,1
17,-6,23,1,0,1
80,35,45,1,0,1
-36,-44,8,1,0,1
-27,-25,-2,0,0,0
35,24,11,1,0,1
64,20,44,1,0,1
15,39,-24,0,0,0
9,10,-1,0,0,0
10,20,-10,0,0,0
51,15,36,1,0,1
35,-6,41,1,0,1
-14,19,-33,0,0,0
-79,-42,-37,0,0,0
-12,-13,1,1,1,0
-9,-13,4,1,1,0
-16,-18,2,1,1,0
33,8,25,1,1,0
-24,-37,13,1,1,0
-15,-24,9,1,1,0
17,-16,33,1,1,0
76,35,41,1,1,0
16,31,-15,0,1,1
-5,37,-42,0,1,1
-16,17,-33,0,1,1
-11,30,-41,0,1,1
67,26,41,1,1,0
8,8,0,0,1,1
69,43,26,1,1,0
-63,-18,-45,0,1,1
2,35,-33,0,0,0
-65,-44,-21,0,0,0
76,43,33,1,0,1
-54,-10,-44,0,0,0
10,-35,45,1,0,1
-63,-36,-27,0,0,0
34,4,30,1,0,1
49,38,11,1,0,1
-33,-12,-21,0,0,0
43,8,35,1,0,1
-2,34,-36,0,1,1
14,-7,21,1,1,0
27,36,-9,0,1,1
-5,-39,34,1,1,0
24,30,-6,0,1,1
-2,-22,20,1,1,0
5,28,-23,0,1,1
19,43,-24,0,1,1
53,11,42,1,1,0
-34,-13,-21,0,1,1
67,28,39,1,1,0
-56,-18,-38,0,1,1
-25,-3,-22,0,1,1
-7,-9,2,1,1,0
-20,-14,-6,0,1,1
43,37,6,1,1,0
-29,1,-30,0,1,1
1,32,-31,0,1,1
-15,-14,-1,0,1,1
64,36,28,1,1,0
-54,-35,-19,0,1,1
17,10,7,1,0,1
-5,-45,40,1,0,1
4,14,-10,0,0,0
31,38,-7,0,0,0
-36,2,-38,0,0,0
30,-12,42,1,0,1
-27,-40,13,1,0,1
-47,-18,-29,0,0,0
39,35,4,1,0,1
13,16,-3,0,0,0
17,8,9,1,0,1
24,9,15,1,1,0
10,-34,44,1,1,0
-60,-41,-19,0,1,1
1,-3,4,1,1,0
69,40,29,1,1,0
2,1,1,1,1,0
-10,31,-41,0,1,1
16,0,16,1,1,0
66,27,39,1,1,0
-33,-1,-32,0,1,1
-19,-30,11,1,0,1
31,35,-4,0,0,0
32,26,6,1,0,1
-45,-24,-21,0,0,0
34,31,3,1,0,1
17,6,11,1,0,1
-12,-11,-1,0,0,0
71,31,40,1,0,1
54,9,45,1,0,1
-18,10,-28,0,0,0
23,31,-8,0,0,0
60,19,41,1,0,1
2,-8,10,1,0,1
44,13,31,1,0,1
23,3,20,1,0,1
7,39,-32,0,0,0
47,42,5,1,0,1
16,-29,45,1,0,1
-46,-12,-34,0,0,0
-7,-16,9,1,0,1
3,31,-28,0,0,0
20,4,16,1,1,0
49,26,23,1,1,0
-36,-13,-23,0,1,1
-40,-40,0,0,1,1
53,14,39,1,1,0
7,18,-11,0,1,1
31,13,18,1,1,0
35,35,0,0,1,1
-45,-1,-44,0,1,1
32,18,14,1,1,0
-58,-38,-20,0,1,1
70,35,35,1,1,0
-46,-6,-40,0,1,1
-42,-11,-31,0,1,1
21,28,-7,0,1,1
8,-33,41,1,1,0
-26,-25,-1,0,1,1
15,-12,27,1,0,1
-19,23,-42,0,0,0
-17,24,-41,0,0,0
-47,-7,-40,0,0,0
16,-25,41,1,0,1
-46,-44,-2,0,0,0
-6,-24,18,1,0,1
-31,-29,-2,0,0,0
19,10,9,1,0,1
-64,-41,-23,0,0,0
47,5,42,1,0,1
-80,-43,-37,0,0,0
-19,-1,-18,0,0,0
14,-22,36,1,0,1
-6,27,-33,0,0,0
-11,-19,8,1,0,1
-58,-34,-24,0,0,0
-13,-39,26,1,0,1
1,-40,41,1,0,1
-5,-15,10,1,0,1
43,43,0,0,0,0
-63,-36,-27,0,1,1
-9,18,-27,0,1,1
-12,-21,9,1,1,0
50,23,27,1,1,0
19,6,13,1,1,0
-10,21,-31,0,1,1
63,37,26,1,1,0
-67,-31,-36,0,1,1
53,21,32,1,1,0
-6,-21,15,1,1,0
-44,-22,-22,0,1,1
-30,-14,-16,0,1,1
-63,-18,-45,0,1,1
42,30,12,1,1,0
-16,-22,6,1,1,0
-1,-14,13,1,1,0
24,43,-19,0,1,1
-83,-41,-42,0,1,1
5,33,-28,0,1,1
-79,-39,-40,0,1,1
-21,-15,-6,0,1,1
-11,14,-25,0,0,0
-32,8,-40,0,0,0
32,-8,40,1,0,1
41,16,25,1,0,1
59,41,18,1,0,1
42,5,37,1,0,1
22,42,-20,0,0,0
15,33,-18,0,0,0
4,31,-27,0,0,0
-63,-43,-20,0,0,0
7,35,-28,0,0,0
35,-9,44,1,0,1
32,31,1,1,0,1
-39,-4,-35,0,0,0
-39,-34,-5,0,0,0
-33,-16,-17,0,0,0
9,5,4,1,0,1
30,11,19,1,0,1
19,-3,22,1,0,1
32,41,-9,0,0,0
-33,-39,6,1,0,1
-38,-28,-10,0,1,1
-46,-10,-36,0,1,1
-24,-16,-8,0,1,1
11,-7,18,1,1,0
6,-31,37,1,1,0
-3,15,-18,0,1,1
30,14,16,1,1,0
17,-22,39,1,1,0
30,-13,43,1,1,0
-43,-40,-3,0,1,1
-41,-35,-6,0,1,1
41,14,27,1,1,0
23,24,-1,0,1,1
28,1,27,1,1,0
-26,0,-26,0,1,1
-25,5,-30,0,1,1
-2,17,-19,0,1,1
-2,-19,17,1,1,0
-10,11,-21,0,1,1
9,8,1,1,1,0
-19,-33,14,1,1,0
-18,18,-36,0,0,0
-34,-36,2,1,0,1
21,-17,38,1,0,1
-52,-24,-28,0,0,0
-35,-22,-13,0,0,0
37,12,25,1,0,1
-50,-21,-29,0,0,0
-68,-28,-40,0,0,0
-68,-40,-28,0,0,0
-26,15,-41,0,0,0
9,-22,31,1,0,1
-33,-2,-31,0,0,0
4,-23,27,1,0,1
15,-15,30,1,0,1
37,42,-5,0,0,0
45,41,4,1,1,0
-4,16,-20,0,1,1
-2,-3,1,1,1,0
40,27,13,1,1,0
-24,-24,0,0,1,1
-38,-26,-12,0,1,1
-8,10,-18,0,1,1
22,-18,40,1,1,0
5,7,-2,0,1,1
24,4,20,1,1,0
45,6,39,1,1,0
22,13,9,1,1,0
25,12,13,1,1,0
-23,-5,-18,0,1,1
11,44,-33,0,1,1
-1,-11,10,1,1,0
3,-35,38,1,0,1
4,-20,24,1,0,1
12,1,11,1,0,1
-41,-4,-37,0,0,0
-5,20,-25,0,0,0
43,18,25,1,0,1
46,32,14,1,0,1
-30,-15,-15,0,0,0
38,43,-5,0,0,0
1,5,-4,0,0,0
0,13,-13,0,0,0
64,37,27,1,0,1
-39,-10,-29,0,1,1
-18,-36,18,1,1,0
-53,-40,-13,0,1,1
-16,8,-24,0,1,1
-54,-26,-28,0,1,1
-61,-17,-44,0,1,1
-64,-33,-31,0,1,1
17,-25,42,1,1,0
-14,-6,-8,0,1,1
19,-3,22,1,1,0
62,27,35,1,1,0
-10,-6,-4,0,1,1
6,36,-30,0,1,1
-36,-20,-16,0,1,1
-31,-30,-1,0,1,1
2,-24,26,1,1,0
4,-16,20,1,1,0
-68,-27,-41,0,1,1
-54,-12,-42,0,1,1
-56,-26,-30,0,1,1
26,44,-18,0,1,1
-58,-31,-27,0,0,0
58,35,23,1,0,1
64,35,29,1,0,1
22,0,22,1,0,1
-5,6,-11,0,0,0
29,-4,33,1,0,1
23,-3,26,1,0,1
-29,3,-32,0,0,0
-28,-45,17,1,0,1
48,35,13,1,0,1
35,29,6,1,1,0
22,-12,34,1,1,0
-34,7,-41,0,1,1
-30,-36,6,1,1,0
-27,-39,12,1,1,0
19,9,10,1,1,0
-25,-10,-15,0,1,1
-11,-25,14,1,1,0
-6,4,-10,0,1,1
-28,-43,15,1,1,0
59,29,30,1,1,0
57,36,21,1,1,0
21,12,9,1,1,0
2,43,-41,0,1,1
36,2,34,1,1,0
-6,30,-36,0,0,0
-49,-8,-41,0,0,0
21,-17,38,1,0,1
-12,-15,3,1,0,1
-5,-33,28,1,0,1
-38,-4,-34,0,0,0
57,43,14,1,0,1
43,43,0,0,0,0
-70,-33,-37,0,0,0
-24,9,-33,0,0,0
-37,-24,-13,0,0,0
20,-22,42,1,0,1
51,20,31,1,0,1
-19,-11,-8,0,0,0
-50,-18,-32,0,0,0
53,18,35,1,0,1
-67,-43,-24,0,0,0
-9,6,-15,0,0,0
-27,-30,3,1,0,1
-30,-43,13,1,1,0
-6,39,-45,0,1,1
72,40,32,1,1,0
-4,18,-22,0,1,1
67,41,26,1,1,0
-18,17,-35,0,1,1
-57,-15,-42,0,1,1
27,39,-12,0,1,1
-37,-25,-12,0,1,1
-73,-42,-31,0,1,1
78,35,43,1,1,0
11,16,-5,0,1,1
-11,27,-38,0,1,1
27,-3,30,1,1,0
-20,-26,6,1,1,0
17,-10,27,1,1,0
-14,-26,12,1,1,0
-57,-21,-36,0,1,1
31,11,20,1,1,0
-55,-21,-34,0,1,1
1,-44,45,1,1,0
-76,-41,-35,0,0,0
63,27,36,1,0,1
12,9,3,1,0,1
-40,-13,-27,0,0,0
-38,-36,-2,0,0,0
4,-16,20,1,0,1
-34,9,-43,0,0,0
14,32,-18,0,0,0
-4,39,-43,0,0,0
-27,-24,-3,0,0,0
81,42,39,1,0,1
39,-6,45,1,0,1
-23,-19,-4,0,0,0
-20,2,-22,0,0,0
12,13,-1,0,0,0
49,36,13,1,0,1
-48,-41,-7,0,0,0
33,22,11,1,0,1
-59,-45,-14,0,0,0
-27,-12,-15,0,0,0
-5,40,-45,0,0,0
37,40,-3,0,1,1
55,31,24,1,1,0
35,4,31,1,1,0
-30,-38,8,1,1,0
2,-43,45,1,1,0
-10,-20,10,1,1,0
58,15,43,1,1,0
-13,23,-36,0,1,1
3,29,-26,0,1,1
-1,-15,14,1,1,0
49,4,45,1,1,0
14,-9,23,1,1,0
53,13,40,1,1,0
-9,16,-25,0,1,1
-60,-37,-23,0,1,1
65,35,30,1,1,0
48,38,10,1,1,0
11,28,-17,0,1,1
34,5,29,1,1,0
31,-9,40,1,1,0
19,-18,37,1,1,0
9,-25,34,1,0,1
26,10,16,1,0,1
36,-9,45,1,0,1
6,4,2,1,0,1
21,-13,34,1,0,1
-39,-14,-25,0,0,0
33,6,27,1,0,1
-39,-10,-29,0,0,0
78,36,42,1,0,1
-3,14,-17,0,0,0
62,28,34,1,0,1
7,36,-29,0,0,0
36,10,26,1,0,1
6,30,-24,0,1,1
-9,-39,30,1,1,0
-2,16,-18,0,1,1
-78,-40,-38,0,1,1
22,3,19,1,1,0
-86,-42,-44,0,1,1
-23,-41,18,1,1,0
-30,-18,-12,0,1,1
-5,23,-28,0,1,1
-8,11,-19,0,1,1
-42,-2,-40,0,1,1
-63,-38,-25,0,0,0
-15,11,-26,0,0,0
-16,2,-18,0,0,0
5,14,-9,0,0,0
-35,-26,-9,0,0,0
-3,10,-13,0,0,0
34,29,5,1,0,1
29,-13,42,1,0,1
40,18,22,1,0,1
-27,13,-40,0,1,1
-3,35,-38,0,1,1
28,-11,39,1,1,0
9,29,-20,0,1,1
24,5,19,1,1,0
57,41,16,1,1,0
-9,-22,13,1,1,0
-52,-32,-20,0,1,1
-23,14,-37,0,1,1
-71,-44,-27,0,1,1
5,-10,15,1,1,0
-44,-36,-8,0,1,1
77,42,35,1,0,1
-40,-25,-15,0,0,0
52,36,16,1,0,1
-51,-6,-45,0,0,0
-9,-41,32,1,0,1
29,36,-7,0,0,0
35,0,35,1,0,1
38,32,6,1,0,1
28,23,5,1,0,1
-74,-29,-45,0,0,0
9,-29,38,1,0,1
-73,-40,-33,0,0,0
-53,-40,-13,0,0,0
13,23,-10,0,0,0
-16,-42,26,1,0,1
67,39,28,1,0,1
-16,-28,12,1,0,1
18,9,9,1,0,1
-75,-38,-37,0,0,0
38,32,6,1,0,1
14,-26,40,1,0,1
7,-1,8,1,1,0
31,4,27,1,1,0
-2,-1,-1,0,1,1
-63,-29,-34,0,1,1
-1,29,-30,0,1,1
19,-4,23,1,1,0
-26,-15,-11,0,1,1
-17,-8,-9,0,1,1
-45,-35,-10,0,1,1
-19,-5,-14,0,1,1
-13,30,-43,0,1,1
28,44,-16,0,1,1
42,18,24,1,0,1
50,18,32,1,0,1
11,-10,21,1,0,1
26,35,-9,0,0,0
35,33,2,1,0,1
-30,-42,12,1,0,1
-13,-12,-1,0,0,0
31,10,21,1,0,1
-59,-45,-14,0,0,0
-12,6,-18,0,1,1
30,18,12,1,1,0
10,14,-4,0,1,1
-56,-34,-22,0,1,1
-63,-41,-22,0,1,1
17,44,-27,0,1,1
7,38,-31,0,1,1
6,-20,26,1,1,0
11,-11,22,1,1,0
-77,-42,-35,0,1,1
37,29,8,1,1,0
-31,-25,-6,0,1,1
67,25,42,1,1,0
-18,15,-33,0,1,1
22,-7,29,1,1,0
58,16,42,1,1,0
-35,-16,-19,0,1,1
52,20,32,1,1,0
54,31,23,1,1,0
8,14,-6,0,1,1
27,21,6,1,1,0
-9,3,-12,0,0,0
-46,-37,-9,0,0,0
8,0,8,1,0,1
2,0,2,1,0,1
-79,-34,-45,0,0,0
-14,-27,13,1,0,1
-11,28,-39,0,0,0
-49,-24,-25,0,0,0
7,12,-5,0,0,0
-30,-1,-29,0,0,0
-37,7,-44,0,0,0
-78,-42,-36,0,0,0
-57,-22,-35,0,0,0
5,3,2,1,0,1
-42,-39,-3,0,0,0
-15,-35,20,1,0,1
-15,-13,-2,0,0,0
-2,-24,22,1,1,0
82,37,45,1,1,0
-59,-25,-34,0,1,1
-72,-45,-27,0,1,1
-9,-9,0,0,1,1
6,-33,39,1,1,0
-21,-27,6,1,1,0
17,-7,24,1,1,0
24,-5,29,1,1,0
12,-16,28,1,1,0
27,44,-17,0,1,1
-36,-20,-16,0,1,1
3,38,-35,0,1,1
-76,-38,-38,0,1,1
-46,-6,-40,0,1,1
33,12,21,1,1,0
13,40,-27,0,1,1
13,1,12,1,1,0
61,39,22,1,1,0
28,26,2,1,1,0
14,25,-11,0,1,1
26,33,-7,0,0,0
-33,-6,-27,0,0,0
2,-3,5,1,0,1
-16,-25,9,1,0,1
-15,-40,25,1,0,1
39,-5,44,1,0,1
-1,21,-22,0,0,0
16,25,-9,0,0,0
85,43,42,1,1,0
26,2,24,1,1,0
67,28,39,1,1,0
17,-14,31,1,1,0
11,-24,35,1,1,0
2,-13,15,1,1,0
-16,-8,-8,0,1,1
-5,10,-15,0,1,1
-14,-39,25,1,0,1
-21,-43,22,1,0,1
26,28,-2,0,0,0
32,-12,44,1,0,1
-8,-21,13,1,0,1
17,36,-19,0,0,0
-32,-17,-15,0,0,0
37,44,-7,0,0,0
29,12,17,1,0,1
0,-21,21,1,0,1
-26,-13,-13,0,0,0
7,-13,20,1,0,1
-9,26,-35,0,0,0
-14,-8,-6,0,0,0
-69,-27,-42,0,0,0
-29,-33,4,1,1,0
-21,-40,19,1,1,0
37,36,1,1,1,0
17,33,-16,0,1,1
-16,-3,-13,0,1,1
-47,-22,-25,0,1,1
-20,-10,-10,0,1,1
-29,-39,10,1,1,0
-61,-33,-28,0,1,1
7,43,-36,0,1,1
-46,-35,-11,0,1,1
-79,-42,-37,0,1,1
44,24,20,1,1,0
16,-1,17,1,1,0
51,34,17,1,1,0
27,32,-5,0,1,1
-59,-35,-24,0,1,1
-6,-19,13,1,1,0
45,19,26,1,1,0
14,21,-7,0,1,1
-20,-30,10,1,0,1
-33,-7,-26,0,0,0
12,23,-11,0,0,0
20,33,-13,0,0,0
19,42,-23,0,0,0
10,-8,18,1,0,1
64,32,32,1,0,1
-25,15,-40,0,0,0
45,23,22,1,0,1
-13,28,-41,0,0,0
-76,-39,-37,0,0,0
-26,-12,-14,0,0,0
-41,-2,-39,0,0,0
-68,-41,-27,0,0,0
-64,-43,-21,0,0,0
-77,-32,-45,0,0,0
-19,-34,15,1,0,1
23,-11,34,1,0,1
-13,4,-17,0,1,1
2,-14,16,1,1,0
-76,-39,-37,0,1,1
20,28,-8,0,1,1
-40,-40,0,0,1,1
37,14,23,1,1,0
1,-34,35,1,1,0
57,31,26,1,1,0
-61,-25,-36,0,1,1
3,43,-40,0,1,1
33,42,-9,0,1,1
19,6,13,1,1,0
-9,0,-9,0,1,1
69,28,41,1,1,0
43,29,14,1,1,0
-38,-23,-15,0,1,1
-40,-39,-1,0,1,1
-24,-17,-7,0,1,1
57,22,35,1,1,0
-3,-18,15,1,1,0
-19,-14,-5,0,1,1
-62,-27,-35,0,0,0
-14,27,-41,0,0,0
15,34,-19,0,0,0
-12,26,-38,0,0,0
-32,-20,-12,0,0,0
-55,-18,-37,0,0,0
17,28,-11,0,0,0
-25,-41,16,1,0,1
-15,8,-23,0,0,0
34,19,15,1,0,1
38,14,24,1,1,0
15,29,-14,0,1,1
-6,20,-26,0,1,1
17,-6,23,1,1,0
-7,-24,17,1,1,0
30,38,-8,0,1,1
62,30,32,1,1,0
22,15,7,1,1,0
-14,-10,-4,0,1,1
3,3,0,0,1,1
83,43,40,1,1,0
-5,18,-23,0,1,1
-88,-44,-44,0,1,1
56,26,30,1,0,1
-29,10,-39,0,0,0
-48,-24,-24,0,0,0
14,-27,41,1,0,1
63,20,43,1,0,1
52,27,25,1,0,1
14,-29,43,1,0,1
24,-19,43,1,0,1
-17,-43,26,1,0,1
-17,-13,-4,0,0,0
-24,-20,-4,0,0,0
35,4,31,1,0,1
-78,-44,-34,0,0,0
-69,-41,-28,0,0,0
-58,-17,-41,0,0,0
-43,-41,-2,0,1,1
77,41,36,1,1,0
-20,-12,-8,0,1,1
65,35,30,1,1,0
-12,-44,32,1,1,0
-9,5,-14,0,1,1
-4,7,-11,0,1,1
-9,-14,5,1,1,0
-20,-13,-7,0,1,1
-41,-38,-3,0,1,1
14,35,-21,0,1,1
-2,14,-16,0,1,1
-14,-45,31,1,1,0
-55,-36,-19,0,1,1
-35,-43,8,1,1,0
6,-2,8,1,1,0
5,36,-31,0,1,1
11,38,-27,0,1,1
13,-6,19,1,1,0
40,21,19,1,1,0
-60,-41,-19,0,1,1
-6,30,-36,0,0,0
-26,-28,2,1,0,1
55,18,37,1,0,1
9,-4,13,1,0,1
14,-27,41,1,0,1
-11,27,-38,0,0,0
36,11,25,1,0,1
40,5,35,1,0,1
-15,-41,26,1,0,1
3,9,-6,0,0,0
21,43,-22,0,0,0
-1,-18,17,1,0,1
-1,15,-16,0,0,0
-17,-25,8,1,1,0
-15,-17,2,1,1,0
-45,-42,-3,0,1,1
-60,-25,-35,0,1,1
-42,-38,-4,0,1,1
-62,-43,-19,0,1,1
15,22,-7,0,1,1
-39,-43,4,1,1,0
31,5,26,1,1,0
-49,-40,-9,0,1,1
72,31,41,1,1,0
71,35,36,1,1,0
-8,34,-42,0,1,1
-2,-27,25,1,1,0
-75,-32,-43,0,1,1
40,19,21,1,1,0
37,19,18,1,1,0
3,16,-13,0,1,1
27,-12,39,1,1,0
60,27,33,1,1,0
17,41,-24,0,0,0
-19,-1,-18,0,0,0
-29,-36,7,1,0,1
6,-4,10,1,0,1
46,21,25,1,0,1
47,40,7,1,0,1
-21,-26,5,1,0,1
64,41,23,1,0,1
-59,-19,-40,0,0,0
51,31,20,1,0,1
-41,-24,-17,0,0,0
-39,-9,-30,0,0,0
-51,-27,-24,0,1,1
7,-5,12,1,1,0
10,36,-26,0,1,1
-48,-45,-3,0,1,1
29,34,-5,0,1,1
0,23,-23,0,1,1
18,-27,45,1,1,0
4,39,-35,0,1,1
35,12,23,1,1,0
52,10,42,1,1,0
-11,-37,26,1,1,0
75,41,34,1,1,0
-25,-7,-18,0,1,1
-46,-35,-11,0,1,1
-21,4,-25,0,1,1
-11,6,-17,0,1,1
37,42,-5,0,1,1
31,39,-8,0,1,1
4,42,-38,0,1,1
-2,2,-4,0,1,1
-17,24,-41,0,1,1
20,-5,25,1,0,1
-42,-14,-28,0,0,0
-33,-44,11,1,0,1
-54,-15,-39,0,0,0
27,22,5,1,0,1
-55,-40,-15,0,0,0
-8,-26,18,1,0,1
-65,-44,-21,0,0,0
2,29,-27,0,1,1
54,24,30,1,1,0
72,41,31,1,1,0
-70,-41,-29,0,1,1
-34,0,-34,0,1,1
-83,-41,-42,0,1,1
-3,-39,36,1,1,0
44,-1,45,1,1,0
-77,-35,-42,0,1,1
-20,-10,-10,0,1,1
-74,-40,-34,0,1,1
-5,29,-34,0,1,1
5,21,-16,0,1,1
36,37,-1,0,1,1
-57,-24,-33,0,1,1
7,6,1,1,1,0
20,32,-12,0,1,1
-45,-22,-23,0,1,1
-22,-17,-5,0,1,1
-10,4,-14,0,1,1
-61,-22,-39,0,1,1
-15,-22,7,1,0,1
47,32,15,1,0,1
26,27,-1,0,0,0
20,-13,33,1,0,1
8,-31,39,1,0,1
11,-9,20,1,0,1
8,-22,30,1,0,1
-39,-1,-38,0,0,0
63,18,45,1,0,1
3,0,3,1,1,0
52,29,23,1,1,0
-17,-10,-7,0,1,1
-29,-31,2,1,1,0
-9,32,-41,0,1,1
5,-8,13,1,1,0
33,43,-10,0,1,1
9,-28,37,1,1,0
-26,-32,6,1,1,0
42,6,36,1,1,0
-29,-13,-16,0,1,1
34,-2,36,1,1,0
6,24,-18,0,1,1
0,-23,23,1,1,0
32,7,25,1,1,0
-15,-4,-11,0,1,1
23,32,-9,0,1,1
37,15,22,1,1,0
20,-15,35,1,1,0
61,36,25,1,1,0
-15,-9,-6,0,1,1
63,42,21,1,0,1
-30,-11,-19,0,0,0
5,39,-34,0,0,0
-9,32,-41,0,0,0
-21,3,-24,0,0,0
0,36,-36,0,0,0
13,-6,19,1,0,1
74,30,44,1,0,1
6,23,-17,0,0,0
8,18,-10,0,0,0
6,18,-12,0,0,0
62,38,24,1,0,1
-44,-28,-16,0,0,0
71,34,37,1,0,1
-23,-44,21,1,0,1
31,-2,33,1,0,1
-78,-36,-42,0,0,0
-45,-3,-42,0,0,0
32,33,-1,0,0,0
47,38,9,1,0,1
4,24,-20,0,0,0
-69,-25,-44,0,1,1
21,20,1,1,1,0
10,21,-11,0,1,1
54,18,36,1,1,0
12,1,11,1,1,0
-16,9,-25,0,1,1
14,-26,40,1,1,0
3,36,-33,0,1,1
10,20,-10,0,0,0
-33,-18,-15,0,0,0
69,38,31,1,0,1
59,44,15,1,0,1
-14,25,-39,0,0,0
-15,1,-16,0,0,0
31,-4,35,1,0,1
-18,1,-19,0,0,0
14,37,-23,0,0,0
30,23,7,1,0,1
30,-4,34,1,1,0
7,-10,17,1,1,0
-14,6,-20,0,1,1
19,21,-2,0,1,1
7,36,-29,0,1,1
70,34,36,1,1,0
26,31,-5,0,1,1
52,27,25,1,1,0
13,38,-25,0,0,0
13,-14,27,1,0,1
32,-11,43,1,0,1
-13,32,-45,0,0,0
-75,-39,-36,0,0,0
1,13,-12,0,0,0
30,20,10,1,0,1
2,34,-32,0,0,0
50,21,29,1,0,1
-21,-25,4,1,0,1
18,30,-12,0,1,1
-41,-12,-29,0,1,1
35,-6,41,1,1,0
2,15,-13,0,1,1
-46,-29,-17,0,1,1
-30,-3,-27,0,1,1
13,-31,44,1,1,0
16,-15,31,1,1,0
-17,-28,11,1,1,0
12,31,-19,0,1,1
20,34,-14,0,1,1
19,36,-17,0,1,1
64,40,24,1,1,0
4,-35,39,1,1,0
-38,0,-38,0,1,1
13,19,-6,0,1,1
-55,-21,-34,0,1,1
-1,24,-25,0,0,0
14,-3,17,1,0,1
-35,-11,-24,0,0,0
-11,-37,26,1,0,1
-12,-19,7,1,0,1
-33,-20,-13,0,0,0
3,28,-25,0,0,0
0,-41,41,1,0,1
-62,-34,-28,0,0,0
55,21,34,1,0,1
63,36,27,1,0,1
41,2,39,1,0,1
-71,-43,-28,0,0,0
1,-40,41,1,0,1
-38,-39,1,1,0,1
62,33,29,1,0,1
-21,-45,24,1,0,1
57,42,15,1,1,0
3,4,-1,0,1,1
21,-23,44,1,1,0
-44,-18,-26,0,1,1
2,-42,44,1,1,0
-10,5,-15,0,1,1
10,16,-6,0,1,1
41,29,12,1,1,0
-64,-42,-22,0,1,1
-36,-25,-11,0,1,1
-28,-22,-6,0,1,1
-31,11,-42,0,1,1
36,5,31,1,1,0
-13,19,-32,0,1,1
-67,-44,-23,0,1,1
34,16,18,1,1,0
-9,-23,14,1,0,1
39,40,-1,0,0,0
-18,-17,-1,0,0,0
-5,-16,11,1,0,1
5,-4,9,1,0,1
43,13,30,1,0,1
-22,-34,12,1,0,1
3,-9,12,1,0,1
-30,14,-44,0,0,0
42,-1,43,1,0,1
-27,9,-36,0,0,0
-25,-33,8,1,0,1
82,40,42,1,0,1
-4,-24,20,1,0,1
-25,2,-27,0,0,0
47,38,9,1,0,1
-10,-14,4,1,0,1
2,-7,9,1,0,1
39,29,10,1,1,0
-59,-39,-20,0,1,1
-68,-39,-29,0,1,1
-3,-40,37,1,1,0
-71,-30,-41,0,1,1
-19,16,-35,0,1,1
14,26,-12,0,1,1
-86,-44,-42,0,1,1
11,37,-26,0,1,1
15,37,-22,0,1,1
-77,-45,-32,0,1,1
26,-13,39,1,1,0
-68,-34,-34,0,1,1
26,10,16,1,1,0
75,30,45,1,0,1
25,43,-18,0,0,0
-16,-18,2,1,0,1
-26,-12,-14,0,0,0
-22,-2,-20,0,0,0
42,43,-1,0,0,0
-13,19,-32,0,0,0
2,39,-37,0,0,0
-6,-38,32,1,0,1
-50,-31,-19,0,0,0
-28,-45,17,1,0,1
1,23,-22,0,0,0
44,1,43,1,1,0
84,44,40,1,1,0
-16,26,-42,0,1,1
-71,-39,-32,0,1,1
-13,-20,7,1,1,0
46,9,37,1,1,0
20,22,-2,0,1,1
-16,-25,9,1,1,0
-55,-40,-15,0,1,1
-61,-38,-23,0,1,1
31,37,-6,0,1,1
20,-22,42,1,1,0
30,17,13,1,1,0
46,5,41,1,1,0
73,34,39,1,0,1
15,12,3,1,0,1
-59,-17,-42,0,0,0
31,35,-4,0,0,0
-76,-41,-35,0,0,0
-18,17,-35,0,0,0
31,31,0,0,0,0
-39,-20,-19,0,0,0
7,41,-34,0,0,0
57,31,26,1,1,0
32,25,7,1,1,0
32,17,15,1,1,0
-13,26,-39,0,1,1
18,24,-6,0,1,1
-1,-6,5,1,1,0
-16,-15,-1,0,1,1
2,19,-17,0,1,1
58,24,34,1,1,0
38,29,9,1,1,0
71,33,38,1,1,0
83,41,42,1,1,0
13,20,-7,0,1,1
38,9,29,1,1,0
-10,-21,11,1,1,0
28,12,16,1,1,0
57,39,18,1,1,0
-38,-30,-8,0,1,1
-30,-12,-18,0,1,1
-9,-45,36,1,1,0
-13,15,-28,0,1,1
24,1,23,1,0,1
-39,-20,-19,0,0,0
-1,6,-7,0,0,0
35,25,10,1,0,1
15,26,-11,0,0,0
46,39,7,1,0,1
-39,-35,-4,0,0,0
0,-44,44,1,0,1
-39,-34,-5,0,0,0
-47,-8,-39,0,0,0
-80,-40,-40,0,0,0
-22,-39,17,1,0,1
-26,3,-29,0,0,0
-3,39,-42,0,0,0
2,25,-23,0,0,0
38,42,-4,0,0,0
-45,-6,-39,0,0,0
62,35,27,1,1,0
0,-3,3,1,1,0
7,10,-3,0,1,1
-49,-12,-37,0,1,1
26,43,-17,0,1,1
67,25,42,1,1,0
31,0,31,1,1,0
41,44,-3,0,1,1
-50,-9,-41,0,1,1
-82,-44,-38,0,1,1
-68,-33,-35,0,1,1
24,38,-14,0,1,1
-24,-38,14,1,1,0
-26,-12,-14,0,1,1
-58,-16,-42,0,1,1
4,23,-19,0,1,1
24,37,-13,0,1,1
-57,-28,-29,0,1,1
-23,-22,-1,0,1,1
11,-28,39,1,1,0
-19,-24,5,1,1,0
36,1,35,1,0,1
38,17,21,1,0,1
14,-28,42,1,0,1
38,31,7,1,0,1
-16,17,-33,0,0,0
13,32,-19,0,0,0
-31,-35,4,1,0,1
1,11,-10,0,0,0
16,-13,29,1,0,1
-5,-36,31,1,0,1
20,21,-1,0,0,0
51,36,15,1,1,0
17,-11,28,1,1,0
-55,-34,-21,0,1,1
57,32,25,1,1,0
-16,-10,-6,0,1,1
-72,-33,-39,0,1,1
-12,6,-18,0,1,1
-61,-44,-17,0,1,1
12,7,5,1,1,0
17,25,-8,0,1,1
0,-22,22,1,1,0
-36,-13,-23,0,1,1
-17,-38,21,1,1,0
-38,-21,-17,0,1,1
32,-13,45,1,1,0
-21,-18,-3,0,1,1
-14,0,-14,0,1,1
-70,-27,-43,0,1,1
-51,-43,-8,0,1,1
-15,-20,5,1,1,0
-54,-11,-43,0,1,1
-50,-36,-14,0,0,0
27,24,3,1,0,1
19,22,-3,0,0,0
64,41,23,1,0,1
9,34,-25,0,0,0
27,43,-16,0,0,0
-47,-11,-36,0,0,0
76,43,33,1,0,1
3,25,-22,0,1,1
-40,0,-40,0,1,1
8,5,3,1,1,0
-15,15,-30,0,1,1
-14,27,-41,0,1,1
69,29,40,1,1,0
-32,11,-43,0,1,1
-55,-40,-15,0,1,1
-44,-1,-43,0,1,1
27,24,3,1,1,0
1,3,-2,0,1,1
-3,23,-26,0,1,1
-16,-28,12,1,1,0
17,28,-11,0,1,1
38,-5,43,1,1,0
28,0,28,1,0,1
-56,-30,-26,0,0,0
0,-34,34,1,0,1
74,36,38,1,0,1
-49,-26,-23,0,0,0
-10,-3,-7,0,0,0
-6,-14,8,1,0,1
-53,-30,-23,0,0,0
40,-2,42,1,1,0
61,40,21,1,1,0
18,20,-2,0,1,1
-6,5,-11,0,1,1
79,41,38,1,1,0
-2,37,-39,0,1,1
-4,-13,9,1,1,0
-7,28,-35,0,1,1
5,42,-37,0,1,1
-53,-31,-22,0,1,1
23,32,-9,0,1,1
-2,-18,16,1,1,0
-22,6,-28,0,1,1
65,33,32,1,1,0
-66,-36,-30,0,1,1
71,29,42,1,1,0
11,42,-31,0,1,1
-37,-39,2,1,1,0
15,17,-2,0,1,1
2,-31,33,1,1,0
-26,10,-36,0,1,1
-49,-15,-34,0,0,0
26,36,-10,0,0,0
25,-13,38,1,0,1
-4,-29,25,1,0,1
-64,-43,-21,0,0,0
-2,33,-35,0,0,0
8,-29,37,1,0,1
-23,-42,19,1,0,1
-30,-36,6,1,0,1
38,2,36,1,0,1
14,28,-14,0,1,1
-12,28,-40,0,1,1
36,25,11,1,1,0
16,-12,28,1,1,0
19,19,0,0,1,1
4,-5,9,1,1,0
22,43,-21,0,1,1
-14,23,-37,0,1,1
43,21,22,1,1,0
56,19,37,1,1,0
-19,-45,26,1,1,0
-7,36,-43,0,1,1
-22,18,-40,0,1,1
-19,-23,4,1,1,0
21,-8,29,1,1,0
40,2,38,1,1,0
-43,1,-44,0,1,1
14,-11,25,1,1,0
-4,14,-18,0,0,0
27,23,4,1,0,1
6,25,-19,0,0,0
37,35,2,1,0,1
-9,-24,15,1,0,1
-11,-27,16,1,0,1
-67,-34,-33,0,0,0
65,31,34,1,0,1
-18,4,-22,0,0,0
-5,4,-9,0,0,0
15,12,3,1,0,1
20,5,15,1,0,1
58,30,28,1,0,1
-48,-32,-16,0,0,0
-56,-44,-12,0,0,0
41,29,12,1,0,1
-35,5,-40,0,0,0
55,12,43,1,1,0
-60,-21,-39,0,1,1
-42,-7,-35,0,1,1
26,-2,28,1,1,0
54,32,22,1,1,0
43,34,9,1,1,0
-42,-44,2,1,1,0
53,16,37,1,1,0
10,-31,41,1,1,0
-61,-22,-39,0,1,1
19,-15,34,1,1,0
4,-25,29,1,1,0
-57,-29,-28,0,1,1
15,0,15,1,1,0
-51,-43,-8,0,1,1
-24,19,-43,0,1,1
-2,-3,1,1,1,0
1,27,-26,0,1,1
10,32,-22,0,1,1
-22,-27,5,1,1,0
58,44,14,1,1,0
-6,7,-13,0,0,0
31,-13,44,1,0,1
22,-23,45,1,0,1
28,27,1,1,0,1
-58,-36,-22,0,0,0
-18,-15,-3,0,0,0
-5,-38,33,1,0,1
39,3,36,1,0,1
-35,1,-36,0,0,0
-24,-40,16,1,0,1
9,28,-19,0,0,0
-3,2,-5,0,0,0
-28,-16,-12,0,0,0
-12,-38,26,1,0,1
18,9,9,1,0,1
-57,-12,-45,0,0,0
49,39,10,1,0,1
20,-13,33,1,0,1
6,-26,32,1,0,1
3,0,3,1,0,1
76,36,40,1,0,1
-44,-19,-25,0,1,1
33,8,25,1,1,0
65,25,40,1,1,0
52,12,40,1,1,0
68,28,40,1,1,0
-7,-35,28,1,1,0
-1,31,-32,0,1,1
61,37,24,1,1,0
1,-12,13,1,1,0
-24,8,-32,0,1,1
-71,-33,-38,0,1,1
-23,-27,4,1,1,0
1,32,-31,0,1,1
9,-9,18,1,1,0
-60,-36,-24,0,1,1
-21,22,-43,0,1,1
-50,-43,-7,0,1,1
47,25,22,1,1,0
-13,-31,18,1,1,0
31,41,-10,0,0,0
-55,-18,-37,0,0,0
5,-28,33,1,0,1
66,28,38,1,0,1
-54,-35,-19,0,0,0
6,26,-20,0,0,0
-66,-39,-27,0,0,0
17,16,1,1,0,1
14,-17,31,1,0,1
-27,7,-34,0,0,0
41,25,16,1,0,1
-10,-27,17,1,0,1
-7,10,-17,0,0,0
-43,-13,-30,0,0,0
24,-6,30,1,0,1
74,41,33,1,0,1
40,26,14,1,1,0
-30,-37,7,1,1,0
-73,-33,-40,0,1,1
20,-2,22,1,1,0
-12,-18,6,1,1,0
-40,-32,-8,0,1,1
-23,-34,11,1,1,0
32,39,-7,0,1,1
-16,-12,-4,0,1,1
-17,27,-44,0,1,1
21,-23,44,1,1,0
44,44,0,0,1,1
-47,-39,-8,0,1,1
33,1,32,1,1,0
-71,-35,-36,0,0,0
33,4,29,1,0,1
-22,-30,8,1,0,1
-44,-40,-4,0,0,0
-4,30,-34,0,0,0
-3,13,-16,0,0,0
8,-27,35,1,0,1
-8,-6,-2,0,0,0
11,8,3,1,0,1
-14,21,-35,0,0,0
-37,-9,-28,0,0,0
2,-22,24,1,0,1
-19,26,-45,0,0,0
4,-16,20,1,1,0
-33,-10,-23,0,1,1
-33,-32,-1,0,1,1
-28,-20,-8,0,1,1
21,15,6,1,1,0
56,20,36,1,1,0
27,-13,40,1,1,0
0,-19,19,1,1,0
-29,-23,-6,0,1,1
37,19,18,1,1,0
-16,14,-30,0,1,1
-49,-10,-39,0,1,1
4,-15,19,1,1,0
3,40,-37,0,1,1
-9,-10,1,1,1,0
-39,-22,-17,0,1,1
-17,-12,-5,0,1,1
20,-11,31,1,1,0
-20,-45,25,1,0,1
-61,-23,-38,0,0,0
-41,-2,-39,0,0,0
9,15,-6,0,0,0
36,11,25,1,0,1
43,17,26,1,0,1
-27,-9,-18,0,0,0
-40,-40,0,0,0,0
22,-2,24,1,0,1
49,34,15,1,0,1
60,28,32,1,0,1
-65,-25,-40,0,1,1
7,-25,32,1,1,0
15,-13,28,1,1,0
-61,-40,-21,0,1,1
-23,19,-42,0,1,1
-55,-38,-17,0,1,1
-16,18,-34,0,1,1
17,-19,36,1,1,0
-53,-34,-19,0,1,1
-12,-36,24,1,1,0
-1,-40,39,1,1,0
-30,-35,5,1,1,0
-12,-25,13,1,1,0
-3,8,-11,0,1,1
2,2,0,0,1,1
14,12,2,1,1,0
6,-26,32,1,1,0
6,37,-31,0,1,1
-1,-23,22,1,1,0
3,-41,44,1,1,0
69,42,27,1,1,0
51,17,34,1,0,1
-41,-25,-16,0,0,0
-45,-12,-33,0,0,0
-30,-34,4,1,0,1
6,10,-4,0,0,0
34,17,17,1,0,1
29,30,-1,0,0,0
-8,7,-15,0,0,0
41,39,2,1,0,1
76,36,40,1,0,1
-14,-26,12,1,0,1
27,15,12,1,0,1
42,41,1,1,0,1
-36,-10,-26,0,0,0
-43,-19,-24,0,0,0
-20,-44,24,1,0,1
-5,12,-17,0,0,0
24,31,-7,0,0,0
36,26,10,1,0,1
-10,-35,25,1,0,1
-58,-33,-25,0,0,0
5,-32,37,1,1,0
-45,-28,-17,0,1,1
-8,30,-38,0,1,1
16,38,-22,0,1,1
-10,-38,28,1,1,0
-10,-4,-6,0,1,1
-47,-38,-9,0,1,1
18,36,-18,0,1,1
-17,16,-33,0,1,1
-33,-5,-28,0,1,1
-52,-21,-31,0,1,1
-40,-25,-15,0,1,1
19,-12,31,1,1,0
-63,-29,-34,0,1,1
-6,1,-7,0,1,1
34,43,-9,0,1,1
23,-15,38,1,1,0
1,-26,27,1,1,0
23,25,-2,0,1,1
5,-27,32,1,1,0
19,-22,41,1,1,0
30,19,11,1,0,1
11,40,-29,0,0,0
34,22,12,1,0,1
-33,-19,-14,0,0,0
71,27,44,1,0,1
3,29,-26,0,0,0
6,30,-24,0,0,0
-19,-29,10,1,0,1
-1,35,-36,0,0,0
-21,17,-38,0,0,0
55,38,17,1,0,1
5,-26,31,1,0,1
61,28,33,1,0,1
53,18,35,1,0,1
51,39,12,1,0,1
-6,-7,1,1,0,1
26,13,13,1,0,1
39,31,8,1,0,1
-38,-15,-23,0,0,0
1,9,-8,0,0,0
-55,-27,-28,0,1,1
-18,23,-41,0,1,1
46,41,5,1,1,0
-25,-34,9,1,1,0
12,20,-8,0,1,1
-14,-12,-2,0,1,1
26,18,8,1,1,0
-25,17,-42,0,1,1
-17,4,-21,0,1,1
-23,-6,-17,0,1,1
3,-26,29,1,0,1
5,-2,7,1,0,1
38,16,22,1,0,1
7,3,4,1,0,1
-42,-1,-41,0,0,0
38,11,27,1,0,1
-64,-34,-30,0,0,0
15,-26,41,1,0,1
-53,-25,-28,0,0,0
25,-3,28,1,0,1
49,16,33,1,0,1
-15,-30,15,1,1,0
31,4,27,1,1,0
-19,-5,-14,0,1,1
7,23,-16,0,1,1
9,17,-8,0,1,1
-63,-36,-27,0,1,1
56,43,13,1,1,0
-16,-43,27,1,1,0
21,-11,32,1,1,0
35,26,9,1,1,0
-45,-15,-30,0,1,1
18,43,-25,0,1,1
20,23,-3,0,1,1
-19,15,-34,0,0,0
-43,-13,-30,0,0,0
-22,-11,-11,0,0,0
76,33,43,1,0,1
-67,-23,-44,0,0,0
30,-4,34,1,0,1
-30,13,-43,0,0,0
-20,-13,-7,0,0,0
11,-22,33,1,0,1
71,34,37,1,0,1
54,12,42,1,0,1
4,-28,32,1,0,1
-41,4,-45,0,0,0
16,-5,21,1,0,1
62,38,24,1,0,1
44,43,1,1,0,1
-10,7,-17,0,0,0
23,10,13,1,0,1
-7,-36,29,1,1,0
11,-8,19,1,1,0
-15,-8,-7,0,1,1
-7,3,-10,0,1,1
-45,-1,-44,0,1,1
-9,-40,31,1,1,0
15,29,-14,0,1,1
-66,-45,-21,0,1,1
-30,-25,-5,0,1,1
12,-19,31,1,1,0
6,-13,19,1,1,0
40,21,19,1,1,0
-30,-28,-2,0,1,1
-33,0,-33,0,1,1
-9,14,-23,0,1,1
24,7,17,1,1,0
-46,-22,-24,0,0,0
-28,-38,10,1,0,1
-38,-40,2,1,0,1
27,6,21,1,0,1
30,6,24,1,0,1
11,20,-9,0,0,0
-44,-45,1,1,0,1
-50,-29,-21,0,0,0
83,42,41,1,0,1
-4,-44,40,1,0,1
44,20,24,1,0,1
-26,-2,-24,0,0,0
0,24,-24,0,0,0
52,25,27,1,0,1
5,13,-8,0,0,0
-55,-34,-21,0,0,0
-12,-42,30,1,0,1
13,-32,45,1,0,1
-25,5,-30,0,0,0
-46,-15,-31,0,0,0
76,31,45,1,0,1
-36,-28,-8,0,1,1
-64,-26,-38,0,1,1
-23,-12,-11,0,1,1
-12,24,-36,0,1,1
-62,-18,-44,0,1,1
-54,-10,-44,0,1,1
-66,-35,-31,0,1,1
46,30,16,1,1,0
-6,-1,-5,0,1,1
8,36,-28,0,1,1
-6,-25,19,1,1,0
17,-10,27,1,1,0
-51,-12,-39,0,1,1
-19,-40,21,1,1,0
55,30,25,1,1,0
30,38,-8,0,1,1
-6,-41,35,1,1,0
-8,-22,14,1,1,0
-16,17,-33,0,1,1
-16,13,-29,0,0,0
14,-5,19,1,0,1
75,37,38,1,0,1
-15,-41,26,1,0,1
-38,-26,-12,0,0,0
24,39,-15,0,0,0
17,5,12,1,0,1
-23,-26,3,1,0,1
-50,-14,-36,0,0,0
61,43,18,1,0,1
47,2,45,1,0,1
61,23,38,1,0,1
19,41,-22,0,0,0
-55,-32,-23,0,0,0
8,30,-22,0,0,0
-6,-20,14,1,0,1
-6,-14,8,1,0,1
-23,-6,-17,0,1,1
25,-14,39,1,1,0
22,37,-15,0,1,1
17,23,-6,0,1,1
15,29,-14,0,1,1
-19,-25,6,1,1,0
-1,44,-45,0,1,1
23,35,-12,0,1,1
56,37,19,1,1,0
-12,4,-16,0,1,1
20,-13,33,1,1,0
53,14,39,1,1,0
-11,-21,10,1,1,0
10,29,-19,0,1,1
-35,6,-41,0,1,1
-4,-5,1,1,1,0
80,41,39,1,1,0
-42,-4,-38,0,1,1
23,-15,38,1,1,0
-23,-2,-21,0,1,1
8,-22,30,1,1,0
11,9,2,1,0,1
25,5,20,1,0,1
-65,-33,-32,0,0,0
30,20,10,1,0,1
44,30,14,1,0,1
-52,-38,-14,0,0,0
24,34,-10,0,0,0
-33,5,-38,0,0,0
-25,20,-45,0,0,0
26,23,3,1,0,1
-42,-40,-2,0,0,0
-59,-26,-33,0,0,0
68,38,30,1,0,1
36,4,32,1,0,1
74,30,44,1,0,1
-12,-30,18,1,0,1
60,16,44,1,1,0
40,10,30,1,1,0
46,25,21,1,1,0
22,-8,30,1,1,0
28,2,26,1,1,0
0,-11,11,1,1,0
21,-21,42,1,1,0
35,19,16,1,1,0
10,0,10,1,1,0
-75,-36,-39,0,1,1
0,43,-43,0,1,1
-47,-27,-20,0,1,1
-1,-27,26,1,1,0
71,43,28,1,0,1
28,-4,32,1,0,1
18,-3,21,1,0,1
64,32,32,1,0,1
-32,-25,-7,0,0,0
0,-17,17,1,0,1
22,34,-12,0,0,0
0,26,-26,0,0,0
20,-24,44,1,0,1
13,-10,23,1,0,1
-53,-19,-34,0,1,1
22,-10,32,1,1,0
-3,39,-42,0,1,1
-61,-16,-45,0,1,1
-21,-39,18,1,1,0
16,19,-3,0,1,1
9,-31,40,1,1,0
60,17,43,1,1,0
-63,-19,-44,0,1,1
-28,15,-43,0,0,0
19,38,-19,0,0,0
-4,7,-11,0,0,0
50,7,43,1,0,1
-50,-8,-42,0,0,0
-22,-19,-3,0,0,0
-15,-15,0,0,0,0
-32,8,-40,0,0,0
56,22,34,1,0,1
7,37,-30,0,0,0
-46,-28,-18,0,0,0
-72,-43,-29,0,0,0
-58,-18,-40,0,0,0
-56,-41,-15,0,1,1
8,-8,16,1,1,0
41,32,9,1,1,0
21,-13,34,1,1,0
13,8,5,1,1,0
16,-6,22,1,1,0
16,-9,25,1,1,0
-69,-33,-36,0,1,1
17,-26,43,1,0,1
59,31,28,1,0,1
57,33,24,1,0,1
27,41,-14,0,0,0
-44,-1,-43,0,0,0
4,27,-23,0,0,0
-46,-39,-7,0,0,0
-14,1,-15,0,0,0
63,40,23,1,0,1
56,11,45,1,0,1
-18,-32,14,1,1,0
18,42,-24,0,1,1
-4,-20,16,1,1,0
-40,-28,-12,0,1,1
13,-24,37,1,1,0
-26,-20,-6,0,1,1
-27,-10,-17,0,1,1
43,33,10,1,1,0
-1,-17,16,1,1,0
59,40,19,1,1,0
-43,-7,-36,0,1,1
9,-29,38,1,1,0
-67,-23,-44,0,1,1
-15,-11,-4,0,1,1
-47,-14,-33,0,1,1
23,-4,27,1,1,0
-80,-35,-45,0,0,0
20,-20,40,1,0,1
20,23,-3,0,0,0
15,-26,41,1,0,1
-3,12,-15,0,0,0
-45,-20,-25,0,0,0
18,27,-9,0,0,0
-59,-15,-44,0,0,0
33,-1,34,1,0,1
-19,-5,-14,0,1,1
63,35,28,1,1,0
-12,4,-16,0,1,1
26,31,-5,0,1,1
-40,3,-43,0,1,1
-30,-8,-22,0,1,1
-51,-13,-38,0,1,1
-25,-26,1,1,1,0
-3,5,-8,0,1,1
55,12,43,1,1,0
14,23,-9,0,1,1
13,-11,24,1,1,0
-33,-12,-21,0,1,1
-22,22,-44,0,1,1
-1,41,-42,0,1,1
3,-33,36,1,1,0
-41,-1,-40,0,1,1
3,9,-6,0,1,1
27,36,-9,0,1,1
30,21,9,1,1,0
-16,-12,-4,0,1,1
48,37,11,1,0,1
-15,12,-27,0,0,0
-16,-44,28,1,0,1
0,-20,20,1,0,1
-30,-22,-8,0,0,0
52,36,16,1,0,1
-18,4,-22,0,0,0
-18,-37,19,1,0,1
-7,-12,5,1,0,1
-6,-43,37,1,0,1
20,9,11,1,0,1
46,33,13,1,0,1
-13,12,-25,0,0,0
15,17,-2,0,0,0
-5,25,-30,0,1,1
12,-12,24,1,1,0
-24,21,-45,0,1,1
-42,-14,-28,0,1,1
-36,9,-45,0,1,1
32,34,-2,0,1,1
39,28,11,1,1,0
-17,-35,18,1,1,0
-23,-26,3,1,1,0
-16,-23,7,1,1,0
34,-11,45,1,1,0
-24,-41,17,1,1,0
2,23,-21,0,1,1
-9,-31,22,1,1,0
-35,-22,-13,0,0,0
65,22,43,1,0,1
-6,-18,12,1,0,1
-42,-11,-31,0,0,0
-30,-34,4,1,0,1
71,30,41,1,0,1
34,27,7,1,0,1
-8,19,-27,0,0,0
52,42,10,1,0,1
28,-2,30,1,0,1
-44,-35,-9,0,0,0
10,40,-30,0,0,0
56,28,28,1,0,1
38,9,29,1,0,1
-74,-39,-35,0,0,0
-10,26,-36,0,0,0
20,38,-18,0,0,0
-2,-37,35,1,0,1
57,13,44,1,0,1
-34,10,-44,0,0,0
64,22,42,1,0,1
-83,-43,-40,0,1,1
71,26,45,1,1,0
61,24,37,1,1,0
-3,-30,27,1,1,0
-5,7,-12,0,1,1
-28,11,-39,0,1,1
-40,-30,-10,0,1,1
39,18,21,1,1,0
-36,-10,-26,0,1,1
-17,-18,1,1,0,1
18,-2,20,1,0,1
13,11,2,1,0,1
44,39,5,1,0,1
44,9,35,1,0,1
42,42,0,0,0,0
-51,-24,-27,0,0,0
-37,-12,-25,0,0,0
-23,-7,-16,0,0,0
-15,-43,28,1,0,1
-18,19,-37,0,0,0
39,34,5,1,0,1
25,31,-6,0,0,0
27,-1,28,1,0,1
-45,-31,-14,0,0,0
-17,9,-26,0,0,0
2,26,-24,0,0,0
7,33,-26,0,0,0
15,19,-4,0,0,0
-43,2,-45,0,0,0
-14,-34,20,1,0,1
-23,-10,-13,0,1,1
0,-33,33,1,1,0
55,34,21,1,1,0
-34,-8,-26,0,1,1
18,-12,30,1,1,0
52,40,12,1,1,0
50,31,19,1,1,0
-54,-33,-21,0,1,1
48,30,18,1,1,0
9,37,-28,0,1,1
-5,15,-20,0,1,1
-82,-42,-40,0,1,1
33,10,23,1,1,0
-52,-13,-39,0,1,1
-50,-31,-19,0,0,0
-7,-19,12,1,0,1
-39,-40,1,1,0,1
-13,-19,6,1,0,1
-28,9,-37,0,0,0
44,42,2,1,0,1
-14,-17,3,1,0,1
15,-3,18,1,0,1
75,37,38,1,0,1
59,38,21,1,0,1
-35,-6,-29,0,1,1
11,-11,22,1,1,0
48,16,32,1,1,0
57,30,27,1,1,0
34,30,4,1,1,0
39,28,11,1,1,0
-25,-41,16,1,1,0
-6,-32,26,1,1,0
16,-28,44,1,1,0
30,13,17,1,1,0
-5,15,-20,0,1,1
-33,-33,0,0,1,1
79,37,42,1,1,0
-57,-39,-18,0,0,0
35,44,-9,0,0,0
-81,-39,-42,0,0,0
-54,-24,-30,0,0,0
-41,-6,-35,0,0,0
48,37,11,1,0,1
15,32,-17,0,0,0
1,-16,17,1,0,1
2,39,-37,0,0,0
-27,17,-44,0,0,0
1,-31,32,1,0,1
-24,-22,-2,0,0,0
64,37,27,1,0,1
-38,-37,-1,0,0,0
-17,-39,22,1,0,1
-49,-17,-32,0,0,0
-74,-32,-42,0,0,0
24,-13,37,1,0,1
-12,-45,33,1,0,1
30,-10,40,1,0,1
-12,-31,19,1,0,1
-35,-40,5,1,1,0
29,34,-5,0,1,1
-18,-42,24,1,1,0
5,26,-21,0,1,1
-44,-22,-22,0,1,1
-12,26,-38,0,1,1
13,12,1,1,1,0
45,15,30,1,1,0
-37,0,-37,0,1,1
-20,15,-35,0,1,1
30,27,3,1,1,0
38,0,38,1,1,0
46,38,8,1,1,0
-10,-31,21,1,1,0
38,44,-6,0,1,1
22,-19,41,1,1,0
-20,12,-32,0,0,0
-3,25,-28,0,0,0
4,22,-18,0,0,0
21,-24,45,1,0,1
47,22,25,1,0,1
-36,-23,-13,0,0,0
2,33,-31,0,0,0
-11,-1,-10,0,0,0
52,11,41,1,1,0
19,-10,29,1,1,0
-45,-23,-22,0,1,1
75,35,40,1,1,0
71,42,29,1,1,0
2,44,-42,0,1,1
68,41,27,1,1,0
23,-8,31,1,1,0
15,-11,26,1,1,0
-8,-3,-5,0,1,1
-43,-8,-35,0,1,1
67,31,36,1,1,0
33,-3,36,1,1,0
29,1,28,1,1,0
27,9,18,1,1,0
14,36,-22,0,1,1
-67,-23,-44,0,1,1
6,-27,33,1,1,0
-42,-6,-36,0,1,1
16,9,7,1,0,1
-2,-13,11,1,0,1
-72,-40,-32,0,0,0
6,-16,22,1,0,1
-19,-17,-2,0,0,0
31,8,23,1,0,1
-63,-45,-18,0,0,0
28,41,-13,0,0,0
-7,-43,36,1,0,1
21,-19,40,1,1,0
-32,2,-34,0,1,1
-25,-22,-3,0,1,1
17,19,-2,0,1,1
52,43,9,1,1,0
7,26,-19,0,1,1
6,23,-17,0,1,1
27,-2,29,1,1,0
-28,-2,-26,0,1,1
-27,-37,10,1,1,0
-37,-26,-11,0,1,1
-62,-21,-41,0,1,1
-8,-10,2,1,1,0
48,9,39,1,0,1
6,-28,34,1,0,1
13,39,-26,0,0,0
21,25,-4,0,0,0
-39,-27,-12,0,0,0
22,16,6,1,0,1
-8,-2,-6,0,0,0
0,-31,31,1,0,1
14,-27,41,1,0,1
38,39,-1,0,1,1
-43,-31,-12,0,1,1
-14,-37,23,1,1,0
-30,0,-30,0,1,1
13,-23,36,1,1,0
-20,19,-39,0,1,1
-27,10,-37,0,1,1
-64,-19,-45,0,1,1
-9,-27,18,1,1,0
32,39,-7,0,1,1
-70,-28,-42,0,1,1
17,-15,32,1,1,0
33,-4,37,1,1,0
-25,2,-27,0,1,1
44,12,32,1,1,0
-75,-42,-33,0,1,1
30,-10,40,1,1,0
20,20,0,0,1,1
-27,-42,15,1,1,0
-9,-41,32,1,1,0
0,30,-30,0,1,1
85,42,43,1,0,1
-3,-12,9,1,0,1
-3,10,-13,0,0,0
16,4,12,1,0,1
-32,8,-40,0,0,0
2,-25,27,1,0,1
71,37,34,1,0,1
73,41,32,1,0,1
-8,6,-14,0,0,0
-15,-31,16,1,0,1
19,2,17,1,1,0
-6,-26,20,1,1,0
-62,-35,-27,0,1,1
-18,21,-39,0,1,1
-35,-17,-18,0,1,1
47,42,5,1,1,0
22,24,-2,0,1,1
-17,18,-35,0,1,1
56,23,33,1,1,0
11,34,-23,0,0,0
-38,-13,-25,0,0,0
-28,6,-34,0,0,0
21,10,11,1,0,1
-28,-16,-12,0,0,0
-39,-45,6,1,0,1
-28,-8,-20,0,0,0
35,18,17,1,0,1
-61,-45,-16,0,0,0
-24,-32,8,1,0,1
17,24,-7,0,0,0
24,6,18,1,0,1
-85,-42,-43,0,0,0
-53,-16,-37,0,0,0
15,-23,38,1,0,1
-20,-24,4,1,0,1
-50,-30,-20,0,0,0
-2,12,-14,0,0,0
-19,-35,16,1,0,1
-11,-9,-2,0,0,0
24,0,24,1,0,1
32,-2,34,1,1,0
28,-1,29,1,1,0
9,-9,18,1,1,0
4,34,-30,0,1,1
-53,-43,-10,0,1,1
41,44,-3,0,1,1
-25,6,-31,0,1,1
60,23,37,1,1,0
36,13,23,1,1,0
65,44,21,1,1,0
18,-20,38,1,1,0
-22,-24,2,1,1,0
20,26,-6,0,1,1
-37,8,-45,0,1,1
36,9,27,1,1,0
-8,-30,22,1,1,0
7,-18,25,1,1,0
-26,7,-33,0,1,1
16,-22,38,1,1,0
-4,-7,3,1,1,0
-2,-4,2,1,1,0
1,14,-13,0,0,0
-34,-13,-21,0,0,0
53,36,17,1,0,1
-65,-33,-32,0,0,0
67,40,27,1,0,1
-9,-3,-6,0,0,0
33,-2,35,1,0,1
6,-13,19,1,0,1
-10,-17,7,1,0,1
4,6,-2,0,0,0
-10,-4,-6,0,0,0
30,10,20,1,0,1
-24,7,-31,0,0,0
-26,-43,17,1,1,0
24,44,-20,0,1,1
-65,-44,-21,0,1,1
-3,41,-44,0,1,1
7,10,-3,0,1,1
2,10,-8,0,1,1
47,22,25,1,1,0
9,-28,37,1,1,0
-26,-6,-20,0,1,1
14,-23,37,1,1,0
-3,-33,30,1,1,0
34,25,9,1,1,0
9,-7,16,1,1,0
-38,3,-41,0,1,1
50,44,6,1,1,0
11,-3,14,1,0,1
-36,8,-44,0,0,0
-67,-36,-31,0,0,0
-8,3,-11,0,0,0
4,-31,35,1,0,1
-14,18,-32,0,0,0
-8,-16,8,1,0,1
6,37,-31,0,0,0
5,-9,14,1,0,1
66,21,45,1,0,1
-26,-33,7,1,0,1
-78,-34,-44,0,0,0
-34,-17,-17,0,0,0
-45,-34,-11,0,0,0
-50,-37,-13,0,0,0
-22,4,-26,0,0,0
-15,-14,-1,0,0,0
-29,-37,8,1,0,1
-14,10,-24,0,0,0
3,-20,23,1,0,1
37,16,21,1,0,1
49,23,26,1,1,0
17,-1,18,1,1,0
34,20,14,1,1,0
-58,-34,-24,0,1,1
66,30,36,1,1,0
-42,-2,-40,0,1,1
-1,26,-27,0,1,1
37,30,7,1,1,0
9,12,-3,0,1,1
-1,36,-37,0,1,1
-22,-35,13,1,1,0
-38,-15,-23,0,1,1
30,38,-8,0,1,1
73,28,45,1,1,0
23,36,-13,0,1,1
14,-16,30,1,1,0
36,-3,39,1,1,0
5,-38,43,1,1,0
30,1,29,1,1,0
3,-30,33,1,1,0
-26,-1,-25,0,1,1
-22,-21,-1,0,0,0
87,42,45,1,0,1
36,-2,38,1,0,1
18,-6,24,1,0,1
-14,-21,7,1,0,1
56,42,14,1,0,1
66,25,41,1,0,1
-17,27,-44,0,0,0
60,18,42,1,0,1
-56,-25,-31,0,0,0
22,40,-18,0,0,0
1,30,-29,0,0,0
1,12,-11,0,0,0
5,-17,22,1,0,1
58,40,18,1,0,1
67,28,39,1,0,1
20,19,1,1,0,1
63,43,20,1,0,1
9,27,-18,0,1,1
-28,-18,-10,0,1,1
41,22,19,1,1,0
36,36,0,0,1,1
-21,-42,21,1,1,0
-80,-42,-38,0,1,1
-10,-28,18,1,1,0
50,13,37,1,1,0
1,9,-8,0,1,1
69,39,30,1,1,0
30,1,29,1,0,1
5,27,-22,0,0,0
49,17,32,1,0,1
5,44,-39,0,0,0
7,44,-37,0,0,0
25,11,14,1,0,1
42,28,14,1,0,1
25,-10,35,1,0,1
-46,-33,-13,0,0,0
78,35,43,1,0,1
13,39,-26,0,0,0
15,17,-2,0,0,0
-18,27,-45,0,0,0
22,44,-22,0,0,0
60,23,37,1,0,1
23,43,-20,0,0,0
-10,-36,26,1,0,1
12,-21,33,1,0,1
-22,-19,-3,0,0,0
-12,25,-37,0,0,0
-23,18,-41,0,0,0
31,29,2,1,1,0
14,-9,23,1,1,0
-74,-35,-39,0,1,1
-12,-23,11,1,1,0
67,41,26,1,1,0
-54,-22,-32,0,1,1
-33,-17,-16,0,1,1
22,44,-22,0,1,1
-15,-28,13,1,1,0
-41,-44,3,1,1,0
18,7,11,1,0,1
-8,-7,-1,0,0,0
-3,13,-16,0,0,0
20,13,7,1,0,1
35,-10,45,1,0,1
-24,-5,-19,0,0,0
-50,-24,-26,0,0,0
26,31,-5,0,0,0
-24,21,-45,0,0,0
-35,-41,6,1,0,1
-31,-29,-2,0,0,0
-35,-22,-13,0,0,0
46,19,27,1,0,1
24,5,19,1,0,1
-53,-26,-27,0,0,0
57,17,40,1,0,1
-38,7,-45,0,0,0
76,34,42,1,0,1
23,9,14,1,0,1
-66,-22,-44,0,0,0
-12,-23,11,1,0,1
8,41,-33,0,1,1
-32,-30,-2,0,1,1
15,-21,36,1,1,0
-22,8,-30,0,1,1
4,8,-4,0,1,1
19,24,-5,0,1,1
26,37,-11,0,1,1
-16,1,-17,0,1,1
11,-18,29,1,1,0
7,28,-21,0,1,1
-66,-42,-24,0,1,1
-31,7,-38,0,1,1
-16,-36,20,1,1,0
-52,-32,-20,0,1,1
11,-27,38,1,0,1
23,-8,31,1,0,1
59,14,45,1,0,1
-3,32,-35,0,0,0
-1,21,-22,0,0,0
-23,-37,14,1,0,1
-21,-41,20,1,0,1
42,19,23,1,0,1
57,18,39,1,0,1
-10,22,-32,0,0,0
67,38,29,1,0,1
-2,-12,10,1,0,1
31,10,21,1,0,1
-33,-21,-12,0,0,0
61,22,39,1,1,0
30,-15,45,1,1,0
65,23,42,1,1,0
-7,13,-20,0,1,1
14,-23,37,1,1,0
-5,-8,3,1,1,0
-53,-44,-9,0,1,1
25,19,6,1,1,0
37,20,17,1,1,0
-18,-4,-14,0,1,1
-69,-34,-35,0,1,1
-2,27,-29,0,1,1
10,1,9,1,1,0
15,-28,43,1,1,0
-59,-34,-25,0,1,1
50,26,24,1,1,0
50,7,43,1,1,0
24,17,7,1,1,0
-7,-31,24,1,1,0
70,31,39,1,1,0
-33,6,-39,0,1,1
82,40,42,1,0,1
-39,-2,-37,0,0,0
42,28,14,1,0,1
4,10,-6,0,0,0
10,6,4,1,0,1
-35,0,-35,0,0,0
-2,-25,23,1,0,1
-44,-26,-18,0,0,0
-19,12,-31,0,1,1
-24,-22,-2,0,1,1
-61,-34,-27,0,1,1
-82,-43,-39,0,1,1
7,-21,28,1,1,0
-19,8,-27,0,1,1
-55,-24,-31,0,1,1
-65,-42,-23,0,1,1
-29,14,-43,0,1,1
-17,-33,16,1,1,0
17,30,-13,0,0,0
26,33,-7,0,0,0
29,16,13,1,0,1
41,5,36,1,0,1
65,20,45,1,0,1
33,31,2,1,0,1
-24,18,-42,0,0,0
58,44,14,1,0,1
-66,-38,-28,0,0,0
-75,-40,-35,0,0,0
47,38,9,1,0,1
64,26,38,1,0,1
-41,-6,-35,0,1,1
6,-30,36,1,1,0
-33,5,-38,0,1,1
-61,-32,-29,0,1,1
33,44,-11,0,1,1
-37,3,-40,0,1,1
27,5,22,1,1,0
12,41,-29,0,1,1
-9,-6,-3,0,1,1
-33,-36,3,1,1,0
-14,28,-42,0,1,1
-31,-40,9,1,1,0
-4,-32,28,1,1,0
-9,-12,3,1,1,0
-1,0,-1,0,1,1
6,24,-18,0,1,1
29,-16,45,1,1,0
22,19,3,1,0,1
2,-7,9,1,0,1
-9,-19,10,1,0,1
40,39,1,1,0,1
64,23,41,1,0,1
-52,-29,-23,0,0,0
-15,6,-21,0,0,0
8,38,-30,0,0,0
-26,-9,-17,0,0,0
-85,-44,-41,0,0,0
7,-8,15,1,1,0
55,25,30,1,1,0
19,-25,44,1,1,0
-54,-22,-32,0,1,1
18,23,-5,0,1,1
6,-15,21,1,1,0
-28,8,-36,0,1,1
13,19,-6,0,1,1
19,33,-14,0,0,0
-63,-30,-33,0,0,0
-8,-36,28,1,0,1
-19,10,-29,0,0,0
71,32,39,1,0,1
-39,-43,4,1,0,1
13,-20,33,1,0,1
-16,-37,21,1,0,1
52,31,21,1,0,1
38,7,31,1,0,1
-17,-40,23,1,0,1
42,39,3,1,0,1
29,13,16,1,1,0
2,36,-34,0,1,1
-47,-37,-10,0,1,1
-22,6,-28,0,1,1
-37,-9,-28,0,1,1
-9,-19,10,1,1,0
23,14,9,1,1,0
-71,-30,-41,0,1,1
-22,-19,-3,0,1,1
1,34,-33,0,1,1
-47,-23,-24,0,1,1
12,16,-4,0,1,1
-29,4,-33,0,1,1
8,-3,11,1,1,0
10,-10,20,1,1,0
-13,-26,13,1,1,0
25,25,0,0,1,1
-68,-45,-23,0,1,1
64,31,33,1,1,0
14,4,10,1,1,0
-6,-10,4,1,1,0
-39,1,-40,0,0,0
-2,-42,40,1,0,1
10,-13,23,1,0,1
-65,-28,-37,0,0,0
-46,-20,-26,0,0,0
56,33,23,1,0,1
-21,-31,10,1,0,1
-9,27,-36,0,0,0
34,-1,35,1,0,1
-2,-21,19,1,0,1
32,-4,36,1,0,1
-51,-8,-43,0,0,0
48,26,22,1,0,1
-6,4,-10,0,0,0
-44,-45,1,1,0,1
-57,-15,-42,0,0,0
-35,-6,-29,0,0,0
-1,9,-10,0,0,0
57,34,23,1,0,1
-70,-34,-36,0,0,0
8,32,-24,0,0,0
36,39,-3,0,1,1
-41,-31,-10,0,1,1
-40,-39,-1,0,1,1
21,29,-8,0,1,1
-54,-38,-16,0,1,1
29,-2,31,1,1,0
-77,-34,-43,0,1,1
-54,-11,-43,0,1,1
-32,3,-35,0,1,1
62,36,26,1,1,0
-39,-36,-3,0,1,1
48,19,29,1,1,0
-38,-43,5,1,1,0
-2,14,-16,0,1,1
-47,-41,-6,0,1,1
13,-22,35,1,1,0
-5,40,-45,0,1,1
14,40,-26,0,1,1
-42,3,-45,0,1,1
16,9,7,1,0,1
47,3,44,1,0,1
19,5,14,1,0,1
5,-22,27,1,0,1
-1,37,-38,0,0,0
-6,-19,13,1,0,1
17,-28,45,1,0,1
14,37,-23,0,0,0
-9,7,-16,0,0,0
17,3,14,1,0,1
3,13,-10,0,0,0
-36,-3,-33,0,0,0
26,31,-5,0,1,1
-33,-13,-20,0,1,1
12,25,-13,0,1,1
-56,-17,-39,0,1,1
27,-16,43,1,1,0
49,17,32,1,1,0
47,10,37,1,1,0
7,2,5,1,1,0
37,25,12,1,1,0
-12,30,-42,0,1,1
35,29,6,1,1,0
-1,-32,31,1,1,0
-30,-29,-1,0,1,1
-25,18,-43,0,1,1
-1,-3,2,1,1,0
60,20,40,1,1,0
5,-29,34,1,1,0
-14,-26,12,1,0,1
-2,24,-26,0,0,0
48,41,7,1,0,1
-77,-37,-40,0,0,0
77,41,36,1,0,1
-21,2,-23,0,0,0
-65,-41,-24,0,0,0
22,42,-20,0,0,0
-13,-40,27,1,0,1
6,-31,37,1,0,1
-19,-41,22,1,0,1
-27,1,-28,0,0,0
42,33,9,1,0,1
59,31,28,1,0,1
19,31,-12,0,1,1
35,10,25,1,1,0
-4,-28,24,1,1,0
61,38,23,1,1,0
25,0,25,1,1,0
-9,21,-30,0,1,1
23,10,13,1,1,0
11,12,-1,0,1,1
18,38,-20,0,1,1
-9,-29,20,1,0,1
-20,-16,-4,0,0,0
27,-13,40,1,0,1
70,41,29,1,0,1
-21,-14,-7,0,0,0
4,36,-32,0,0,0
-5,-24,19,1,0,1
-43,-19,-24,0,0,0
-16,0,-16,0,1,1
46,15,31,1,1,0
12,-10,22,1,1,0
-26,-1,-25,0,1,1
4,-26,30,1,1,0
-30,-32,2,1,1,0
67,29,38,1,1,0
4,-38,42,1,1,0
23,-11,34,1,0,1
-4,-6,2,1,0,1
-58,-31,-27,0,0,0
5,16,-11,0,0,0
27,2,25,1,0,1
-4,8,-12,0,0,0
-43,-13,-30,0,0,0
7,37,-30,0,0,0
12,22,-10,0,0,0
4,-22,26,1,1,0
12,36,-24,0,1,1
83,39,44,1,1,0
81,39,42,1,1,0
-34,-19,-15,0,1,1
-15,-4,-11,0,1,1
16,23,-7,0,1,1
-8,-5,-3,0,1,1
16,6,10,1,1,0
11,43,-32,0,1,1
-33,-37,4,1,1,0
38,32,6,1,1,0
9,33,-24,0,1,1
53,9,44,1,1,0
43,23,20,1,1,0
-10,1,-11,0,1,1
-16,-27,11,1,1,0
-27,11,-38,0,1,1
-28,-12,-16,0,0,0
24,24,0,0,0,0
22,-15,37,1,0,1
-7,-27,20,1,0,1
-36,-13,-23,0,0,0
-5,10,-15,0,0,0
10,-2,12,1,0,1
-59,-26,-33,0,0,0
-45,-10,-35,0,0,0
5,41,-36,0,0,0
34,-4,38,1,0,1
12,-18,30,1,0,1
2,15,-13,0,0,0
-29,-9,-20,0,0,0
42,3,39,1,0,1
-34,-5,-29,0,0,0
15,-15,30,1,0,1
-8,-28,20,1,0,1
17,26,-9,0,0,0
2,31,-29,0,0,0
-13,-34,21,1,1,0
18,-15,33,1,1,0
15,24,-9,0,1,1
44,36,8,1,1,0
54,27,27,1,1,0
-11,5,-16,0,1,1
11,14,-3,0,1,1
33,43,-10,0,1,1
28,36,-8,0,1,1
-81,-37,-44,0,1,1
20,24,-4,0,1,1
36,10,26,1,0,1
15,15,0,0,0,0
-49,-34,-15,0,0,0
78,41,37,1,0,1
8,13,-5,0,0,0
3,1,2,1,0,1
-22,-43,21,1,0,1
10,-2,12,1,0,1
41,7,34,1,0,1
12,33,-21,0,0,0
2,-32,34,1,0,1
-18,-25,7,1,0,1
22,2,20,1,0,1
29,-9,38,1,0,1
-7,30,-37,0,1,1
33,6,27,1,1,0
-8,-9,1,1,1,0
-8,-40,32,1,1,0
-76,-45,-31,0,1,1
5,28,-23,0,1,1
13,-3,16,1,1,0
-30,-10,-20,0,1,1
42,4,38,1,1,0
23,28,-5,0,1,1
-50,-28,-22,0,1,1
-8,-9,1,1,1,0
11,32,-21,0,0,0
-39,-16,-23,0,0,0
-76,-35,-41,0,0,0
4,-16,20,1,0,1
8,-4,12,1,0,1
11,17,-6,0,0,0
16,-2,18,1,0,1
8,42,-34,0,0,0
-27,7,-34,0,0,0
-64,-22,-42,0,0,0
-50,-16,-34,0,0,0
-61,-22,-39,0,0,0
26,13,13,1,0,1
12,0,12,1,1,0
-10,-7,-3,0,1,1
3,2,1,1,1,0
58,24,34,1,1,0
-52,-28,-24,0,1,1
-19,-38,19,1,1,0
55,26,29,1,1,0
-47,-8,-39,0,1,1
6,-13,19,1,1,0
-67,-34,-33,0,1,1
-2,29,-31,0,1,1
51,9,42,1,1,0
46,2,44,1,1,0
8,-7,15,1,1,0
3,33,-30,0,1,1
-17,15,-32,0,0,0
18,12,6,1,0,1
0,-12,12,1,0,1
34,6,28,1,0,1
-55,-18,-37,0,0,0
42,31,11,1,0,1
25,-6,31,1,0,1
74,39,35,1,0,1
11,18,-7,0,0,0
15,-21,36,1,1,0
58,40,18,1,1,0
-30,-45,15,1,1,0
-14,-22,8,1,1,0
-3,41,-44,0,1,1
-15,22,-37,0,1,1
-32,-31,-1,0,1,1
7,34,-27,0,1,1
-48,-45,-3,0,1,1
38,-1,39,1,1,0
17,30,-13,0,1,1
34,34,0,0,1,1
80,39,41,1,1,0
21,26,-5,0,1,1
12,-1,13,1,1,0
-14,4,-18,0,0,0
30,30,0,0,0,0
-12,32,-44,0,0,0
-26,-8,-18,0,0,0
-14,-2,-12,0,0,0
83,42,41,1,0,1
46,33,13,1,0,1
13,-2,15,1,0,1
21,11,10,1,0,1
14,-14,28,1,0,1
15,9,6,1,0,1
9,-35,44,1,0,1
31,8,23,1,0,1
31,14,17,1,1,0
25,-3,28,1,1,0
36,4,32,1,1,0
65,23,42,1,1,0
44,3,41,1,1,0
39,25,14,1,1,0
-26,-31,5,1,1,0
-40,-6,-34,0,1,1
-4,-12,8,1,1,0
67,42,25,1,1,0
5,5,0,0,1,1
-32,-8,-24,0,1,1
49,30,19,1,1,0
22,35,-13,0,0,0
-58,-32,-26,0,0,0
-18,7,-25,0,0,0
13,1,12,1,0,1
-20,-31,11,1,0,1
-51,-42,-9,0,0,0
11,17,-6,0,0,0
-5,-3,-2,0,0,0
-41,-15,-26,0,0,0
-33,-21,-12,0,0,0
22,42,-20,0,0,0
44,29,15,1,0,1
33,23,10,1,1,0
3,34,-31,0,1,1
31,28,3,1,1,0
27,36,-9,0,1,1
62,31,31,1,1,0
17,26,-9,0,1,1
-54,-21,-33,0,1,1
86,44,42,1,1,0
-8,24,-32,0,1,1
44,28,16,1,1,0
9,18,-9,0,1,1
6,-19,25,1,1,0
-8,-45,37,1,1,0
49,26,23,1,1,0
4,32,-28,0,1,1
0,-4,4,1,1,0
-15,-33,18,1,1,0
56,33,23,1,1,0
16,-11,27,1,1,0
-16,-33,17,1,1,0
-27,-15,-12,0,0,0
-84,-40,-44,0,0,0
66,22,44,1,0,1
-40,-31,-9,0,0,0
-73,-32,-41,0,0,0
-21,-38,17,1,0,1
-42,-4,-38,0,0,0
22,-12,34,1,0,1
-24,-25,1,1,1,0
16,23,-7,0,1,1
39,6,33,1,1,0
58,34,24,1,1,0
-14,15,-29,0,1,1
-14,-9,-5,0,1,1
-41,-44,3,1,1,0
-40,-11,-29,0,1,1
-33,8,-41,0,1,1
-66,-44,-22,0,1,1
8,-36,44,1,1,0
2,20,-18,0,1,1
48,8,40,1,1,0
11,-11,22,1,1,0
-62,-42,-20,0,1,1
5,36,-31,0,1,1
25,-12,37,1,1,0
-39,-11,-28,0,1,1
15,-23,38,1,1,0
-20,-16,-4,0,1,1
42,6,36,1,0,1
-54,-44,-10,0,0,0
15,20,-5,0,0,0
6,-11,17,1,0,1
-21,16,-37,0,0,0
-5,-38,33,1,0,1
-1,29,-30,0,0,0
32,19,13,1,0,1
-15,-45,30,1,0,1
-45,-19,-26,0,0,0
-6,-25,19,1,0,1
24,44,-20,0,0,0
19,34,-15,0,0,0
-40,-44,4,1,0,1
-18,14,-32,0,0,0
-10,-10,0,0,0,0
-22,5,-27,0,0,0
13,13,0,0,0,0
-55,-41,-14,0,0,0
-56,-17,-39,0,0,0
8,-20,28,1,0,1
-45,-35,-10,0,1,1
27,-11,38,1,1,0
39,19,20,1,1,0
-28,-39,11,1,1,0
57,14,43,1,1,0
-4,-39,35,1,1,0
-80,-37,-43,0,1,1
28,44,-16,0,1,1
-34,-5,-29,0,1,1
-1,42,-43,0,0,0
-2,-36,34,1,0,1
-41,-43,2,1,0,1
-30,-29,-1,0,0,0
-34,-30,-4,0,0,0
-15,4,-19,0,0,0
49,31,18,1,0,1
13,16,-3,0,0,0
21,13,8,1,0,1
-45,-14,-31,0,0,0
-48,-35,-13,0,0,0
29,2,27,1,0,1
-12,-30,18,1,1,0
39,18,21,1,1,0
16,9,7,1,1,0
19,33,-14,0,1,1
-7,20,-27,0,1,1
48,42,6,1,1,0
27,17,10,1,1,0
-5,-12,7,1,1,0
-2,-32,30,1,1,0
3,2,1,1,1,0
11,-23,34,1,1,0
-15,-30,15,1,1,0
-15,-30,15,1,1,0
-17,-18,1,1,1,0
83,38,45,1,0,1
-24,-22,-2,0,0,0
27,42,-15,0,0,0
-8,-16,8,1,0,1
15,43,-28,0,0,0
-20,-15,-5,0,0,0
-5,4,-9,0,0,0
-14,-37,23,1,0,1
-62,-37,-25,0,0,0
-43,-26,-17,0,0,0
-62,-28,-34,0,0,0
14,-8,22,1,0,1
43,12,31,1,1,0
-51,-38,-13,0,1,1
36,-8,44,1,1,0
62,38,24,1,1,0
78,42,36,1,1,0
49,18,31,1,1,0
7,29,-22,0,1,1
86,42,44,1,1,0
-20,-45,25,1,1,0
32,-1,33,1,1,0
5,-11,16,1,1,0
-34,-37,3,1,1,0
7,-15,22,1,1,0
-37,-45,8,1,1,0
-47,-5,-42,0,1,1
-11,-15,4,1,0,1
0,39,-39,0,0,0
-28,-39,11,1,0,1
40,24,16,1,0,1
16,7,9,1,0,1
19,-15,34,1,0,1
30,-14,44,1,0,1
46,40,6,1,0,1
-16,-35,19,1,0,1
21,-9,30,1,1,0
79,43,36,1,1,0
21,2,19,1,1,0
-15,21,-36,0,1,1
-23,-23,0,0,1,1
-52,-44,-8,0,1,1
-40,-20,-20,0,1,1
12,8,4,1,1,0
-20,11,-31,0,1,1
-47,-44,-3,0,1,1
54,44,10,1,1,0
-5,-8,3,1,0,1
-12,-37,25,1,0,1
50,26,24,1,0,1
-56,-23,-33,0,0,0
21,-12,33,1,0,1
-75,-44,-31,0,0,0
10,-28,38,1,0,1
29,43,-14,0,0,0
13,5,8,1,0,1
46,40,6,1,0,1
-4,-29,25,1,0,1
-9,29,-38,0,0,0
-29,-18,-11,0,1,1
-44,-15,-29,0,1,1
-26,0,-26,0,1,1
-42,-30,-12,0,1,1
54,32,22,1,1,0
58,29,29,1,1,0
16,40,-24,0,1,1
-10,-16,6,1,1,0
-37,-38,1,1,0,1
-55,-39,-16,0,0,0
-2,-7,5,1,0,1
-34,2,-36,0,0,0
10,-7,17,1,0,1
-15,-45,30,1,0,1
18,12,6,1,0,1
39,44,-5,0,0,0
45,30,15,1,0,1
46,2,44,1,0,1
-1,-21,20,1,0,1
-31,11,-42,0,0,0
-19,20,-39,0,0,0
11,-2,13,1,0,1
-28,-14,-14,0,0,0
10,-14,24,1,0,1
-10,-3,-7,0,0,0
-28,-42,14,1,0,1
56,32,24,1,0,1
13,-3,16,1,0,1
-20,16,-36,0,0,0
-26,-34,8,1,1,0
-42,-15,-27,0,1,1
10,8,2,1,1,0
0,13,-13,0,1,1
-2,-37,35,1,1,0
-57,-23,-34,0,1,1
40,11,29,1,1,0
29,15,14,1,1,0
-11,10,-21,0,1,1
43,35,8,1,1,0
-38,-3,-35,0,1,1
-14,11,-25,0,1,1
-6,2,-8,0,1,1
62,22,40,1,1,0
-50,-35,-15,0,1,1
-90,-45,-45,0,1,1
-18,21,-39,0,1,1
-83,-39,-44,0,1,1
56,35,21,1,1,0
59,41,18,1,1,0
-41,-45,4,1,1,0
-13,30,-43,0,0,0
39,37,2,1,0,1
88,44,44,1,0,1
-18,20,-38,0,0,0
-16,9,-25,0,0,0
-13,7,-20,0,0,0
-22,-16,-6,0,0,0
-5,-40,35,1,0,1
41,-4,45,1,0,1
7,-9,16,1,1,0
-9,-41,32,1,1,0
78,43,35,1,1,0
2,32,-30,0,1,1
-18,17,-35,0,1,1
-24,-41,17,1,1,0
-66,-34,-32,0,1,1
44,30,14,1,1,0
-36,-24,-12,0,1,1
-25,-41,16,1,1,0
-81,-38,-43,0,1,1
-1,38,-39,0,1,1
2,-35,37,1,1,0
16,8,8,1,1,0
-17,-25,8,1,1,0
36,10,26,1,1,0
-86,-45,-41,0,1,1
-31,-8,-23,0,1,1
48,33,15,1,1,0
-33,-25,-8,0,1,1
50,34,16,1,1,0
-60,-15,-45,0,0,0
