first_image,second_image,answers,correct_answer,rule,action
35,34,1,1,1,0
42,39,3,1,1,0
23,6,17,1,1,0
48,34,14,1,1,0
28,9,19,1,1,0
-13,-12,-1,0,1,1
-48,-32,-16,0,1,1
-33,-45,12,1,1,0
5,25,-20,0,1,1
34,35,-1,0,1,1
25,44,-19,0,1,1
29,42,-13,0,1,1
33,36,-3,0,1,1
30,43,-13,0,1,1
-36,-45,9,1,1,0
20,23,-3,0,1,1
16,12,4,1,1,0
53,42,11,1,0,1
-22,-25,3,1,0,1
6,-7,13,1,0,1
18,26,-8,0,0,0
4,6,-2,0,0,0
-4,-8,4,1,0,1
47,40,7,1,0,1
-26,-9,-17,0,0,0
-18,-8,-10,0,1,1
20,39,-19,0,1,1
10,-7,17,1,1,0
19,19,0,0,1,1
16,8,8,1,1,0
-20,-19,-1,0,1,1
21,6,15,1,1,0
54,37,17,1,1,0
-44,-40,-4,0,1,1
24,21,3,1,0,1
36,44,-8,0,0,0
39,33,6,1,0,1
-31,-17,-14,0,0,0
18,28,-10,0,0,0
29,17,12,1,0,1
-45,-45,0,0,0,0
13,2,11,1,0,1
-25,-39,14,1,0,1
10,9,1,1,0,1
-10,-2,-8,0,0,0
-14,-23,9,1,0,1
-1,13,-14,0,0,0
-11,-22,11,1,0,1
45,28,17,1,0,1
16,25,-9,0,0,0
37,26,11,1,0,1
-5,-19,14,1,0,1
25,14,11,1,0,1
7,10,-3,0,0,0
44,40,4,1,0,1
38,37,1,1,1,0
3,13,-10,0,1,1
-10,-16,6,1,1,0
-30,-41,11,1,1,0
-35,-31,-4,0,1,1
1,17,-16,0,1,1
-1,-3,2,1,1,0
-16,-1,-15,0,1,1
31,18,13,1,1,0
27,14,13,1,1,0
10,-2,12,1,1,0
39,23,16,1,0,1
-40,-42,2,1,0,1
-16,-7,-9,0,0,0
-25,-39,14,1,0,1
-3,6,-9,0,0,0
26,39,-13,0,0,0
-35,-35,0,0,0,0
46,38,8,1,0,1
33,22,11,1,0,1
-53,-40,-13,0,0,0
-38,-41,3,1,1,0
19,15,4,1,1,0
26,33,-7,0,1,1
-60,-42,-18,0,1,1
14,8,6,1,1,0
-46,-35,-11,0,1,1
-15,-31,16,1,1,0
-40,-44,4,1,1,0
-39,-21,-18,0,1,1
17,20,-3,0,1,1
-17,-27,10,1,1,0
-44,-40,-4,0,1,1
9,-7,16,1,1,0
0,-19,19,1,0,1
24,16,8,1,0,1
-12,-1,-11,0,0,0
-13,-5,-8,0,0,0
13,4,9,1,0,1
-7,4,-11,0,0,0
30,24,6,1,0,1
-18,2,-20,0,0,0
-3,-1,-2,0,1,1
16,29,-13,0,1,1
24,42,-18,0,1,1
17,-3,20,1,1,0
-33,-45,12,1,1,0
-11,-17,6,1,1,0
-29,-26,-3,0,1,1
-50,-34,-16,0,1,1
11,26,-15,0,1,1
-17,-1,-16,0,1,1
28,15,13,1,1,0
27,40,-13,0,1,1
-49,-30,-19,0,1,1
-37,-30,-7,0,1,1
-34,-45,11,1,1,0
-19,-36,17,1,1,0
-10,-2,-8,0,1,1
5,7,-2,0,1,1
-6,-15,9,1,1,0
-27,-40,13,1,1,0
3,5,-2,0,1,1
-28,-27,-1,0,0,0
20,13,7,1,0,1
-33,-27,-6,0,0,0
-28,-31,3,1,0,1
12,14,-2,0,0,0
-22,-21,-1,0,0,0
-57,-37,-20,0,0,0
-25,-16,-9,0,0,0
-21,-36,15,1,0,1
7,-9,16,1,0,1
-14,-26,12,1,0,1
37,33,4,1,0,1
9,24,-15,0,1,1
-41,-38,-3,0,1,1
13,14,-1,0,1,1
48,35,13,1,1,0
-4,1,-5,0,1,1
6,26,-20,0,1,1
-5,11,-16,0,1,1
-41,-44,3,1,1,0
-47,-31,-16,0,1,1
42,25,17,1,0,1
25,20,5,1,0,1
30,13,17,1,0,1
-20,-25,5,1,0,1
8,5,3,1,0,1
42,41,1,1,0,1
-23,-27,4,1,0,1
-29,-43,14,1,0,1
52,39,13,1,0,1
-1,15,-16,0,0,0
-6,-7,1,1,0,1
-48,-40,-8,0,0,0
1,-4,5,1,0,1
-17,-34,17,1,0,1
34,34,0,0,0,0
-18,-21,3,1,0,1
-20,-32,12,1,0,1
-1,4,-5,0,0,0
-25,-34,9,1,1,0
-26,-27,1,1,1,0
29,39,-10,0,1,1
-35,-33,-2,0,1,1
47,28,19,1,1,0
9,-5,14,1,1,0
15,17,-2,0,1,1
-22,-2,-20,0,1,1
28,21,7,1,1,0
-15,-21,6,1,1,0
-6,-4,-2,0,1,1
31,13,18,1,1,0
-38,-32,-6,0,1,1
-8,11,-19,0,1,1
4,10,-6,0,1,1
25,29,-4,0,1,1
-13,-5,-8,0,1,1
50,34,16,1,1,0
-1,-21,20,1,1,0
39,29,10,1,1,0
-37,-23,-14,0,1,1
16,0,16,1,0,1
-26,-30,4,1,0,1
-15,-3,-12,0,0,0
-41,-32,-9,0,0,0
36,29,7,1,0,1
-38,-44,6,1,0,1
0,3,-3,0,0,0
33,16,17,1,0,1
23,23,0,0,0,0
-15,-5,-10,0,0,0
-3,-11,8,1,0,1
-15,2,-17,0,0,0
-26,-15,-11,0,0,0
-9,-4,-5,0,0,0
50,32,18,1,0,1
-20,-10,-10,0,0,0
49,29,20,1,0,1
3,-10,13,1,0,1
53,35,18,1,0,1
23,39,-16,0,1,1
-52,-42,-10,0,1,1
44,43,1,1,1,0
-60,-40,-20,0,1,1
16,35,-19,0,1,1
-29,-27,-2,0,1,1
8,-9,17,1,1,0
-30,-41,11,1,1,0
37,32,5,1,1,0
7,9,-2,0,1,1
-14,-12,-2,0,1,1
-52,-36,-16,0,1,1
10,16,-6,0,1,1
-40,-26,-14,0,1,1
-20,-38,18,1,1,0
-45,-35,-10,0,1,1
47,31,16,1,0,1
-2,-8,6,1,0,1
7,8,-1,0,0,0
14,19,-5,0,0,0
-18,-27,9,1,0,1
3,-3,6,1,0,1
-22,-25,3,1,0,1
23,42,-19,0,0,0
22,25,-3,0,0,0
-30,-29,-1,0,0,0
-2,16,-18,0,0,0
14,21,-7,0,0,0
3,7,-4,0,0,0
25,42,-17,0,1,1
-21,-17,-4,0,1,1
-6,-21,15,1,1,0
-10,-30,20,1,1,0
-15,-1,-14,0,1,1
-9,-8,-1,0,1,1
-48,-35,-13,0,1,1
-20,-12,-8,0,1,1
-42,-30,-12,0,1,1
-16,-34,18,1,1,0
-18,-2,-16,0,1,1
16,-3,19,1,1,0
-24,-35,11,1,1,0
34,37,-3,0,0,0
37,25,12,1,0,1
15,20,-5,0,0,0
36,23,13,1,0,1
23,25,-2,0,0,0
-11,-18,7,1,0,1
-33,-39,6,1,0,1
26,8,18,1,0,1
-28,-43,15,1,1,0
4,23,-19,0,1,1
-31,-25,-6,0,1,1
-32,-34,2,1,1,0
-1,-21,20,1,1,0
-44,-38,-6,0,1,1
52,40,12,1,1,0
23,37,-14,0,1,1
-22,-4,-18,0,1,1
32,33,-1,0,1,1
11,30,-19,0,1,1
31,40,-9,0,1,1
40,40,0,0,1,1
-35,-36,1,1,1,0
37,22,15,1,1,0
6,-8,14,1,1,0
31,16,15,1,1,0
-8,-10,2,1,1,0
-42,-38,-4,0,0,0
10,9,1,1,0,1
21,12,9,1,0,1
-3,0,-3,0,0,0
-24,-37,13,1,0,1
-22,-24,2,1,0,1
12,-7,19,1,0,1
9,17,-8,0,0,0
28,21,7,1,0,1
-56,-36,-20,0,0,0
32,36,-4,0,0,0
-52,-41,-11,0,0,0
-20,-22,2,1,0,1
-14,-24,10,1,0,1
-52,-40,-12,0,0,0
49,44,5,1,0,1
-18,-21,3,1,1,0
-49,-33,-16,0,1,1
-59,-41,-18,0,1,1
-26,-18,-8,0,1,1
-43,-40,-3,0,1,1
-28,-18,-10,0,1,1
25,15,10,1,1,0
6,-4,10,1,1,0
-39,-32,-7,0,1,1
-41,-36,-5,0,1,1
19,33,-14,0,1,1
30,10,20,1,1,0
37,29,8,1,1,0
-21,-8,-13,0,1,1
5,25,-20,0,1,1
33,44,-11,0,1,1
15,21,-6,0,1,1
2,13,-11,0,1,1
-37,-43,6,1,1,0
11,-4,15,1,1,0
29,15,14,1,1,0
23,14,9,1,0,1
46,36,10,1,0,1
-25,-18,-7,0,0,0
-15,-31,16,1,0,1
27,19,8,1,0,1
-15,-2,-13,0,0,0
-28,-39,11,1,0,1
22,20,2,1,0,1
-23,-32,9,1,0,1
3,-8,11,1,0,1
29,42,-13,0,0,0
-3,6,-9,0,0,0
-54,-41,-13,0,0,0
5,-7,12,1,0,1
33,42,-9,0,0,0
10,29,-19,0,0,0
40,25,15,1,0,1
43,42,1,1,0,1
-13,7,-20,0,0,0
-45,-27,-18,0,0,0
28,27,1,1,0,1
-32,-32,0,0,1,1
-55,-43,-12,0,1,1
-32,-43,11,1,1,0
28,18,10,1,1,0
-3,0,-3,0,1,1
-28,-40,12,1,1,0
-3,-3,0,0,1,1
12,18,-6,0,1,1
-9,-18,9,1,1,0
24,30,-6,0,1,1
-37,-33,-4,0,1,1
12,12,0,0,1,1
-51,-33,-18,0,1,1
27,37,-10,0,0,0
6,23,-17,0,0,0
-22,-33,11,1,0,1
1,-11,12,1,0,1
-4,-4,0,0,0,0
-5,0,-5,0,0,0
31,44,-13,0,0,0
37,37,0,0,0,0
48,39,9,1,0,1
-38,-41,3,1,0,1
-30,-25,-5,0,0,0
-21,-16,-5,0,0,0
-25,-26,1,1,0,1
-50,-45,-5,0,0,0
-40,-35,-5,0,0,0
1,-10,11,1,0,1
-42,-27,-15,0,1,1
-24,-6,-18,0,1,1
49,31,18,1,1,0
-58,-40,-18,0,1,1
-37,-26,-11,0,1,1
19,12,7,1,1,0
17,37,-20,0,1,1
26,20,6,1,1,0
-8,-19,11,1,1,0
-11,-12,1,1,1,0
-44,-45,1,1,1,0
19,36,-17,0,0,0
-57,-41,-16,0,0,0
17,20,-3,0,0,0
32,21,11,1,0,1
-59,-39,-20,0,0,0
-1,-15,14,1,0,1
-32,-39,7,1,0,1
42,26,16,1,0,1
25,10,15,1,0,1
2,8,-6,0,0,0
37,24,13,1,0,1
21,26,-5,0,1,1
34,29,5,1,1,0
4,-14,18,1,1,0
23,20,3,1,1,0
34,16,18,1,1,0
24,41,-17,0,1,1
15,10,5,1,1,0
-24,-31,7,1,1,0
26,8,18,1,1,0
-14,-8,-6,0,1,1
-10,7,-17,0,1,1
-17,3,-20,0,1,1
-3,-8,5,1,1,0
13,2,11,1,1,0
-13,-22,9,1,1,0
42,25,17,1,0,1
4,3,1,1,0,1
30,10,20,1,0,1
-1,-21,20,1,0,1
19,2,17,1,0,1
-33,-13,-20,0,0,0
-20,-32,12,1,0,1
-7,-25,18,1,0,1
5,13,-8,0,0,0
-43,-39,-4,0,0,0
-9,2,-11,0,0,0
4,18,-14,0,0,0
6,2,4,1,0,1
32,19,13,1,0,1
-22,-21,-1,0,0,0
-47,-43,-4,0,0,0
-46,-29,-17,0,0,0
51,33,18,1,0,1
23,32,-9,0,0,0
-38,-45,7,1,0,1
36,31,5,1,0,1
23,25,-2,0,1,1
2,7,-5,0,1,1
-6,4,-10,0,1,1
-3,11,-14,0,1,1
6,26,-20,0,1,1
-40,-31,-9,0,1,1
-35,-41,6,1,1,0
15,9,6,1,1,0
-9,-29,20,1,1,0
-50,-33,-17,0,1,1
32,42,-10,0,1,1
-12,-24,12,1,1,0
-40,-30,-10,0,1,1
-8,-18,10,1,0,1
-29,-9,-20,0,0,0
30,44,-14,0,0,0
-10,-29,19,1,0,1
1,13,-12,0,0,0
28,29,-1,0,0,0
41,36,5,1,0,1
-22,-27,5,1,0,1
30,19,11,1,1,0
0,-8,8,1,1,0
-35,-16,-19,0,1,1
-4,-11,7,1,1,0
28,8,20,1,1,0
33,29,4,1,1,0
24,42,-18,0,1,1
-47,-35,-12,0,1,1
15,21,-6,0,1,1
26,9,17,1,1,0
-9,-28,19,1,1,0
-55,-42,-13,0,1,1
1,-10,11,1,1,0
-22,-9,-13,0,1,1
-25,-23,-2,0,1,1
-21,-14,-7,0,1,1
42,29,13,1,1,0
8,27,-19,0,1,1
-10,-13,3,1,1,0
50,39,11,1,0,1
-9,-3,-6,0,0,0
11,16,-5,0,0,0
-3,8,-11,0,0,0
36,16,20,1,0,1
-58,-40,-18,0,0,0
14,25,-11,0,0,0
34,34,0,0,0,0
51,39,12,1,0,1
4,13,-9,0,0,0
39,33,6,1,0,1
30,26,4,1,1,0
24,15,9,1,1,0
14,7,7,1,1,0
-62,-44,-18,0,1,1
12,2,10,1,1,0
36,42,-6,0,1,1
37,18,19,1,1,0
16,8,8,1,1,0
35,42,-7,0,1,1
14,2,12,1,1,0
-25,-11,-14,0,1,1
-21,-15,-6,0,0,0
12,11,1,1,0,1
-21,-14,-7,0,0,0
-5,-14,9,1,0,1
16,17,-1,0,0,0
-40,-29,-11,0,0,0
44,41,3,1,0,1
-26,-43,17,1,0,1
0,-20,20,1,0,1
6,10,-4,0,0,0
-35,-45,10,1,0,1
39,37,2,1,0,1
-23,-39,16,1,0,1
21,39,-18,0,0,0
14,1,13,1,0,1
-28,-45,17,1,0,1
-25,-18,-7,0,1,1
5,-2,7,1,1,0
35,38,-3,0,1,1
8,-5,13,1,1,0
-48,-42,-6,0,1,1
-33,-27,-6,0,1,1
-1,-16,15,1,1,0
-27,-31,4,1,1,0
-32,-33,1,1,1,0
12,14,-2,0,1,1
6,0,6,1,1,0
-10,-4,-6,0,1,1
35,38,-3,0,1,1
9,10,-1,0,1,1
-31,-44,13,1,1,0
21,11,10,1,1,0
-20,-15,-5,0,1,1
55,42,13,1,1,0
36,25,11,1,1,0
2,-17,19,1,1,0
-29,-21,-8,0,1,1
53,41,12,1,0,1
-18,-26,8,1,0,1
15,-5,20,1,0,1
6,15,-9,0,0,0
-27,-14,-13,0,0,0
26,44,-18,0,0,0
24,25,-1,0,0,0
-15,-24,9,1,0,1
15,6,9,1,0,1
-20,-14,-6,0,0,0
24,24,0,0,0,0
-1,-14,13,1,0,1
27,32,-5,0,0,0
36,31,5,1,0,1
40,42,-2,0,0,0
-28,-10,-18,0,0,0
-31,-24,-7,0,0,0
34,31,3,1,0,1
-18,-27,9,1,0,1
-10,-13,3,1,0,1
36,24,12,1,0,1
-29,-40,11,1,1,0
-16,-32,16,1,1,0
-26,-42,16,1,1,0
-38,-34,-4,0,1,1
-20,-29,9,1,1,0
12,16,-4,0,1,1
30,12,18,1,1,0
-26,-20,-6,0,1,1
16,31,-15,0,1,1
13,0,13,1,0,1
29,11,18,1,0,1
45,44,1,1,0,1
-15,-2,-13,0,0,0
51,33,18,1,0,1
41,44,-3,0,0,0
-29,-38,9,1,0,1
43,40,3,1,0,1
-20,-8,-12,0,0,0
-3,4,-7,0,0,0
-18,1,-19,0,0,0
51,41,10,1,0,1
-30,-25,-5,0,0,0
-23,-38,15,1,0,1
-19,-39,20,1,0,1
61,41,20,1,0,1
22,3,19,1,0,1
-13,3,-16,0,0,0
-18,-22,4,1,0,1
13,15,-2,0,0,0
19,12,7,1,0,1
6,20,-14,0,1,1
-4,15,-19,0,1,1
-1,-16,15,1,1,0
-38,-34,-4,0,1,1
-9,-10,1,1,1,0
-28,-10,-18,0,1,1
17,24,-7,0,1,1
-61,-42,-19,0,1,1
1,19,-18,0,1,1
-8,-19,11,1,1,0
24,7,17,1,1,0
27,11,16,1,1,0
-30,-28,-2,0,1,1
11,-9,20,1,1,0
6,2,4,1,1,0
-14,-21,7,1,1,0
-27,-39,12,1,1,0
-4,-19,15,1,1,0
-58,-44,-14,0,1,1
-1,6,-7,0,0,0
8,-7,15,1,0,1
-42,-26,-16,0,0,0
47,36,11,1,0,1
-9,-9,0,0,0,0
36,41,-5,0,0,0
43,43,0,0,0,0
0,-4,4,1,0,1
12,0,12,1,0,1
15,17,-2,0,0,0
-5,-12,7,1,0,1
36,19,17,1,0,1
10,19,-9,0,0,0
-8,-27,19,1,0,1
-8,-16,8,1,0,1
-9,-27,18,1,0,1
-36,-37,1,1,0,1
-2,-14,12,1,0,1
-34,-27,-7,0,0,0
-50,-35,-15,0,0,0
60,44,16,1,0,1
53,44,9,1,1,0
-6,0,-6,0,1,1
25,29,-4,0,1,1
32,30,2,1,1,0
31,34,-3,0,1,1
-12,-19,7,1,1,0
-15,-23,8,1,1,0
43,25,18,1,1,0
17,12,5,1,1,0
-38,-45,7,1,1,0
53,39,14,1,1,0
33,30,3,1,1,0
-11,3,-14,0,1,1
-44,-43,-1,0,1,1
47,32,15,1,1,0
-10,-9,-1,0,1,1
4,4,0,0,1,1
14,23,-9,0,1,1
18,18,0,0,1,1
4,-3,7,1,1,0
-52,-38,-14,0,1,1
-30,-15,-15,0,0,0
9,16,-7,0,0,0
-59,-41,-18,0,0,0
-27,-10,-17,0,0,0
0,-7,7,1,0,1
-38,-19,-19,0,0,0
59,43,16,1,0,1
2,15,-13,0,0,0
47,30,17,1,0,1
12,5,7,1,0,1
4,19,-15,0,0,0
32,42,-10,0,0,0
-21,-5,-16,0,0,0
-25,-41,16,1,0,1
-25,-35,10,1,1,0
56,39,17,1,1,0
-36,-42,6,1,1,0
26,21,5,1,1,0
-42,-34,-8,0,1,1
-12,-14,2,1,1,0
18,34,-16,0,1,1
-8,-10,2,1,1,0
2,-5,7,1,1,0
-20,-27,7,1,1,0
6,4,2,1,0,1
-24,-41,17,1,0,1
-3,-19,16,1,0,1
25,36,-11,0,0,0
-27,-30,3,1,0,1
29,23,6,1,0,1
-22,-23,1,1,0,1
-11,-9,-2,0,0,0
-32,-26,-6,0,1,1
33,18,15,1,1,0
-30,-25,-5,0,1,1
-19,-35,16,1,1,0
3,16,-13,0,1,1
4,-3,7,1,1,0
2,-12,14,1,1,0
32,25,7,1,1,0
-36,-36,0,0,1,1
-30,-42,12,1,0,1
23,13,10,1,0,1
-38,-42,4,1,0,1
1,-4,5,1,0,1
14,9,5,1,0,1
-36,-40,4,1,0,1
-50,-38,-12,0,0,0
50,38,12,1,0,1
32,30,2,1,0,1
-58,-38,-20,0,0,0
-31,-24,-7,0,0,0
-2,10,-12,0,0,0
4,-6,10,1,0,1
-46,-44,-2,0,1,1
26,16,10,1,1,0
-14,-15,1,1,1,0
-29,-28,-1,0,1,1
-1,9,-10,0,1,1
-32,-41,9,1,1,0
51,35,16,1,1,0
34,22,12,1,1,0
3,8,-5,0,1,1
-14,-3,-11,0,1,1
-6,-8,2,1,1,0
29,38,-9,0,1,1
23,16,7,1,1,0
-1,-12,11,1,1,0
-55,-37,-18,0,1,1
43,39,4,1,1,0
46,28,18,1,1,0
11,13,-2,0,1,1
33,19,14,1,1,0
-31,-25,-6,0,1,1
-26,-45,19,1,1,0
4,10,-6,0,0,0
-2,-22,20,1,0,1
-40,-27,-13,0,0,0
-60,-41,-19,0,0,0
-5,-3,-2,0,0,0
7,16,-9,0,0,0
-35,-32,-3,0,0,0
54,38,16,1,0,1
-26,-23,-3,0,1,1
24,40,-16,0,1,1
31,21,10,1,1,0
-45,-33,-12,0,1,1
4,24,-20,0,1,1
12,-5,17,1,1,0
-21,-17,-4,0,1,1
-9,-11,2,1,1,0
17,0,17,1,1,0
-12,-1,-11,0,0,0
-5,-13,8,1,0,1
37,42,-5,0,0,0
48,30,18,1,0,1
15,4,11,1,0,1
15,0,15,1,0,1
26,24,2,1,0,1
17,28,-11,0,0,0
48,38,10,1,0,1
-62,-44,-18,0,0,0
58,38,20,1,0,1
37,39,-2,0,0,0
2,-17,19,1,0,1
22,32,-10,0,0,0
7,10,-3,0,0,0
10,-8,18,1,0,1
23,13,10,1,0,1
-31,-16,-15,0,0,0
38,33,5,1,0,1
-34,-23,-11,0,0,0
-17,-4,-13,0,0,0
-16,-27,11,1,1,0
-42,-30,-12,0,1,1
28,41,-13,0,1,1
-43,-41,-2,0,1,1
-65,-45,-20,0,1,1
-37,-19,-18,0,1,1
26,8,18,1,1,0
-16,-29,13,1,1,0
-20,-5,-15,0,1,1
-30,-25,-5,0,1,1
28,16,12,1,1,0
-26,-30,4,1,1,0
19,-1,20,1,1,0
-26,-10,-16,0,0,0
-33,-34,1,1,0,1
-3,-10,7,1,0,1
24,5,19,1,0,1
-37,-32,-5,0,0,0
24,36,-12,0,0,0
56,38,18,1,0,1
36,44,-8,0,0,0
-4,9,-13,0,0,0
21,25,-4,0,0,0
-7,-23,16,1,0,1
2,18,-16,0,0,0
16,5,11,1,0,1
23,25,-2,0,0,0
40,20,20,1,0,1
-17,-37,20,1,0,1
27,34,-7,0,0,0
-29,-19,-10,0,0,0
-8,-22,14,1,1,0
-11,2,-13,0,1,1
1,4,-3,0,1,1
11,7,4,1,1,0
7,-2,9,1,1,0
-38,-36,-2,0,1,1
-54,-40,-14,0,1,1
-23,-11,-12,0,1,1
3,18,-15,0,1,1
16,21,-5,0,1,1
29,31,-2,0,1,1
-10,-17,7,1,1,0
-49,-32,-17,0,1,1
15,16,-1,0,0,0
12,24,-12,0,0,0
9,14,-5,0,0,0
16,12,4,1,0,1
-33,-45,12,1,0,1
-13,-21,8,1,0,1
32,13,19,1,0,1
7,-10,17,1,0,1
-44,-29,-15,0,1,1
-49,-43,-6,0,1,1
-21,-29,8,1,1,0
18,35,-17,0,1,1
25,42,-17,0,1,1
-30,-29,-1,0,1,1
23,4,19,1,1,0
-43,-30,-13,0,1,1
36,40,-4,0,1,1
1,15,-14,0,1,1
-20,-39,19,1,1,0
-6,11,-17,0,1,1
-46,-29,-17,0,1,1
38,33,5,1,1,0
-9,-20,11,1,1,0
-5,11,-16,0,1,1
-26,-42,16,1,1,0
31,33,-2,0,0,0
-48,-35,-13,0,0,0
24,22,2,1,0,1
-58,-42,-16,0,0,0
-9,-28,19,1,0,1
38,37,1,1,0,1
22,27,-5,0,0,0
-7,12,-19,0,0,0
30,42,-12,0,0,0
-24,-35,11,1,0,1
39,24,15,1,0,1
40,39,1,1,0,1
37,22,15,1,0,1
39,37,2,1,1,0
34,41,-7,0,1,1
-1,-19,18,1,1,0
-16,-9,-7,0,1,1
-13,-23,10,1,1,0
-33,-44,11,1,1,0
-22,-36,14,1,1,0
-18,-25,7,1,1,0
-3,17,-20,0,0,0
38,31,7,1,0,1
-12,-18,6,1,0,1
41,26,15,1,0,1
55,37,18,1,0,1
44,36,8,1,0,1
12,-2,14,1,0,1
23,7,16,1,0,1
31,21,10,1,0,1
5,25,-20,0,0,0
9,-5,14,1,0,1
19,30,-11,0,0,0
23,37,-14,0,0,0
-41,-22,-19,0,1,1
-53,-44,-9,0,1,1
20,34,-14,0,1,1
-28,-13,-15,0,1,1
7,3,4,1,1,0
-24,-42,18,1,1,0
-4,-4,0,0,1,1
-42,-35,-7,0,1,1
27,13,14,1,1,0
16,13,3,1,1,0
-39,-25,-14,0,1,1
-16,1,-17,0,1,1
-64,-45,-19,0,1,1
-28,-38,10,1,1,0
-50,-31,-19,0,1,1
3,-2,5,1,1,0
4,-9,13,1,1,0
-23,-35,12,1,1,0
-33,-22,-11,0,1,1
-15,-34,19,1,1,0
35,35,0,0,1,1
-1,-10,9,1,0,1
-6,13,-19,0,0,0
-16,-18,2,1,0,1
36,17,19,1,0,1
14,3,11,1,0,1
-12,-31,19,1,0,1
-31,-40,9,1,0,1
-50,-43,-7,0,0,0
21,37,-16,0,0,0
-57,-40,-17,0,0,0
28,41,-13,0,0,0
0,-7,7,1,0,1
-24,-41,17,1,0,1
-36,-35,-1,0,0,0
9,-10,19,1,0,1
28,12,16,1,0,1
-22,-6,-16,0,1,1
5,-8,13,1,1,0
55,43,12,1,1,0
-27,-18,-9,0,1,1
-62,-44,-18,0,1,1
-9,11,-20,0,1,1
25,25,0,0,1,1
-4,14,-18,0,1,1
21,31,-10,0,1,1
30,29,1,1,1,0
44,44,0,0,1,1
-18,-11,-7,0,1,1
-2,18,-20,0,1,1
36,35,1,1,0,1
-40,-30,-10,0,0,0
26,19,7,1,0,1
20,3,17,1,0,1
-47,-38,-9,0,0,0
-6,-26,20,1,0,1
10,24,-14,0,0,0
3,21,-18,0,0,0
-42,-42,0,0,0,0
-40,-24,-16,0,0,0
25,34,-9,0,0,0
-13,-10,-3,0,0,0
27,15,12,1,0,1
0,7,-7,0,0,0
34,15,19,1,0,1
0,-12,12,1,0,1
36,26,10,1,0,1
-17,1,-18,0,0,0
7,21,-14,0,0,0
36,35,1,1,0,1
4,-3,7,1,0,1
-29,-38,9,1,1,0
-21,-20,-1,0,1,1
-35,-19,-16,0,1,1
13,-4,17,1,1,0
-46,-27,-19,0,1,1
-10,-23,13,1,1,0
37,26,11,1,1,0
32,41,-9,0,1,1
34,22,12,1,1,0
-25,-28,3,1,1,0
-30,-23,-7,0,1,1
-31,-25,-6,0,1,1
-1,-2,1,1,0,1
9,-6,15,1,0,1
38,44,-6,0,0,0
-47,-44,-3,0,0,0
-42,-35,-7,0,0,0
-7,-18,11,1,0,1
6,-7,13,1,0,1
35,44,-9,0,0,0
-25,-16,-9,0,0,0
-18,-26,8,1,0,1
-26,-30,4,1,0,1
-7,12,-19,0,0,0
2,20,-18,0,1,1
22,12,10,1,1,0
-27,-27,0,0,1,1
15,28,-13,0,1,1
4,15,-11,0,1,1
49,44,5,1,1,0
-21,-8,-13,0,1,1
26,13,13,1,1,0
44,40,4,1,1,0
39,40,-1,0,1,1
21,13,8,1,1,0
19,8,11,1,1,0
-11,-30,19,1,1,0
34,37,-3,0,1,1
1,-19,20,1,1,0
1,16,-15,0,1,1
-17,-36,19,1,1,0
54,35,19,1,1,0
-39,-23,-16,0,1,1
17,4,13,1,0,1
-33,-38,5,1,0,1
-44,-35,-9,0,0,0
-10,-11,1,1,0,1
-19,-7,-12,0,0,0
-15,3,-18,0,0,0
33,21,12,1,0,1
-25,-11,-14,0,0,0
13,1,12,1,0,1
-17,-15,-2,0,0,0
1,-17,18,1,0,1
19,2,17,1,0,1
-46,-27,-19,0,1,1
14,3,11,1,1,0
25,32,-7,0,1,1
5,19,-14,0,1,1
18,18,0,0,1,1
-7,7,-14,0,1,1
-20,-1,-19,0,1,1
-17,-14,-3,0,1,1
5,13,-8,0,1,1
-38,-31,-7,0,1,1
-4,-13,9,1,1,0
51,35,16,1,0,1
-38,-38,0,0,0,0
27,37,-10,0,0,0
29,17,12,1,0,1
-56,-45,-11,0,0,0
-58,-40,-18,0,0,0
28,21,7,1,0,1
-23,-35,12,1,0,1
8,-8,16,1,0,1
9,29,-20,0,0,0
31,28,3,1,0,1
18,36,-18,0,0,0
36,19,17,1,0,1
0,-4,4,1,0,1
1,7,-6,0,0,0
9,4,5,1,0,1
14,1,13,1,0,1
26,10,16,1,0,1
28,18,10,1,0,1
15,12,3,1,0,1
26,39,-13,0,0,0
8,24,-16,0,1,1
47,38,9,1,1,0
58,41,17,1,1,0
4,17,-13,0,1,1
19,3,16,1,1,0
-33,-22,-11,0,1,1
49,31,18,1,1,0
51,31,20,1,1,0
11,29,-18,0,1,1
-28,-20,-8,0,1,1
-11,2,-13,0,1,1
4,-2,6,1,1,0
20,21,-1,0,1,1
5,-13,18,1,1,0
43,41,2,1,0,1
49,30,19,1,0,1
-33,-37,4,1,0,1
-10,-8,-2,0,0,0
-26,-19,-7,0,0,0
-24,-9,-15,0,0,0
15,9,6,1,0,1
-12,-22,10,1,0,1
-55,-36,-19,0,0,0
-23,-6,-17,0,0,0
-24,-25,1,1,0,1
30,35,-5,0,0,0
-58,-41,-17,0,0,0
13,13,0,0,0,0
25,23,2,1,0,1
-3,11,-14,0,0,0
49,33,16,1,0,1
14,1,13,1,0,1
23,15,8,1,0,1
23,5,18,1,0,1
-25,-27,2,1,0,1
12,7,5,1,1,0
19,5,14,1,1,0
3,7,-4,0,1,1
19,25,-6,0,1,1
-11,-4,-7,0,1,1
17,-2,19,1,1,0
-25,-27,2,1,1,0
-21,-36,15,1,1,0
-22,-20,-2,0,1,1
-26,-25,-1,0,1,1
-3,2,-5,0,1,1
-10,-19,9,1,1,0
-23,-37,14,1,1,0
-36,-31,-5,0,1,1
7,-12,19,1,1,0
-37,-36,-1,0,1,1
2,21,-19,0,1,1
-26,-42,16,1,1,0
-37,-37,0,0,1,1
30,28,2,1,1,0
25,12,13,1,1,0
-8,-19,11,1,0,1
0,-1,1,1,0,1
34,40,-6,0,0,0
-11,-16,5,1,0,1
1,10,-9,0,0,0
32,24,8,1,0,1
-47,-29,-18,0,0,0
20,30,-10,0,0,0
9,-8,17,1,0,1
13,13,0,0,0,0
26,31,-5,0,0,0
32,14,18,1,0,1
42,33,9,1,0,1
8,17,-9,0,0,0
25,43,-18,0,0,0
-11,9,-20,0,0,0
-29,-27,-2,0,0,0
40,27,13,1,0,1
-37,-39,2,1,0,1
-6,-11,5,1,0,1
14,16,-2,0,0,0
34,20,14,1,1,0
-57,-43,-14,0,1,1
23,4,19,1,1,0
-19,-34,15,1,1,0
16,25,-9,0,1,1
-53,-45,-8,0,1,1
-12,-1,-11,0,1,1
4,2,2,1,1,0
-2,12,-14,0,1,1
-18,-20,2,1,1,0
7,22,-15,0,1,1
2,-11,13,1,1,0
29,10,19,1,1,0
-12,-10,-2,0,1,1
0,17,-17,0,1,1
-50,-42,-8,0,1,1
12,20,-8,0,1,1
11,1,10,1,1,0
41,30,11,1,1,0
-48,-33,-15,0,1,1
44,37,7,1,1,0
-13,-12,-1,0,0,0
13,30,-17,0,0,0
-42,-40,-2,0,0,0
22,15,7,1,0,1
-32,-21,-11,0,0,0
-9,2,-11,0,0,0
-39,-21,-18,0,0,0
-2,-9,7,1,0,1
-29,-16,-13,0,0,0
24,34,-10,0,0,0
-28,-10,-18,0,0,0
-12,-10,-2,0,1,1
9,-1,10,1,1,0
43,24,19,1,1,0
-13,-30,17,1,1,0
58,39,19,1,1,0
15,19,-4,0,1,1
-15,-22,7,1,1,0
15,0,15,1,1,0
41,40,1,1,0,1
-2,6,-8,0,0,0
39,36,3,1,0,1
27,11,16,1,0,1
-4,-19,15,1,0,1
-51,-43,-8,0,0,0
25,28,-3,0,0,0
-4,-20,16,1,0,1
-38,-18,-20,0,0,0
-40,-31,-9,0,0,0
-11,6,-17,0,0,0
-2,-3,1,1,0,1
-15,-1,-14,0,0,0
-17,-15,-2,0,0,0
28,40,-12,0,0,0
-45,-40,-5,0,0,0
-7,-7,0,0,0,0
-38,-37,-1,0,0,0
-48,-44,-4,0,0,0
-31,-31,0,0,0,0
13,-7,20,1,0,1
8,-5,13,1,1,0
24,39,-15,0,1,1
-29,-14,-15,0,1,1
-1,-17,16,1,1,0
-28,-29,1,1,1,0
14,2,12,1,1,0
5,15,-10,0,1,1
11,21,-10,0,1,1
9,1,8,1,1,0
38,25,13,1,1,0
2,2,0,0,1,1
28,35,-7,0,1,1
49,32,17,1,1,0
1,-5,6,1,1,0
17,15,2,1,1,0
26,39,-13,0,1,1
34,44,-10,0,0,0
-22,-25,3,1,0,1
-21,-41,20,1,0,1
-34,-36,2,1,0,1
23,7,16,1,0,1
13,-2,15,1,0,1
-51,-38,-13,0,0,0
45,40,5,1,0,1
1,-5,6,1,0,1
46,31,15,1,0,1
-37,-21,-16,0,0,0
39,32,7,1,0,1
-28,-24,-4,0,0,0
-37,-42,5,1,0,1
24,18,6,1,0,1
15,1,14,1,0,1
19,35,-16,0,0,0
-15,-24,9,1,0,1
-31,-19,-12,0,1,1
-2,-21,19,1,1,0
-8,-16,8,1,1,0
35,27,8,1,1,0
39,41,-2,0,1,1
38,27,11,1,1,0
31,39,-8,0,1,1
7,-6,13,1,1,0
9,-1,10,1,1,0
-28,-45,17,1,1,0
23,40,-17,0,0,0
19,36,-17,0,0,0
18,34,-16,0,0,0
22,25,-3,0,0,0
10,20,-10,0,0,0
36,36,0,0,0,0
2,-7,9,1,0,1
4,18,-14,0,0,0
18,38,-20,0,0,0
-35,-40,5,1,0,1
19,31,-12,0,0,0
2,15,-13,0,0,0
0,19,-19,0,0,0
-25,-31,6,1,1,0
-13,-32,19,1,1,0
-11,-16,5,1,1,0
-9,8,-17,0,1,1
-28,-42,14,1,1,0
14,14,0,0,1,1
-43,-42,-1,0,1,1
-42,-32,-10,0,1,1
-24,-21,-3,0,1,1
-10,-7,-3,0,1,1
42,22,20,1,1,0
51,42,9,1,1,0
12,1,11,1,1,0
17,-3,20,1,0,1
-49,-30,-19,0,0,0
30,16,14,1,0,1
8,28,-20,0,0,0
-30,-22,-8,0,0,0
-26,-21,-5,0,0,0
22,10,12,1,0,1
20,37,-17,0,0,0
1,-17,18,1,0,1
10,16,-6,0,0,0
-46,-30,-16,0,0,0
33,42,-9,0,0,0
-7,0,-7,0,0,0
-21,-29,8,1,0,1
39,21,18,1,0,1
-15,-33,18,1,0,1
23,8,15,1,0,1
9,-1,10,1,0,1
36,39,-3,0,0,0
-19,-6,-13,0,1,1
27,28,-1,0,1,1
-7,-6,-1,0,1,1
31,19,12,1,1,0
16,19,-3,0,1,1
28,43,-15,0,1,1
40,31,9,1,1,0
-13,-1,-12,0,1,1
2,11,-9,0,1,1
-6,-6,0,0,1,1
-31,-13,-18,0,1,1
27,41,-14,0,1,1
28,44,-16,0,1,1
-32,-40,8,1,1,0
-3,-6,3,1,1,0
-52,-44,-8,0,1,1
-9,-24,15,1,1,0
13,4,9,1,1,0
22,6,16,1,1,0
-24,-12,-12,0,1,1
35,28,7,1,1,0
26,44,-18,0,0,0
-27,-35,8,1,0,1
-3,-5,2,1,0,1
-48,-45,-3,0,0,0
18,8,10,1,0,1
12,-8,20,1,0,1
-28,-33,5,1,0,1
25,34,-9,0,0,0
-37,-18,-19,0,0,0
46,35,11,1,0,1
31,22,9,1,0,1
16,23,-7,0,0,0
0,19,-19,0,0,0
15,13,2,1,0,1
37,43,-6,0,0,0
32,13,19,1,0,1
-10,3,-13,0,0,0
-55,-39,-16,0,0,0
6,11,-5,0,0,0
5,-2,7,1,0,1
8,-6,14,1,0,1
-34,-41,7,1,1,0
-22,-29,7,1,1,0
-53,-33,-20,0,1,1
-15,-21,6,1,1,0
16,1,15,1,1,0
46,37,9,1,1,0
31,12,19,1,1,0
-7,-13,6,1,1,0
-53,-41,-12,0,1,1
-23,-8,-15,0,1,1
-9,-3,-6,0,0,0
18,31,-13,0,0,0
1,-11,12,1,0,1
15,18,-3,0,0,0
-6,-5,-1,0,0,0
3,-11,14,1,0,1
-19,-38,19,1,0,1
-53,-38,-15,0,0,0
-42,-23,-19,0,0,0
-51,-34,-17,0,1,1
-17,-32,15,1,1,0
-22,-18,-4,0,1,1
24,35,-11,0,1,1
-18,-20,2,1,1,0
31,17,14,1,1,0
-3,0,-3,0,1,1
-10,-3,-7,0,1,1
50,33,17,1,1,0
-40,-35,-5,0,1,1
24,38,-14,0,1,1
2,-1,3,1,0,1
32,21,11,1,0,1
-54,-45,-9,0,0,0
-16,-20,4,1,0,1
22,18,4,1,0,1
36,30,6,1,0,1
-50,-30,-20,0,0,0
-9,-22,13,1,0,1
-28,-43,15,1,0,1
-48,-33,-15,0,0,0
15,34,-19,0,1,1
-10,0,-10,0,1,1
11,-9,20,1,1,0
-2,10,-12,0,1,1
-1,3,-4,0,1,1
-20,-3,-17,0,1,1
-38,-21,-17,0,1,1
48,44,4,1,1,0
8,21,-13,0,0,0
1,11,-10,0,0,0
-31,-35,4,1,0,1
-48,-28,-20,0,0,0
46,30,16,1,0,1
17,8,9,1,0,1
43,29,14,1,0,1
-43,-23,-20,0,0,0
4,-10,14,1,0,1
-22,-14,-8,0,0,0
-27,-28,1,1,0,1
-44,-24,-20,0,0,0
49,37,12,1,0,1
7,23,-16,0,0,0
-10,-17,7,1,0,1
-61,-41,-20,0,1,1
-25,-33,8,1,1,0
-4,4,-8,0,1,1
7,4,3,1,1,0
-2,-4,2,1,1,0
5,2,3,1,1,0
-1,2,-3,0,1,1
-7,-15,8,1,1,0
20,35,-15,0,0,0
-3,-21,18,1,0,1
-48,-37,-11,0,0,0
12,4,8,1,0,1
43,25,18,1,0,1
-39,-34,-5,0,0,0
-36,-36,0,0,0,0
-47,-30,-17,0,0,0
39,42,-3,0,1,1
-17,-14,-3,0,1,1
-29,-33,4,1,1,0
7,26,-19,0,1,1
-44,-33,-11,0,1,1
17,-1,18,1,1,0
9,-8,17,1,1,0
-15,-1,-14,0,1,1
-27,-41,14,1,1,0
35,33,2,1,1,0
25,42,-17,0,1,1
34,42,-8,0,1,1
54,37,17,1,1,0
33,44,-11,0,1,1
55,41,14,1,1,0
-46,-36,-10,0,1,1
30,31,-1,0,1,1
14,3,11,1,1,0
-62,-45,-17,0,1,1
22,25,-3,0,1,1
0,9,-9,0,1,1
0,2,-2,0,0,0
-21,-7,-14,0,0,0
-10,-20,10,1,0,1
-5,-3,-2,0,0,0
-9,-22,13,1,0,1
-10,-14,4,1,0,1
45,31,14,1,0,1
-19,-4,-15,0,0,0
27,27,0,0,0,0
7,-1,8,1,0,1
-5,6,-11,0,0,0
-39,-42,3,1,0,1
16,36,-20,0,0,0
17,3,14,1,0,1
41,36,5,1,0,1
35,41,-6,0,0,0
-26,-17,-9,0,0,0
-15,-21,6,1,0,1
-11,0,-11,0,0,0
34,37,-3,0,0,0
20,32,-12,0,0,0
23,35,-12,0,1,1
13,7,6,1,1,0
-5,-16,11,1,1,0
-30,-38,8,1,1,0
-47,-33,-14,0,1,1
36,39,-3,0,1,1
-5,-3,-2,0,1,1
-29,-40,11,1,1,0
39,34,5,1,1,0
-8,-8,0,0,1,1
4,9,-5,0,1,1
-33,-27,-6,0,1,1
41,32,9,1,1,0
-35,-15,-20,0,1,1
55,37,18,1,1,0
20,23,-3,0,1,1
-37,-32,-5,0,1,1
-19,-9,-10,0,1,1
24,15,9,1,1,0
44,24,20,1,0,1
3,17,-14,0,0,0
-28,-42,14,1,0,1
-3,-5,2,1,0,1
-28,-32,4,1,0,1
48,32,16,1,0,1
-11,2,-13,0,0,0
-14,-8,-6,0,0,0
-23,-8,-15,0,0,0
-19,-9,-10,0,0,0
-46,-43,-3,0,0,0
-6,-10,4,1,1,0
32,22,10,1,1,0
39,41,-2,0,1,1
41,22,19,1,1,0
-40,-35,-5,0,1,1
42,43,-1,0,1,1
-47,-29,-18,0,1,1
-4,-17,13,1,1,0
-7,-14,7,1,1,0
-46,-31,-15,0,1,1
-52,-39,-13,0,1,1
11,27,-16,0,1,1
-46,-35,-11,0,1,1
5,21,-16,0,1,1
16,29,-13,0,1,1
-17,-12,-5,0,1,1
-8,-9,1,1,1,0
-1,-11,10,1,1,0
13,33,-20,0,1,1
35,17,18,1,1,0
31,26,5,1,1,0
26,29,-3,0,0,0
-6,-5,-1,0,0,0
-32,-17,-15,0,0,0
20,1,19,1,0,1
2,7,-5,0,0,0
-31,-26,-5,0,0,0
-15,-35,20,1,0,1
-41,-22,-19,0,0,0
-58,-45,-13,0,0,0
-28,-23,-5,0,0,0
1,13,-12,0,0,0
16,-4,20,1,0,1
14,16,-2,0,0,0
6,7,-1,0,0,0
24,31,-7,0,0,0
19,3,16,1,0,1
7,25,-18,0,0,0
-7,-24,17,1,0,1
-27,-17,-10,0,0,0
-26,-43,17,1,0,1
-11,-29,18,1,0,1
18,24,-6,0,1,1
22,31,-9,0,1,1
-27,-43,16,1,1,0
-3,4,-7,0,1,1
27,26,1,1,1,0
48,32,16,1,1,0
-9,-29,20,1,1,0
25,18,7,1,1,0
4,13,-9,0,1,1
-30,-14,-16,0,1,1
-50,-39,-11,0,1,1
-12,8,-20,0,1,1
-34,-35,1,1,1,0
2,1,1,1,1,0
-33,-42,9,1,1,0
43,38,5,1,1,0
28,23,5,1,1,0
-19,-16,-3,0,1,1
48,33,15,1,1,0
18,19,-1,0,1,1
-32,-17,-15,0,1,1
-30,-32,2,1,0,1
15,10,5,1,0,1
18,27,-9,0,0,0
52,40,12,1,0,1
2,10,-8,0,0,0
15,34,-19,0,0,0
-14,1,-15,0,0,0
-23,-20,-3,0,0,0
8,17,-9,0,0,0
29,30,-1,0,0,0
11,14,-3,0,0,0
-10,-10,0,0,0,0
29,35,-6,0,1,1
-53,-39,-14,0,1,1
-13,-24,11,1,1,0
13,0,13,1,1,0
34,43,-9,0,1,1
14,7,7,1,1,0
14,17,-3,0,1,1
9,4,5,1,1,0
-58,-38,-20,0,1,1
3,3,0,0,1,1
-46,-40,-6,0,1,1
30,20,10,1,1,0
8,18,-10,0,1,1
-1,-17,16,1,1,0
-31,-14,-17,0,1,1
17,33,-16,0,1,1
25,13,12,1,1,0
13,-1,14,1,1,0
46,32,14,1,0,1
-10,-15,5,1,0,1
26,25,1,1,0,1
-20,-8,-12,0,0,0
-31,-36,5,1,0,1
7,20,-13,0,0,0
-18,-34,16,1,0,1
42,33,9,1,0,1
-3,-9,6,1,0,1
21,41,-20,0,0,0
31,42,-11,0,0,0
-28,-29,1,1,0,1
22,35,-13,0,0,0
24,15,9,1,0,1
17,18,-1,0,0,0
8,-4,12,1,0,1
-28,-29,1,1,0,1
45,42,3,1,0,1
-36,-26,-10,0,0,0
-36,-43,7,1,0,1
-9,-5,-4,0,1,1
-8,-20,12,1,1,0
-30,-17,-13,0,1,1
-24,-17,-7,0,1,1
26,19,7,1,1,0
47,35,12,1,1,0
-14,-2,-12,0,1,1
-38,-44,6,1,1,0
-33,-38,5,1,1,0
-42,-37,-5,0,1,1
18,6,12,1,1,0
-37,-18,-19,0,1,1
0,-15,15,1,1,0
6,16,-10,0,1,1
36,24,12,1,1,0
-11,-6,-5,0,1,1
-40,-44,4,1,1,0
6,21,-15,0,1,1
37,32,5,1,1,0
1,-17,18,1,1,0
-6,-6,0,0,1,1
-31,-13,-18,0,0,0
16,35,-19,0,0,0
-22,-15,-7,0,0,0
-35,-35,0,0,0,0
-17,-8,-9,0,0,0
34,43,-9,0,0,0
3,15,-12,0,0,0
31,11,20,1,0,1
20,30,-10,0,0,0
44,29,15,1,0,1
29,42,-13,0,0,0
-1,-10,9,1,0,1
28,31,-3,0,0,0
-3,-9,6,1,0,1
-17,-30,13,1,0,1
-62,-44,-18,0,0,0
-2,14,-16,0,0,0
-46,-28,-18,0,0,0
-2,-16,14,1,0,1
-9,-4,-5,0,0,0
13,15,-2,0,0,0
15,29,-14,0,1,1
-33,-31,-2,0,1,1
5,7,-2,0,1,1
-26,-17,-9,0,1,1
-26,-11,-15,0,1,1
-22,-3,-19,0,1,1
-27,-28,1,1,1,0
-6,-9,3,1,1,0
19,7,12,1,1,0
3,19,-16,0,1,1
32,29,3,1,1,0
28,29,-1,0,1,1
8,13,-5,0,1,1
-14,5,-19,0,1,1
13,22,-9,0,1,1
5,-3,8,1,1,0
15,8,7,1,1,0
29,32,-3,0,1,1
-34,-15,-19,0,1,1
27,22,5,1,1,0
-21,-34,13,1,1,0
-20,-38,18,1,0,1
6,11,-5,0,0,0
-43,-38,-5,0,0,0
-11,-4,-7,0,0,0
29,17,12,1,0,1
-47,-32,-15,0,0,0
25,19,6,1,0,1
-6,-5,-1,0,0,0
-51,-37,-14,0,0,0
-49,-37,-12,0,0,0
2,1,1,1,0,1
42,26,16,1,1,0
3,14,-11,0,1,1
12,16,-4,0,1,1
-23,-34,11,1,1,0
28,25,3,1,1,0
53,37,16,1,1,0
-33,-19,-14,0,1,1
-59,-40,-19,0,1,1
53,34,19,1,1,0
-34,-20,-14,0,1,1
42,26,16,1,1,0
17,31,-14,0,1,1
-4,15,-19,0,1,1
-1,5,-6,0,1,1
-7,-23,16,1,1,0
-40,-34,-6,0,0,0
-38,-21,-17,0,0,0
17,5,12,1,0,1
-7,5,-12,0,0,0
-25,-26,1,1,0,1
11,0,11,1,0,1
43,26,17,1,0,1
60,41,19,1,0,1
-19,0,-19,0,0,0
-42,-40,-2,0,0,0
13,29,-16,0,0,0
-5,-18,13,1,0,1
27,12,15,1,0,1
17,22,-5,0,0,0
-9,11,-20,0,0,0
-41,-22,-19,0,0,0
-41,-34,-7,0,0,0
7,16,-9,0,0,0
37,44,-7,0,0,0
1,-13,14,1,0,1
54,43,11,1,0,1
-19,-3,-16,0,1,1
21,2,19,1,1,0
0,-19,19,1,1,0
-13,7,-20,0,1,1
-23,-36,13,1,1,0
2,10,-8,0,1,1
-37,-41,4,1,1,0
15,1,14,1,1,0
-7,-13,6,1,1,0
-1,-7,6,1,1,0
-11,-13,2,1,0,1
-29,-25,-4,0,0,0
26,13,13,1,0,1
6,3,3,1,0,1
9,24,-15,0,0,0
24,31,-7,0,0,0
-40,-45,5,1,0,1
-8,-8,0,0,0,0
14,2,12,1,0,1
-23,-26,3,1,1,0
2,-18,20,1,1,0
40,20,20,1,1,0
50,44,6,1,1,0
-7,1,-8,0,1,1
19,20,-1,0,1,1
26,40,-14,0,1,1
15,33,-18,0,1,1
-26,-42,16,1,1,0
9,5,4,1,0,1
-26,-29,3,1,0,1
3,1,2,1,0,1
-4,-3,-1,0,0,0
-51,-32,-19,0,0,0
-14,-2,-12,0,0,0
44,28,16,1,0,1
37,19,18,1,0,1
23,18,5,1,0,1
41,32,9,1,0,1
58,40,18,1,1,0
0,0,0,0,1,1
-30,-41,11,1,1,0
3,-15,18,1,1,0
-33,-31,-2,0,1,1
-13,-16,3,1,1,0
15,35,-20,0,1,1
31,24,7,1,1,0
1,16,-15,0,1,1
-54,-35,-19,0,1,1
21,27,-6,0,1,1
-24,-26,2,1,1,0
33,43,-10,0,1,1
1,-8,9,1,1,0
4,3,1,1,1,0
-50,-44,-6,0,1,1
-9,-25,16,1,1,0
-48,-35,-13,0,1,1
-41,-42,1,1,1,0
-15,-14,-1,0,1,1
4,24,-20,0,1,1
3,-11,14,1,0,1
40,29,11,1,0,1
0,8,-8,0,0,0
-20,-4,-16,0,0,0
-40,-26,-14,0,0,0
33,31,2,1,0,1
-49,-37,-12,0,0,0
22,35,-13,0,0,0
-16,-34,18,1,0,1
-29,-26,-3,0,0,0
9,3,6,1,0,1
-37,-41,4,1,0,1
-45,-25,-20,0,1,1
22,12,10,1,1,0
41,29,12,1,1,0
17,4,13,1,1,0
-37,-22,-15,0,1,1
-15,-29,14,1,1,0
25,29,-4,0,1,1
33,34,-1,0,1,1
24,39,-15,0,1,1
-41,-26,-15,0,1,1
-45,-38,-7,0,1,1
3,-16,19,1,1,0
-17,-12,-5,0,1,1
13,20,-7,0,1,1
-8,0,-8,0,1,1
44,42,2,1,1,0
43,36,7,1,1,0
-11,-22,11,1,1,0
-52,-42,-10,0,1,1
30,29,1,1,1,0
-25,-27,2,1,1,0
-25,-14,-11,0,0,0
32,22,10,1,0,1
-34,-40,6,1,0,1
53,34,19,1,0,1
-3,-3,0,0,0,0
24,28,-4,0,0,0
40,25,15,1,0,1
14,18,-4,0,0,0
-8,-10,2,1,0,1
10,27,-17,0,0,0
-4,-7,3,1,0,1
-1,-2,1,1,0,1
-18,-33,15,1,0,1
-30,-42,12,1,0,1
-7,-5,-2,0,0,0
32,13,19,1,0,1
-44,-26,-18,0,0,0
-36,-30,-6,0,0,0
49,31,18,1,0,1
-6,3,-9,0,0,0
3,22,-19,0,1,1
-42,-32,-10,0,1,1
-11,0,-11,0,1,1
15,10,5,1,1,0
2,-18,20,1,1,0
5,0,5,1,1,0
-36,-21,-15,0,1,1
-12,-32,20,1,1,0
26,23,3,1,1,0
7,9,-2,0,1,1
25,36,-11,0,1,1
41,28,13,1,1,0
9,22,-13,0,1,1
-33,-36,3,1,1,0
-26,-13,-13,0,1,1
4,-7,11,1,1,0
-43,-41,-2,0,1,1
-48,-42,-6,0,1,1
-39,-19,-20,0,1,1
10,14,-4,0,1,1
-44,-39,-5,0,1,1
-5,6,-11,0,0,0
-21,-15,-6,0,0,0
-14,-29,15,1,0,1
-6,7,-13,0,0,0
-7,10,-17,0,0,0
-1,-13,12,1,0,1
19,24,-5,0,0,0
14,0,14,1,0,1
15,-4,19,1,0,1
4,-10,14,1,0,1
-1,-14,13,1,0,1
-4,-15,11,1,0,1
12,17,-5,0,0,0
53,33,20,1,0,1
-47,-34,-13,0,0,0
-20,-6,-14,0,0,0
3,-10,13,1,1,0
-16,-21,5,1,1,0
43,24,19,1,1,0
-5,-19,14,1,1,0
16,15,1,1,1,0
46,28,18,1,1,0
-9,-19,10,1,1,0
2,16,-14,0,1,1
-3,-17,14,1,1,0
-22,-33,11,1,1,0
-35,-38,3,1,1,0
1,18,-17,0,1,1
-33,-28,-5,0,1,1
-20,-13,-7,0,1,1
14,-6,20,1,1,0
-13,-5,-8,0,1,1
-29,-28,-1,0,1,1
-42,-45,3,1,0,1
-39,-19,-20,0,0,0
9,9,0,0,0,0
-28,-42,14,1,0,1
-35,-32,-3,0,0,0
5,23,-18,0,0,0
43,27,16,1,0,1
-42,-30,-12,0,0,0
30,34,-4,0,0,0
-16,-13,-3,0,0,0
-7,9,-16,0,0,0
1,-12,13,1,0,1
-34,-35,1,1,0,1
-8,-3,-5,0,1,1
15,33,-18,0,1,1
0,3,-3,0,1,1
21,22,-1,0,1,1
21,16,5,1,1,0
-4,-22,18,1,1,0
-22,-38,16,1,1,0
-17,-18,1,1,1,0
-10,-4,-6,0,0,0
-31,-24,-7,0,0,0
-39,-38,-1,0,0,0
7,17,-10,0,0,0
-14,-24,10,1,0,1
-38,-21,-17,0,0,0
-20,-21,1,1,0,1
8,-8,16,1,0,1
-13,-14,1,1,0,1
2,19,-17,0,1,1
-44,-25,-19,0,1,1
10,17,-7,0,1,1
-32,-44,12,1,1,0
-17,1,-18,0,1,1
27,7,20,1,1,0
-11,-22,11,1,1,0
23,15,8,1,1,0
-13,-23,10,1,1,0
49,36,13,1,1,0
9,20,-11,0,1,1
44,30,14,1,1,0
34,29,5,1,1,0
32,15,17,1,1,0
-11,-30,19,1,1,0
13,14,-1,0,1,1
46,35,11,1,1,0
-28,-44,16,1,1,0
-29,-11,-18,0,1,1
13,32,-19,0,1,1
-45,-39,-6,0,1,1
45,32,13,1,0,1
32,15,17,1,0,1
-26,-37,11,1,0,1
6,-9,15,1,0,1
23,24,-1,0,0,0
-61,-44,-17,0,0,0
-39,-27,-12,0,0,0
-43,-30,-13,0,0,0
16,-2,18,1,0,1
1,17,-16,0,0,0
22,37,-15,0,0,0
-52,-34,-18,0,0,0
26,23,3,1,0,1
27,27,0,0,0,0
-36,-31,-5,0,0,0
4,1,3,1,0,1
-16,-26,10,1,0,1
23,36,-13,0,1,1
7,10,-3,0,1,1
35,18,17,1,1,0
-44,-36,-8,0,1,1
14,1,13,1,1,0
24,5,19,1,1,0
19,36,-17,0,1,1
-1,13,-14,0,1,1
13,-1,14,1,1,0
16,12,4,1,1,0
41,38,3,1,0,1
-25,-18,-7,0,0,0
-22,-23,1,1,0,1
18,2,16,1,0,1
-13,-9,-4,0,0,0
5,17,-12,0,0,0
3,-8,11,1,0,1
26,39,-13,0,0,0
-49,-38,-11,0,1,1
-28,-28,0,0,1,1
-48,-33,-15,0,1,1
-57,-39,-18,0,1,1
-8,-18,10,1,1,0
-1,-19,18,1,1,0
47,39,8,1,1,0
40,41,-1,0,1,1
-20,-3,-17,0,0,0
-18,-7,-11,0,0,0
-38,-32,-6,0,0,0
5,-14,19,1,0,1
8,-10,18,1,0,1
2,-1,3,1,0,1
8,-3,11,1,0,1
-21,-34,13,1,0,1
7,-2,9,1,0,1
-32,-41,9,1,0,1
27,32,-5,0,0,0
-2,7,-9,0,0,0
-31,-13,-18,0,0,0
5,5,0,0,0,0
18,14,4,1,1,0
11,31,-20,0,1,1
-58,-38,-20,0,1,1
18,13,5,1,1,0
-46,-39,-7,0,1,1
13,21,-8,0,1,1
-23,-20,-3,0,1,1
-17,-6,-11,0,1,1
32,43,-11,0,1,1
-23,-19,-4,0,1,1
24,12,12,1,1,0
-61,-45,-16,0,1,1
-33,-42,9,1,1,0
-54,-42,-12,0,1,1
-18,1,-19,0,1,1
46,41,5,1,1,0
20,16,4,1,1,0
22,42,-20,0,1,1
43,28,15,1,1,0
24,30,-6,0,1,1
-24,-24,0,0,1,1
16,32,-16,0,0,0
44,28,16,1,0,1
-27,-39,12,1,0,1
4,15,-11,0,0,0
-2,-2,0,0,0,0
6,-7,13,1,0,1
44,39,5,1,0,1
-42,-22,-20,0,0,0
-2,-10,8,1,0,1
45,36,9,1,0,1
9,20,-11,0,0,0
-28,-39,11,1,0,1
10,13,-3,0,0,0
-30,-35,5,1,0,1
15,6,9,1,0,1
-40,-22,-18,0,1,1
7,7,0,0,1,1
-26,-35,9,1,1,0
-35,-28,-7,0,1,1
-17,2,-19,0,1,1
6,-7,13,1,1,0
9,26,-17,0,1,1
14,32,-18,0,1,1
-20,0,-20,0,1,1
48,29,19,1,0,1
-18,-21,3,1,0,1
-13,-7,-6,0,0,0
29,30,-1,0,0,0
25,5,20,1,0,1
-34,-33,-1,0,0,0
-28,-24,-4,0,0,0
-20,-4,-16,0,0,0
-35,-16,-19,0,1,1
-36,-17,-19,0,1,1
-31,-24,-7,0,1,1
35,15,20,1,1,0
12,32,-20,0,1,1
57,41,16,1,1,0
23,24,-1,0,1,1
-6,-9,3,1,1,0
-48,-42,-6,0,1,1
6,1,5,1,1,0
1,18,-17,0,1,1
14,20,-6,0,1,1
-31,-22,-9,0,1,1
19,38,-19,0,1,1
18,25,-7,0,1,1
33,25,8,1,1,0
49,43,6,1,0,1
18,34,-16,0,0,0
-16,-21,5,1,0,1
-33,-28,-5,0,0,0
2,2,0,0,0,0
-9,-12,3,1,0,1
-13,-13,0,0,0,0
27,41,-14,0,0,0
-41,-22,-19,0,0,0
-16,-15,-1,0,0,0
-37,-32,-5,0,0,0
0,9,-9,0,1,1
-44,-33,-11,0,1,1
-5,-8,3,1,1,0
26,8,18,1,1,0
57,38,19,1,1,0
8,1,7,1,1,0
44,44,0,0,1,1
3,-5,8,1,1,0
-13,-11,-2,0,1,1
11,-1,12,1,1,0
-35,-23,-12,0,1,1
18,37,-19,0,0,0
40,35,5,1,0,1
32,19,13,1,0,1
-37,-40,3,1,0,1
7,-6,13,1,0,1
-46,-41,-5,0,0,0
29,29,0,0,0,0
-8,12,-20,0,0,0
10,-8,18,1,0,1
-30,-26,-4,0,0,0
-3,-11,8,1,0,1
22,9,13,1,1,0
-6,-18,12,1,1,0
51,36,15,1,1,0
38,42,-4,0,1,1
-1,0,-1,0,1,1
-35,-24,-11,0,1,1
33,27,6,1,1,0
-10,-9,-1,0,1,1
-48,-41,-7,0,1,1
30,43,-13,0,1,1
-2,-2,0,0,1,1
26,10,16,1,1,0
6,-12,18,1,1,0
-29,-39,10,1,0,1
27,33,-6,0,0,0
2,7,-5,0,0,0
-26,-16,-10,0,0,0
-31,-38,7,1,0,1
-43,-30,-13,0,0,0
23,16,7,1,0,1
16,2,14,1,0,1
55,41,14,1,0,1
-11,-18,7,1,1,0
-15,-20,5,1,1,0
-32,-40,8,1,1,0
-17,-5,-12,0,1,1
-23,-26,3,1,1,0
26,44,-18,0,1,1
24,13,11,1,1,0
-3,0,-3,0,1,1
-20,0,-20,0,1,1
-4,3,-7,0,1,1
26,39,-13,0,1,1
-40,-40,0,0,0,0
9,23,-14,0,0,0
-13,-28,15,1,0,1
12,13,-1,0,0,0
-27,-14,-13,0,0,0
9,15,-6,0,0,0
18,34,-16,0,0,0
-19,-32,13,1,0,1
11,8,3,1,0,1
-14,5,-19,0,1,1
-13,-15,2,1,1,0
-30,-17,-13,0,1,1
-8,9,-17,0,1,1
21,12,9,1,1,0
-21,-10,-11,0,1,1
-25,-25,0,0,1,1
36,35,1,1,1,0
19,31,-12,0,1,1
0,-19,19,1,1,0
-25,-44,19,1,0,1
-48,-45,-3,0,0,0
-7,5,-12,0,0,0
-11,8,-19,0,0,0
47,30,17,1,0,1
-29,-27,-2,0,0,0
50,35,15,1,0,1
-15,-15,0,0,0,0
12,-4,16,1,0,1
41,23,18,1,0,1
-14,-26,12,1,0,1
26,16,10,1,0,1
-39,-34,-5,0,0,0
31,12,19,1,0,1
9,4,5,1,0,1
-8,-9,1,1,0,1
10,17,-7,0,1,1
-32,-25,-7,0,1,1
12,-4,16,1,1,0
-1,10,-11,0,1,1
27,19,8,1,1,0
-3,4,-7,0,1,1
55,44,11,1,1,0
-24,-39,15,1,1,0
26,38,-12,0,1,1
2,14,-12,0,1,1
-31,-35,4,1,1,0
-58,-43,-15,0,1,1
31,40,-9,0,1,1
-5,13,-18,0,1,1
-6,-21,15,1,1,0
-12,1,-13,0,0,0
34,37,-3,0,0,0
6,-6,12,1,0,1
9,-1,10,1,0,1
14,9,5,1,0,1
21,5,16,1,0,1
-48,-33,-15,0,0,0
-18,-33,15,1,0,1
-29,-29,0,0,0,0
-3,16,-19,0,0,0
43,39,4,1,0,1
45,40,5,1,0,1
-12,-21,9,1,0,1
-39,-22,-17,0,0,0
-42,-26,-16,0,1,1
22,8,14,1,1,0
36,27,9,1,1,0
-2,5,-7,0,1,1
50,35,15,1,1,0
-4,-14,10,1,1,0
28,36,-8,0,1,1
-20,-34,14,1,1,0
7,-10,17,1,1,0
32,44,-12,0,1,1
-27,-37,10,1,1,0
50,44,6,1,1,0
-23,-34,11,1,1,0
-13,-10,-3,0,1,1
-12,-21,9,1,1,0
-20,-39,19,1,0,1
5,7,-2,0,0,0
7,-10,17,1,0,1
-16,-26,10,1,0,1
7,25,-18,0,0,0
-41,-32,-9,0,0,0
-24,-32,8,1,0,1
21,30,-9,0,0,0
-26,-31,5,1,0,1
18,16,2,1,0,1
28,17,11,1,1,0
23,35,-12,0,1,1
24,36,-12,0,1,1
14,11,3,1,1,0
47,30,17,1,1,0
-38,-42,4,1,1,0
41,33,8,1,1,0
-29,-23,-6,0,1,1
-9,-25,16,1,1,0
39,25,14,1,1,0
30,43,-13,0,1,1
-1,5,-6,0,1,1
-28,-21,-7,0,1,1
31,36,-5,0,1,1
-13,-22,9,1,1,0
48,36,12,1,1,0
13,6,7,1,1,0
-29,-32,3,1,0,1
-49,-40,-9,0,0,0
18,2,16,1,0,1
-4,6,-10,0,0,0
-17,-25,8,1,0,1
-9,-11,2,1,0,1
-26,-12,-14,0,0,0
-2,8,-10,0,0,0
33,32,1,1,1,0
23,19,4,1,1,0
-19,-16,-3,0,1,1
15,7,8,1,1,0
-28,-33,5,1,1,0
-33,-44,11,1,1,0
-8,-22,14,1,1,0
25,36,-11,0,1,1
51,38,13,1,1,0
-24,-8,-16,0,1,1
-36,-43,7,1,1,0
-10,-3,-7,0,1,1
-2,-14,12,1,1,0
-18,2,-20,0,1,1
-20,-40,20,1,1,0
14,24,-10,0,0,0
-27,-23,-4,0,0,0
22,28,-6,0,0,0
-19,-30,11,1,0,1
58,39,19,1,0,1
18,4,14,1,0,1
-13,-24,11,1,0,1
-38,-32,-6,0,0,0
56,42,14,1,0,1
8,23,-15,0,1,1
-25,-6,-19,0,1,1
-19,-39,20,1,1,0
21,39,-18,0,1,1
27,36,-9,0,1,1
39,35,4,1,1,0
-20,-27,7,1,1,0
38,42,-4,0,1,1
-20,-34,14,1,1,0
58,38,20,1,1,0
-21,-13,-8,0,1,1
-52,-39,-13,0,1,1
30,30,0,0,1,1
-50,-37,-13,0,1,1
43,32,11,1,1,0
-29,-25,-4,0,1,1
-29,-34,5,1,1,0
49,43,6,1,1,0
5,9,-4,0,1,1
-34,-26,-8,0,1,1
36,41,-5,0,1,1
17,19,-2,0,0,0
61,43,18,1,0,1
-34,-20,-14,0,0,0
-14,-33,19,1,0,1
49,29,20,1,0,1
27,43,-16,0,0,0
-8,-6,-2,0,0,0
-20,-29,9,1,0,1
2,-17,19,1,1,0
-14,-25,11,1,1,0
13,32,-19,0,1,1
-33,-19,-14,0,1,1
24,21,3,1,1,0
29,29,0,0,1,1
-31,-30,-1,0,1,1
-13,2,-15,0,1,1
14,11,3,1,0,1
-42,-27,-15,0,0,0
-7,-11,4,1,0,1
0,-3,3,1,0,1
-37,-42,5,1,0,1
0,7,-7,0,0,0
-30,-38,8,1,0,1
7,-4,11,1,0,1
17,32,-15,0,0,0
-18,-1,-17,0,0,0
24,19,5,1,0,1
16,16,0,0,0,0
-5,7,-12,0,0,0
2,-5,7,1,0,1
57,44,13,1,0,1
-48,-30,-18,0,0,0
-10,-23,13,1,0,1
25,5,20,1,0,1
-20,-36,16,1,0,1
-15,-20,5,1,0,1
18,25,-7,0,0,0
62,43,19,1,1,0
-36,-38,2,1,1,0
17,26,-9,0,1,1
12,-7,19,1,1,0
-39,-27,-12,0,1,1
-22,-31,9,1,1,0
-28,-12,-16,0,1,1
-36,-45,9,1,1,0
12,17,-5,0,1,1
15,9,6,1,1,0
46,43,3,1,0,1
-40,-31,-9,0,0,0
34,28,6,1,0,1
13,19,-6,0,0,0
-19,-7,-12,0,0,0
-3,-22,19,1,0,1
-54,-36,-18,0,0,0
40,40,0,0,0,0
-51,-36,-15,0,1,1
-54,-42,-12,0,1,1
-19,-33,14,1,1,0
10,-8,18,1,1,0
16,26,-10,0,1,1
-24,-19,-5,0,1,1
13,33,-20,0,1,1
10,3,7,1,1,0
24,39,-15,0,1,1
-8,-1,-7,0,0,0
-53,-38,-15,0,0,0
13,11,2,1,0,1
43,27,16,1,0,1
-35,-40,5,1,0,1
-24,-24,0,0,0,0
4,-15,19,1,0,1
29,44,-15,0,0,0
32,34,-2,0,0,0
-57,-38,-19,0,0,0
18,25,-7,0,0,0
-14,-8,-6,0,0,0
30,36,-6,0,0,0
-16,-10,-6,0,0,0
43,27,16,1,0,1
-43,-26,-17,0,0,0
-27,-31,4,1,0,1
-1,-16,15,1,0,1
3,1,2,1,0,1
-41,-40,-1,0,0,0
-45,-29,-16,0,0,0
-21,-17,-4,0,1,1
-3,-15,12,1,1,0
25,27,-2,0,1,1
-26,-14,-12,0,1,1
-16,-28,12,1,1,0
-7,-10,3,1,1,0
-39,-33,-6,0,1,1
-51,-41,-10,0,1,1
-20,-18,-2,0,1,1
8,-5,13,1,1,0
1,7,-6,0,1,1
-11,4,-15,0,1,1
-25,-29,4,1,0,1
22,42,-20,0,0,0
49,44,5,1,0,1
22,9,13,1,0,1
23,12,11,1,0,1
12,6,6,1,0,1
10,13,-3,0,0,0
-2,14,-16,0,0,0
-4,-11,7,1,0,1
10,29,-19,0,0,0
2,-18,20,1,0,1
35,20,15,1,0,1
3,22,-19,0,0,0
-18,-9,-9,0,0,0
-34,-30,-4,0,0,0
37,34,3,1,0,1
41,24,17,1,0,1
27,28,-1,0,0,0
-12,6,-18,0,1,1
18,36,-18,0,1,1
-20,-18,-2,0,1,1
-25,-19,-6,0,1,1
45,33,12,1,1,0
-15,-11,-4,0,1,1
-21,-1,-20,0,1,1
-26,-37,11,1,1,0
-25,-43,18,1,1,0
-5,15,-20,0,1,1
-16,-31,15,1,1,0
-3,-18,15,1,1,0
-59,-43,-16,0,1,1
-45,-28,-17,0,1,1
5,-14,19,1,1,0
14,-4,18,1,1,0
-42,-37,-5,0,1,1
-27,-13,-14,0,1,1
-20,-18,-2,0,1,1
-33,-34,1,1,1,0
7,0,7,1,0,1
-32,-30,-2,0,0,0
-17,-3,-14,0,0,0
47,30,17,1,0,1
28,27,1,1,0,1
-18,-35,17,1,0,1
22,11,11,1,0,1
-23,-7,-16,0,0,0
23,25,-2,0,0,0
45,34,11,1,0,1
-17,-19,2,1,0,1
-25,-15,-10,0,0,0
-19,-37,18,1,1,0
-22,-17,-5,0,1,1
-28,-22,-6,0,1,1
2,21,-19,0,1,1
-21,-14,-7,0,1,1
-28,-37,9,1,1,0
14,10,4,1,1,0
-4,-1,-3,0,1,1
-26,-28,2,1,0,1
34,42,-8,0,0,0
-23,-3,-20,0,0,0
19,15,4,1,0,1
6,-12,18,1,0,1
-26,-10,-16,0,0,0
-21,-1,-20,0,0,0
36,28,8,1,0,1
-19,-2,-17,0,0,0
-33,-17,-16,0,0,0
25,6,19,1,0,1
16,30,-14,0,0,0
22,15,7,1,0,1
36,16,20,1,0,1
44,37,7,1,0,1
-11,-11,0,0,0,0
9,15,-6,0,0,0
-20,-12,-8,0,0,0
17,-3,20,1,0,1
17,35,-18,0,1,1
-27,-19,-8,0,1,1
-7,7,-14,0,1,1
-24,-10,-14,0,1,1
-42,-39,-3,0,1,1
-26,-11,-15,0,1,1
8,26,-18,0,1,1
16,2,14,1,1,0
-51,-34,-17,0,1,1
18,-2,20,1,1,0
-39,-20,-19,0,1,1
36,19,17,1,1,0
13,12,1,1,1,0
39,37,2,1,1,0
9,1,8,1,1,0
11,27,-16,0,1,1
-24,-24,0,0,1,1
2,8,-6,0,1,1
-44,-39,-5,0,1,1
-11,4,-15,0,1,1
38,30,8,1,1,0
-36,-29,-7,0,0,0
36,17,19,1,0,1
40,31,9,1,0,1
-11,-14,3,1,0,1
47,42,5,1,0,1
-17,-19,2,1,0,1
-28,-41,13,1,0,1
-3,14,-17,0,0,0
7,15,-8,0,0,0
-1,-12,11,1,0,1
-28,-26,-2,0,0,0
-9,-18,9,1,0,1
25,23,2,1,0,1
-18,-19,1,1,0,1
-1,15,-16,0,0,0
-40,-22,-18,0,0,0
-30,-19,-11,0,0,0
-23,-10,-13,0,0,0
-31,-12,-19,0,0,0
5,6,-1,0,0,0
44,29,15,1,0,1
-36,-31,-5,0,1,1
-20,-15,-5,0,1,1
-16,-19,3,1,1,0
-7,13,-20,0,1,1
21,29,-8,0,1,1
-42,-25,-17,0,1,1
-49,-36,-13,0,1,1
-44,-35,-9,0,1,1
18,6,12,1,1,0
14,18,-4,0,1,1
-17,-25,8,1,0,1
-4,-23,19,1,0,1
2,19,-17,0,0,0
-51,-33,-18,0,0,0
34,43,-9,0,0,0
3,-11,14,1,0,1
-8,4,-12,0,0,0
-59,-39,-20,0,0,0
17,5,12,1,0,1
-43,-29,-14,0,0,0
26,41,-15,0,0,0
30,18,12,1,0,1
-4,-10,6,1,0,1
8,2,6,1,0,1
2,-12,14,1,0,1
-30,-38,8,1,0,1
-20,-12,-8,0,0,0
-14,-13,-1,0,0,0
41,33,8,1,0,1
-40,-38,-2,0,0,0
-25,-20,-5,0,1,1
35,26,9,1,1,0
34,41,-7,0,1,1
7,-13,20,1,1,0
-21,-18,-3,0,1,1
42,29,13,1,1,0
44,43,1,1,1,0
5,25,-20,0,1,1
18,16,2,1,1,0
18,25,-7,0,1,1
19,1,18,1,1,0
-14,-21,7,1,1,0
-47,-29,-18,0,1,1
57,37,20,1,0,1
39,25,14,1,0,1
8,28,-20,0,0,0
-21,-11,-10,0,0,0
20,31,-11,0,0,0
-24,-4,-20,0,0,0
-16,-23,7,1,0,1
-21,-13,-8,0,0,0
-33,-22,-11,0,0,0
-56,-41,-15,0,0,0
4,9,-5,0,0,0
21,4,17,1,0,1
-3,4,-7,0,0,0
1,16,-15,0,0,0
-13,-2,-11,0,1,1
5,12,-7,0,1,1
-17,-30,13,1,1,0
-17,1,-18,0,1,1
41,29,12,1,1,0
27,8,19,1,1,0
17,4,13,1,1,0
28,26,2,1,1,0
52,40,12,1,1,0
-10,-21,11,1,1,0
55,35,20,1,1,0
22,7,15,1,1,0
-3,-16,13,1,1,0
-9,2,-11,0,1,1
-34,-33,-1,0,1,1
47,44,3,1,1,0
-26,-24,-2,0,1,1
-32,-45,13,1,1,0
-36,-40,4,1,1,0
5,-11,16,1,1,0
-24,-42,18,1,0,1
-5,-4,-1,0,0,0
9,20,-11,0,0,0
-21,-34,13,1,0,1
30,16,14,1,0,1
-21,-7,-14,0,0,0
53,39,14,1,0,1
7,14,-7,0,0,0
51,34,17,1,1,0
6,-10,16,1,1,0
-48,-45,-3,0,1,1
-58,-38,-20,0,1,1
8,3,5,1,1,0
-20,-16,-4,0,1,1
17,19,-2,0,1,1
-52,-34,-18,0,1,1
-26,-15,-11,0,1,1
-44,-41,-3,0,1,1
19,21,-2,0,1,1
-3,14,-17,0,1,1
-48,-39,-9,0,1,1
14,-1,15,1,1,0
20,5,15,1,0,1
27,20,7,1,0,1
-3,-12,9,1,0,1
-11,-25,14,1,0,1
-10,-3,-7,0,0,0
-22,-3,-19,0,0,0
16,26,-10,0,0,0
15,18,-3,0,0,0
-37,-18,-19,0,0,0
-27,-16,-11,0,0,0
-32,-17,-15,0,0,0
45,40,5,1,0,1
38,23,15,1,0,1
63,44,19,1,0,1
-30,-24,-6,0,0,0
42,27,15,1,0,1
15,16,-1,0,0,0
47,30,17,1,0,1
36,43,-7,0,0,0
43,38,5,1,0,1
41,26,15,1,0,1
-8,-11,3,1,1,0
-38,-29,-9,0,1,1
7,22,-15,0,1,1
31,36,-5,0,1,1
6,13,-7,0,1,1
-24,-5,-19,0,1,1
19,39,-20,0,1,1
-37,-38,1,1,1,0
-51,-43,-8,0,0,0
-27,-12,-15,0,0,0
-46,-33,-13,0,0,0
6,-10,16,1,0,1
34,18,16,1,0,1
25,38,-13,0,0,0
-26,-30,4,1,0,1
38,42,-4,0,0,0
-23,-33,10,1,0,1
-50,-34,-16,0,0,0
-10,-18,8,1,0,1
31,26,5,1,1,0
23,42,-19,0,1,1
-27,-37,10,1,1,0
36,37,-1,0,1,1
4,-8,12,1,1,0
8,-1,9,1,1,0
9,12,-3,0,1,1
-21,-5,-16,0,1,1
53,41,12,1,1,0
21,37,-16,0,1,1
31,35,-4,0,1,1
3,-13,16,1,0,1
-5,12,-17,0,0,0
-1,2,-3,0,0,0
10,14,-4,0,0,0
-55,-39,-16,0,0,0
-49,-45,-4,0,0,0
6,-14,20,1,0,1
-15,-25,10,1,0,1
37,23,14,1,1,0
-24,-13,-11,0,1,1
-39,-27,-12,0,1,1
8,13,-5,0,1,1
43,35,8,1,1,0
39,26,13,1,1,0
40,33,7,1,1,0
-3,1,-4,0,1,1
21,39,-18,0,1,1
1,11,-10,0,1,1
37,42,-5,0,1,1
16,32,-16,0,1,1
-13,-3,-10,0,1,1
18,8,10,1,1,0
-2,-10,8,1,1,0
-34,-19,-15,0,1,1
7,-4,11,1,1,0
20,35,-15,0,1,1
-46,-35,-11,0,0,0
-48,-38,-10,0,0,0
-21,-24,3,1,0,1
-27,-20,-7,0,0,0
13,26,-13,0,0,0
7,8,-1,0,0,0
40,32,8,1,0,1
-19,-24,5,1,0,1
-34,-40,6,1,0,1
12,13,-1,0,0,0
5,25,-20,0,0,0
15,31,-16,0,0,0
-9,-16,7,1,0,1
22,26,-4,0,0,0
-7,-9,2,1,0,1
20,7,13,1,1,0
7,5,2,1,1,0
24,31,-7,0,1,1
-25,-11,-14,0,1,1
19,3,16,1,1,0
-14,-30,16,1,1,0
-14,-3,-11,0,1,1
1,2,-1,0,1,1
-17,1,-18,0,1,1
3,5,-2,0,1,1
-18,-36,18,1,1,0
-46,-41,-5,0,1,1
16,1,15,1,1,0
29,23,6,1,1,0
-25,-5,-20,0,1,1
-18,-19,1,1,1,0
-17,-26,9,1,0,1
-25,-7,-18,0,0,0
5,14,-9,0,0,0
-8,11,-19,0,0,0
-21,-34,13,1,0,1
33,17,16,1,0,1
48,35,13,1,0,1
25,8,17,1,0,1
32,41,-9,0,0,0
-13,-18,5,1,0,1
-31,-39,8,1,0,1
9,27,-18,0,0,0
-15,2,-17,0,0,0
39,31,8,1,0,1
-28,-32,4,1,0,1
-20,-11,-9,0,0,0
47,28,19,1,1,0
51,32,19,1,1,0
23,20,3,1,1,0
-16,-8,-8,0,1,1
32,22,10,1,1,0
28,25,3,1,1,0
35,37,-2,0,1,1
-37,-18,-19,0,1,1
-29,-35,6,1,1,0
0,-17,17,1,1,0
-31,-33,2,1,1,0
-46,-31,-15,0,1,1
44,29,15,1,1,0
39,33,6,1,1,0
16,4,12,1,1,0
15,26,-11,0,1,1
15,14,1,1,1,0
40,23,17,1,0,1
-59,-45,-14,0,0,0
-2,-17,15,1,0,1
-11,-25,14,1,0,1
23,15,8,1,0,1
-8,-21,13,1,0,1
23,14,9,1,0,1
-4,-3,-1,0,0,0
-48,-30,-18,0,0,0
28,21,7,1,0,1
-8,3,-11,0,0,0
26,28,-2,0,0,0
-5,-21,16,1,0,1
-25,-33,8,1,0,1
-22,-41,19,1,0,1
53,42,11,1,0,1
-9,-8,-1,0,0,0
9,8,1,1,0,1
-23,-23,0,0,0,0
-2,16,-18,0,1,1
26,44,-18,0,1,1
24,10,14,1,1,0
24,14,10,1,1,0
45,26,19,1,1,0
20,37,-17,0,1,1
12,8,4,1,1,0
-22,-9,-13,0,1,1
-4,-10,6,1,1,0
8,12,-4,0,1,1
50,36,14,1,1,0
30,31,-1,0,1,1
-25,-12,-13,0,1,1
-6,6,-12,0,1,1
7,7,0,0,1,1
-11,-17,6,1,1,0
-13,-18,5,1,1,0
36,16,20,1,1,0
18,36,-18,0,0,0
-37,-41,4,1,0,1
28,41,-13,0,0,0
-35,-32,-3,0,0,0
-37,-32,-5,0,0,0
37,23,14,1,0,1
-60,-43,-17,0,0,0
21,25,-4,0,0,0
27,30,-3,0,0,0
-5,-11,6,1,0,1
-4,12,-16,0,0,0
1,3,-2,0,0,0
33,17,16,1,0,1
-47,-30,-17,0,0,0
-35,-24,-11,0,1,1
-46,-35,-11,0,1,1
-25,-8,-17,0,1,1
31,34,-3,0,1,1
34,38,-4,0,1,1
-32,-44,12,1,1,0
-57,-42,-15,0,1,1
-36,-31,-5,0,1,1
27,21,6,1,1,0
-40,-28,-12,0,1,1
-26,-32,6,1,1,0
-41,-44,3,1,1,0
-2,9,-11,0,1,1
-45,-28,-17,0,1,1
-13,1,-14,0,1,1
-34,-29,-5,0,1,1
-17,-20,3,1,0,1
-19,-34,15,1,0,1
7,25,-18,0,0,0
16,34,-18,0,0,0
40,30,10,1,0,1
-29,-19,-10,0,0,0
19,18,1,1,0,1
4,4,0,0,0,0
-4,-2,-2,0,1,1
14,23,-9,0,1,1
14,24,-10,0,1,1
-42,-26,-16,0,1,1
-32,-26,-6,0,1,1
46,38,8,1,1,0
-9,-25,16,1,1,0
25,31,-6,0,1,1
15,0,15,1,1,0
-8,-11,3,1,1,0
-21,-25,4,1,1,0
4,13,-9,0,1,1
3,-16,19,1,1,0
5,6,-1,0,1,1
22,15,7,1,1,0
-14,-23,9,1,1,0
40,21,19,1,1,0
-32,-12,-20,0,1,1
-8,7,-15,0,1,1
-32,-21,-11,0,1,1
-7,10,-17,0,1,1
-18,-12,-6,0,0,0
-22,-15,-7,0,0,0
-27,-45,18,1,0,1
-55,-44,-11,0,0,0
-31,-13,-18,0,0,0
-6,1,-7,0,0,0
-23,-21,-2,0,0,0
37,26,11,1,0,1
-14,-2,-12,0,0,0
53,40,13,1,0,1
10,22,-12,0,1,1
-23,-26,3,1,1,0
41,40,1,1,1,0
-2,-8,6,1,1,0
2,14,-12,0,1,1
13,27,-14,0,1,1
11,-1,12,1,1,0
-48,-38,-10,0,1,1
15,30,-15,0,1,1
-35,-26,-9,0,0,0
14,6,8,1,0,1
2,3,-1,0,0,0
-4,4,-8,0,0,0
46,44,2,1,0,1
-35,-44,9,1,0,1
-1,-5,4,1,0,1
49,37,12,1,0,1
-41,-23,-18,0,0,0
10,30,-20,0,1,1
22,13,9,1,1,0
37,25,12,1,1,0
5,0,5,1,1,0
-57,-43,-14,0,1,1
38,31,7,1,1,0
32,36,-4,0,1,1
-13,-23,10,1,1,0
-31,-30,-1,0,1,1
32,36,-4,0,1,1
-31,-31,0,0,1,1
-42,-30,-12,0,1,1
46,36,10,1,1,0
37,33,4,1,1,0
4,16,-12,0,1,1
3,16,-13,0,1,1
-31,-16,-15,0,1,1
43,27,16,1,0,1
-3,11,-14,0,0,0
22,21,1,1,0,1
40,36,4,1,0,1
21,25,-4,0,0,0
0,12,-12,0,0,0
-20,-29,9,1,0,1
-16,-6,-10,0,0,0
9,-5,14,1,0,1
-28,-14,-14,0,0,0
-6,-8,2,1,0,1
-28,-11,-17,0,0,0
-18,-36,18,1,0,1
10,20,-10,0,0,0
-28,-17,-11,0,0,0
-17,-33,16,1,0,1
-38,-38,0,0,1,1
-15,-30,15,1,1,0
15,18,-3,0,1,1
20,15,5,1,1,0
-7,-27,20,1,1,0
-6,4,-10,0,1,1
-25,-33,8,1,1,0
-22,-20,-2,0,1,1
6,4,2,1,1,0
38,24,14,1,0,1
-37,-21,-16,0,0,0
13,30,-17,0,0,0
-10,-28,18,1,0,1
10,-7,17,1,0,1
-54,-42,-12,0,0,0
-10,9,-19,0,0,0
-1,5,-6,0,0,0
23,37,-14,0,0,0
-5,-17,12,1,0,1
15,8,7,1,0,1
-38,-43,5,1,0,1
-29,-42,13,1,0,1
-27,-42,15,1,0,1
-8,2,-10,0,0,0
51,42,9,1,0,1
34,32,2,1,0,1
27,10,17,1,0,1
0,-14,14,1,0,1
-14,-5,-9,0,0,0
29,38,-9,0,0,0
37,27,10,1,1,0
-16,-8,-8,0,1,1
0,-5,5,1,1,0
-21,-38,17,1,1,0
-37,-20,-17,0,1,1
-23,-41,18,1,1,0
43,27,16,1,1,0
12,8,4,1,1,0
-19,-27,8,1,1,0
-5,-5,0,0,1,1
-24,-16,-8,0,1,1
40,27,13,1,1,0
-26,-45,19,1,1,0
-47,-32,-15,0,1,1
38,40,-2,0,1,1
25,35,-10,0,1,1
46,40,6,1,1,0
-48,-29,-19,0,1,1
-13,-24,11,1,1,0
17,6,11,1,1,0
57,39,18,1,1,0
-15,-5,-10,0,0,0
17,34,-17,0,0,0
32,14,18,1,0,1
-31,-30,-1,0,0,0
21,33,-12,0,0,0
1,-1,2,1,0,1
36,42,-6,0,0,0
-7,-23,16,1,0,1
-26,-13,-13,0,0,0
-51,-43,-8,0,0,0
17,-2,19,1,0,1
21,26,-5,0,1,1
42,43,-1,0,1,1
14,18,-4,0,1,1
3,20,-17,0,1,1
-18,-16,-2,0,1,1
-9,-22,13,1,1,0
15,35,-20,0,1,1
6,10,-4,0,1,1
-39,-33,-6,0,1,1
-1,-16,15,1,0,1
3,14,-11,0,0,0
-23,-13,-10,0,0,0
-55,-42,-13,0,0,0
-16,-1,-15,0,0,0
-26,-40,14,1,0,1
-52,-38,-14,0,0,0
-6,12,-18,0,0,0
-12,-17,5,1,1,0
22,25,-3,0,1,1
8,14,-6,0,1,1
14,13,1,1,1,0
-17,-35,18,1,1,0
-12,-27,15,1,1,0
32,14,18,1,1,0
-48,-35,-13,0,1,1
-9,-18,9,1,0,1
-35,-35,0,0,0,0
24,40,-16,0,0,0
12,15,-3,0,0,0
-8,12,-20,0,0,0
-31,-41,10,1,0,1
-54,-39,-15,0,0,0
19,14,5,1,0,1
14,9,5,1,1,0
-26,-35,9,1,1,0
-21,-38,17,1,1,0
-65,-45,-20,0,1,1
42,23,19,1,1,0
-8,-23,15,1,1,0
-6,3,-9,0,1,1
55,35,20,1,1,0
-3,11,-14,0,1,1
-6,-17,11,1,1,0
39,26,13,1,1,0
-13,-25,12,1,1,0
-13,-14,1,1,1,0
-4,-21,17,1,1,0
-60,-44,-16,0,1,1
42,30,12,1,1,0
-20,-17,-3,0,1,1
-28,-26,-2,0,1,1
-31,-12,-19,0,1,1
-5,-13,8,1,1,0
-23,-5,-18,0,1,1
0,5,-5,0,0,0
12,20,-8,0,0,0
33,19,14,1,0,1
29,11,18,1,0,1
-14,-5,-9,0,0,0
-4,-13,9,1,0,1
-38,-27,-11,0,0,0
10,-6,16,1,0,1
25,40,-15,0,0,0
-11,-8,-3,0,0,0
-16,-19,3,1,0,1
-48,-33,-15,0,0,0
-25,-17,-8,0,0,0
-7,3,-10,0,0,0
-21,-15,-6,0,0,0
-17,2,-19,0,0,0
-13,-29,16,1,0,1
20,3,17,1,0,1
-45,-42,-3,0,0,0
15,22,-7,0,0,0
5,-5,10,1,0,1
-1,-20,19,1,1,0
-8,-6,-2,0,1,1
13,-2,15,1,1,0
37,24,13,1,1,0
-36,-26,-10,0,1,1
-19,-36,17,1,1,0
-28,-13,-15,0,1,1
19,13,6,1,1,0
10,-10,20,1,0,1
21,8,13,1,0,1
-9,7,-16,0,0,0
16,22,-6,0,0,0
56,44,12,1,0,1
17,8,9,1,0,1
-14,1,-15,0,0,0
-6,-10,4,1,0,1
1,21,-20,0,0,0
35,37,-2,0,0,0
-18,-26,8,1,0,1
5,-11,16,1,1,0
-14,-5,-9,0,1,1
32,19,13,1,1,0
35,31,4,1,1,0
-36,-44,8,1,1,0
6,8,-2,0,1,1
19,6,13,1,1,0
11,-8,19,1,1,0
41,24,17,1,1,0
-8,-2,-6,0,1,1
-41,-25,-16,0,1,1
23,13,10,1,1,0
-46,-31,-15,0,1,1
-7,-16,9,1,1,0
-59,-45,-14,0,1,1
-3,-15,12,1,1,0
33,38,-5,0,1,1
36,19,17,1,1,0
-38,-39,1,1,1,0
11,17,-6,0,1,1
35,42,-7,0,1,1
39,31,8,1,0,1
0,-9,9,1,0,1
-10,-7,-3,0,0,0
44,38,6,1,0,1
31,36,-5,0,0,0
20,3,17,1,0,1
-28,-11,-17,0,0,0
30,30,0,0,0,0
-56,-42,-14,0,0,0
6,-12,18,1,0,1
-10,3,-13,0,0,0
-13,-16,3,1,0,1
-39,-41,2,1,0,1
22,13,9,1,0,1
16,23,-7,0,0,0
34,40,-6,0,0,0
36,28,8,1,0,1
10,9,1,1,0,1
-55,-43,-12,0,0,0
-6,-6,0,0,0,0
-53,-33,-20,0,0,0
10,-8,18,1,1,0
-51,-43,-8,0,1,1
-49,-36,-13,0,1,1
-23,-30,7,1,1,0
34,18,16,1,1,0
-16,-32,16,1,1,0
-21,-34,13,1,1,0
-27,-42,15,1,1,0
15,0,15,1,1,0
-54,-35,-19,0,1,1
16,27,-11,0,0,0
-37,-25,-12,0,0,0
46,44,2,1,0,1
48,37,11,1,0,1
-28,-43,15,1,0,1
40,28,12,1,0,1
-30,-15,-15,0,0,0
9,1,8,1,0,1
7,20,-13,0,0,0
25,24,1,1,0,1
-59,-39,-20,0,0,0
22,38,-16,0,1,1
-7,-27,20,1,1,0
-15,-6,-9,0,1,1
-41,-28,-13,0,1,1
-51,-35,-16,0,1,1
30,33,-3,0,1,1
-12,-7,-5,0,1,1
-18,-35,17,1,1,0
-39,-27,-12,0,0,0
-46,-33,-13,0,0,0
3,15,-12,0,0,0
42,27,15,1,0,1
-8,-2,-6,0,0,0
-38,-42,4,1,0,1
-2,-17,15,1,0,1
0,-3,3,1,0,1
-54,-43,-11,0,0,0
-24,-31,7,1,0,1
-22,-41,19,1,0,1
-33,-43,10,1,0,1
-24,-15,-9,0,0,0
30,43,-13,0,0,0
-38,-34,-4,0,0,0
21,33,-12,0,0,0
-32,-16,-16,0,0,0
-7,0,-7,0,0,0
60,40,20,1,0,1
30,14,16,1,0,1
-31,-36,5,1,0,1
9,27,-18,0,1,1
39,39,0,0,1,1
-28,-32,4,1,1,0
10,-3,13,1,1,0
-35,-30,-5,0,1,1
14,33,-19,0,1,1
-25,-14,-11,0,1,1
21,29,-8,0,1,1
50,41,9,1,1,0
10,8,2,1,1,0
-14,-34,20,1,1,0
12,31,-19,0,0,0
31,37,-6,0,0,0
33,25,8,1,0,1
45,43,2,1,0,1
1,-2,3,1,0,1
-18,-28,10,1,0,1
-21,-33,12,1,0,1
33,25,8,1,0,1
11,6,5,1,1,0
-59,-43,-16,0,1,1
-28,-34,6,1,1,0
18,31,-13,0,1,1
10,13,-3,0,1,1
28,42,-14,0,1,1
-19,-17,-2,0,1,1
-8,-25,17,1,1,0
10,23,-13,0,1,1
3,-3,6,1,1,0
8,7,1,1,1,0
-8,-13,5,1,1,0
34,43,-9,0,1,1
-3,-18,15,1,1,0
25,27,-2,0,1,1
-43,-31,-12,0,1,1
-9,-6,-3,0,0,0
-51,-45,-6,0,0,0
8,15,-7,0,0,0
-8,-25,17,1,0,1
-20,-40,20,1,0,1
20,36,-16,0,0,0
6,6,0,0,0,0
0,-3,3,1,0,1
-27,-8,-19,0,0,0
8,6,2,1,0,1
23,12,11,1,0,1
-11,-5,-6,0,1,1
-31,-17,-14,0,1,1
-18,-12,-6,0,1,1
-32,-24,-8,0,1,1
-9,-12,3,1,1,0
24,30,-6,0,1,1
9,-10,19,1,1,0
-22,-32,10,1,1,0
24,18,6,1,1,0
-11,-19,8,1,0,1
36,44,-8,0,0,0
0,-1,1,1,0,1
-36,-39,3,1,0,1
-36,-32,-4,0,0,0
-9,-19,10,1,0,1
-57,-38,-19,0,0,0
-8,-27,19,1,0,1
20,24,-4,0,0,0
18,15,3,1,1,0
-11,-19,8,1,1,0
-25,-26,1,1,1,0
11,6,5,1,1,0
35,34,1,1,1,0
6,25,-19,0,1,1
45,27,18,1,1,0
20,34,-14,0,1,1
-5,-16,11,1,1,0
-29,-32,3,1,1,0
-28,-33,5,1,1,0
-23,-3,-20,0,1,1
-34,-43,9,1,0,1
-26,-6,-20,0,0,0
-3,-3,0,0,0,0
23,32,-9,0,0,0
-17,-26,9,1,0,1
-50,-38,-12,0,0,0
25,40,-15,0,0,0
11,-4,15,1,0,1
27,24,3,1,0,1
47,31,16,1,0,1
-49,-31,-18,0,0,0
-11,-8,-3,0,1,1
-21,-37,16,1,1,0
-22,-28,6,1,1,0
-7,-22,15,1,1,0
-18,-33,15,1,1,0
-20,-11,-9,0,1,1
19,19,0,0,1,1
-36,-26,-10,0,1,1
24,9,15,1,1,0
-1,-8,7,1,1,0
-52,-44,-8,0,1,1
11,0,11,1,1,0
29,13,16,1,1,0
-26,-43,17,1,1,0
-16,-2,-14,0,1,1
-30,-28,-2,0,1,1
-4,3,-7,0,1,1
27,42,-15,0,1,1
-16,0,-16,0,1,1
52,42,10,1,1,0
19,0,19,1,1,0
-21,-19,-2,0,0,0
23,6,17,1,0,1
30,12,18,1,0,1
10,-9,19,1,0,1
29,20,9,1,0,1
22,4,18,1,0,1
-34,-32,-2,0,0,0
28,30,-2,0,0,0
-23,-34,11,1,0,1
49,43,6,1,0,1
33,44,-11,0,0,0
32,37,-5,0,0,0
15,7,8,1,0,1
16,17,-1,0,0,0
8,12,-4,0,0,0
-59,-45,-14,0,0,0
-45,-38,-7,0,0,0
-23,-14,-9,0,0,0
25,20,5,1,0,1
-43,-29,-14,0,0,0
-26,-36,10,1,0,1
17,4,13,1,1,0
-39,-39,0,0,1,1
-13,-31,18,1,1,0
-15,-16,1,1,1,0
1,-10,11,1,1,0
25,23,2,1,1,0
1,1,0,0,1,1
-8,-3,-5,0,1,1
27,8,19,1,1,0
-25,-30,5,1,0,1
22,41,-19,0,0,0
-33,-31,-2,0,0,0
-33,-20,-13,0,0,0
-9,-8,-1,0,0,0
-47,-42,-5,0,0,0
47,29,18,1,0,1
-3,-4,1,1,0,1
-42,-32,-10,0,0,0
43,34,9,1,0,1
-7,-22,15,1,0,1
-50,-45,-5,0,0,0
13,7,6,1,0,1
51,33,18,1,0,1
-60,-44,-16,0,0,0
15,9,6,1,0,1
-2,12,-14,0,0,0
20,34,-14,0,0,0
-64,-44,-20,0,0,0
5,-8,13,1,0,1
33,34,-1,0,0,0
27,19,8,1,1,0
-34,-34,0,0,1,1
30,11,19,1,1,0
1,15,-14,0,1,1
-11,-31,20,1,1,0
-10,-29,19,1,1,0
-12,-2,-10,0,1,1
-27,-24,-3,0,1,1
-24,-9,-15,0,1,1
10,-2,12,1,1,0
-15,2,-17,0,1,1
-24,-17,-7,0,1,1
19,18,1,1,1,0
14,23,-9,0,1,1
-52,-39,-13,0,1,1
-26,-25,-1,0,1,1
-46,-36,-10,0,1,1
8,17,-9,0,1,1
7,9,-2,0,1,1
-25,-38,13,1,1,0
-16,-21,5,1,0,1
21,13,8,1,0,1
-9,8,-17,0,0,0
-40,-30,-10,0,0,0
-3,-7,4,1,0,1
-1,-21,20,1,0,1
21,27,-6,0,0,0
47,41,6,1,0,1
-22,-21,-1,0,1,1
20,33,-13,0,1,1
29,10,19,1,1,0
39,34,5,1,1,0
-10,-17,7,1,1,0
-22,-28,6,1,1,0
42,23,19,1,1,0
28,10,18,1,1,0
4,21,-17,0,1,1
30,18,12,1,1,0
11,9,2,1,1,0
17,-2,19,1,1,0
-6,-19,13,1,1,0
14,-5,19,1,1,0
-18,0,-18,0,1,1
53,43,10,1,1,0
12,13,-1,0,1,1
1,-7,8,1,0,1
-60,-45,-15,0,0,0
4,24,-20,0,0,0
-19,-10,-9,0,0,0
60,44,16,1,0,1
23,36,-13,0,0,0
-40,-44,4,1,0,1
26,42,-16,0,0,0
3,3,0,0,0,0
-43,-34,-9,0,0,0
-31,-35,4,1,0,1
1,9,-8,0,1,1
4,-15,19,1,1,0
31,12,19,1,1,0
25,22,3,1,1,0
-28,-39,11,1,1,0
-45,-33,-12,0,1,1
36,32,4,1,1,0
-4,1,-5,0,1,1
1,16,-15,0,1,1
4,20,-16,0,1,1
-31,-23,-8,0,1,1
6,-7,13,1,1,0
-47,-44,-3,0,1,1
23,9,14,1,1,0
60,40,20,1,1,0
-13,0,-13,0,1,1
-13,-26,13,1,1,0
-25,-16,-9,0,1,1
-36,-36,0,0,1,1
-20,0,-20,0,1,1
-23,-36,13,1,1,0
10,11,-1,0,0,0
38,41,-3,0,0,0
-39,-20,-19,0,0,0
-23,-5,-18,0,0,0
-32,-23,-9,0,0,0
27,15,12,1,0,1
17,13,4,1,0,1
39,43,-4,0,0,0
-35,-26,-9,0,0,0
-14,-34,20,1,0,1
36,39,-3,0,0,0
-42,-24,-18,0,0,0
19,14,5,1,0,1
-16,-25,9,1,0,1
-21,-41,20,1,1,0
12,13,-1,0,1,1
43,40,3,1,1,0
-36,-23,-13,0,1,1
26,31,-5,0,1,1
-6,-11,5,1,1,0
-30,-27,-3,0,1,1
38,21,17,1,1,0
-27,-9,-18,0,1,1
9,2,7,1,1,0
17,31,-14,0,1,1
3,20,-17,0,1,1
12,24,-12,0,1,1
-44,-26,-18,0,1,1
-25,-7,-18,0,1,1
23,40,-17,0,0,0
-29,-20,-9,0,0,0
-21,-35,14,1,0,1
-29,-45,16,1,0,1
32,29,3,1,0,1
3,16,-13,0,0,0
-36,-16,-20,0,0,0
14,-5,19,1,0,1
8,-2,10,1,0,1
42,41,1,1,0,1
-27,-23,-4,0,0,0
47,36,11,1,0,1
-30,-17,-13,0,0,0
35,34,1,1,0,1
30,10,20,1,0,1
38,28,10,1,0,1
-13,-33,20,1,0,1
-29,-16,-13,0,0,0
22,39,-17,0,0,0
25,28,-3,0,0,0
10,28,-18,0,1,1
7,-4,11,1,1,0
42,42,0,0,1,1
-63,-45,-18,0,1,1
-14,-27,13,1,1,0
5,-5,10,1,1,0
29,16,13,1,1,0
16,8,8,1,1,0
23,12,11,1,1,0
-17,-25,8,1,1,0
-31,-17,-14,0,1,1
-24,-27,3,1,1,0
54,40,14,1,0,1
32,41,-9,0,0,0
3,0,3,1,0,1
-22,-15,-7,0,0,0
-8,4,-12,0,0,0
20,25,-5,0,0,0
-26,-12,-14,0,0,0
26,27,-1,0,0,0
-6,14,-20,0,0,0
-8,-26,18,1,0,1
27,44,-17,0,0,0
37,40,-3,0,0,0
30,39,-9,0,0,0
7,5,2,1,0,1
47,39,8,1,0,1
-30,-14,-16,0,0,0
-56,-45,-11,0,0,0
-12,3,-15,0,0,0
-33,-13,-20,0,0,0
54,38,16,1,0,1
-30,-35,5,1,0,1
-11,-16,5,1,1,0
42,30,12,1,1,0
23,22,1,1,1,0
-33,-31,-2,0,1,1
49,37,12,1,1,0
16,10,6,1,1,0
-15,-4,-11,0,1,1
-1,13,-14,0,1,1
36,29,7,1,1,0
12,0,12,1,1,0
29,22,7,1,1,0
-18,-16,-2,0,1,1
-36,-39,3,1,1,0
32,43,-11,0,1,1
32,31,1,1,0,1
0,-5,5,1,0,1
-43,-43,0,0,0,0
-34,-32,-2,0,0,0
7,5,2,1,0,1
-6,-20,14,1,0,1
12,23,-11,0,0,0
-42,-26,-16,0,0,0
-3,14,-17,0,0,0
-36,-27,-9,0,0,0
-43,-40,-3,0,0,0
-27,-42,15,1,0,1
59,42,17,1,0,1
-51,-45,-6,0,0,0
-48,-45,-3,0,0,0
24,9,15,1,1,0
-33,-37,4,1,1,0
-45,-43,-2,0,1,1
6,26,-20,0,1,1
-9,7,-16,0,1,1
-16,-22,6,1,1,0
-4,4,-8,0,1,1
11,29,-18,0,1,1
-21,-8,-13,0,1,1
-32,-12,-20,0,1,1
-53,-40,-13,0,1,1
-14,-7,-7,0,1,1
-4,-24,20,1,1,0
-10,-22,12,1,0,1
-18,-9,-9,0,0,0
16,27,-11,0,0,0
-15,4,-19,0,0,0
-50,-33,-17,0,0,0
-8,-21,13,1,0,1
30,29,1,1,0,1
-39,-33,-6,0,0,0
-12,-7,-5,0,0,0
25,40,-15,0,0,0
43,33,10,1,0,1
10,1,9,1,0,1
-2,10,-12,0,0,0
25,29,-4,0,0,0
20,13,7,1,0,1
43,25,18,1,0,1
19,1,18,1,0,1
13,-3,16,1,0,1
-24,-43,19,1,0,1
2,0,2,1,0,1
21,15,6,1,0,1
-26,-44,18,1,1,0
15,27,-12,0,1,1
-35,-39,4,1,1,0
-6,-12,6,1,1,0
-14,-12,-2,0,1,1
-18,-16,-2,0,1,1
35,30,5,1,1,0
-44,-41,-3,0,1,1
30,13,17,1,1,0
28,10,18,1,1,0
-3,7,-10,0,1,1
-43,-26,-17,0,0,0
-20,-37,17,1,0,1
31,11,20,1,0,1
28,43,-15,0,0,0
-19,-2,-17,0,0,0
33,42,-9,0,0,0
42,41,1,1,0,1
-13,-13,0,0,0,0
-13,-28,15,1,0,1
52,34,18,1,0,1
9,-8,17,1,0,1
21,9,12,1,0,1
44,26,18,1,0,1
0,-13,13,1,1,0
24,21,3,1,1,0
11,10,1,1,1,0
6,22,-16,0,1,1
-7,9,-16,0,1,1
1,-8,9,1,1,0
-47,-37,-10,0,1,1
1,-2,3,1,1,0
30,38,-8,0,1,1
28,14,14,1,1,0
-10,9,-19,0,1,1
6,9,-3,0,1,1
-4,10,-14,0,1,1
-62,-42,-20,0,1,1
-4,1,-5,0,1,1
-3,-3,0,0,1,1
-20,-12,-8,0,1,1
11,10,1,1,1,0
33,44,-11,0,1,1
-30,-16,-14,0,1,1
-25,-34,9,1,0,1
3,20,-17,0,0,0
-23,-14,-9,0,0,0
42,40,2,1,0,1
32,43,-11,0,0,0
-36,-44,8,1,0,1
-41,-23,-18,0,0,0
35,39,-4,0,0,0
-11,-3,-8,0,0,0
-14,-1,-13,0,0,0
-30,-23,-7,0,0,0
46,36,10,1,0,1
-12,2,-14,0,1,1
-41,-45,4,1,1,0
-29,-28,-1,0,1,1
-26,-12,-14,0,1,1
13,32,-19,0,1,1
-40,-21,-19,0,1,1
-13,2,-15,0,1,1
13,11,2,1,1,0
-33,-13,-20,0,1,1
25,14,11,1,1,0
25,37,-12,0,1,1
33,34,-1,0,1,1
-26,-16,-10,0,1,1
19,34,-15,0,1,1
23,26,-3,0,1,1
-43,-35,-8,0,0,0
-28,-43,15,1,0,1
46,36,10,1,0,1
-4,3,-7,0,0,0
8,2,6,1,0,1
3,7,-4,0,0,0
12,23,-11,0,0,0
24,19,5,1,0,1
-17,-9,-8,0,1,1
-3,-7,4,1,1,0
39,26,13,1,1,0
11,-6,17,1,1,0
-48,-39,-9,0,1,1
17,29,-12,0,1,1
-13,-29,16,1,1,0
10,-7,17,1,1,0
37,21,16,1,1,0
-40,-32,-8,0,1,1
36,34,2,1,1,0
-11,-2,-9,0,1,1
-26,-39,13,1,1,0
-22,-29,7,1,1,0
40,30,10,1,1,0
16,2,14,1,1,0
33,27,6,1,1,0
-19,-32,13,1,1,0
-26,-22,-4,0,1,1
47,34,13,1,1,0
3,-16,19,1,1,0
-20,-17,-3,0,0,0
-23,-7,-16,0,0,0
35,33,2,1,0,1
-6,-18,12,1,0,1
6,-10,16,1,0,1
-33,-21,-12,0,0,0
16,24,-8,0,0,0
-48,-29,-19,0,0,0
-43,-41,-2,0,0,0
-37,-27,-10,0,0,0
-17,-5,-12,0,0,0
-24,-16,-8,0,0,0
-17,-8,-9,0,0,0
-35,-34,-1,0,0,0
-2,-19,17,1,1,0
-28,-21,-7,0,1,1
39,29,10,1,1,0
-48,-35,-13,0,1,1
32,33,-1,0,1,1
26,11,15,1,1,0
-13,-14,1,1,1,0
11,8,3,1,1,0
-40,-42,2,1,1,0
37,31,6,1,1,0
-44,-37,-7,0,1,1
-21,-33,12,1,1,0
30,43,-13,0,1,1
-25,-41,16,1,1,0
36,16,20,1,1,0
-1,5,-6,0,1,1
60,42,18,1,1,0
42,27,15,1,1,0
-2,8,-10,0,1,1
-29,-44,15,1,1,0
-13,3,-16,0,1,1
11,6,5,1,0,1
30,28,2,1,0,1
-26,-29,3,1,0,1
-16,3,-19,0,0,0
-23,-18,-5,0,0,0
-20,-6,-14,0,0,0
27,24,3,1,0,1
-13,-29,16,1,0,1
38,27,11,1,1,0
29,27,2,1,1,0
-23,-10,-13,0,1,1
12,-7,19,1,1,0
29,24,5,1,1,0
6,26,-20,0,1,1
-50,-31,-19,0,1,1
31,22,9,1,1,0
34,35,-1,0,1,1
24,30,-6,0,1,1
-27,-11,-16,0,1,1
-1,-12,11,1,1,0
-19,-7,-12,0,1,1
26,14,12,1,1,0
-29,-36,7,1,1,0
29,35,-6,0,1,1
2,5,-3,0,1,1
-38,-20,-18,0,1,1
-43,-39,-4,0,1,1
-19,-18,-1,0,1,1
-30,-39,9,1,1,0
-40,-41,1,1,0,1
22,3,19,1,0,1
38,38,0,0,0,0
23,3,20,1,0,1
14,9,5,1,0,1
11,9,2,1,0,1
-21,-11,-10,0,0,0
-35,-40,5,1,0,1
28,34,-6,0,0,0
33,16,17,1,0,1
-31,-26,-5,0,0,0
-14,-20,6,1,0,1
-29,-12,-17,0,0,0
41,41,0,0,0,0
-38,-38,0,0,0,0
27,24,3,1,0,1
4,2,2,1,0,1
-26,-43,17,1,0,1
-3,13,-16,0,1,1
-17,-18,1,1,1,0
20,7,13,1,1,0
35,43,-8,0,1,1
-18,-3,-15,0,1,1
19,31,-12,0,1,1
17,35,-18,0,1,1
-23,-12,-11,0,1,1
-32,-31,-1,0,0,0
-38,-31,-7,0,0,0
48,32,16,1,0,1
-33,-21,-12,0,0,0
1,-18,19,1,0,1
-52,-40,-12,0,0,0
-47,-35,-12,0,0,0
33,43,-10,0,0,0
4,-8,12,1,0,1
47,33,14,1,0,1
-22,-34,12,1,0,1
-38,-36,-2,0,0,0
-4,-9,5,1,0,1
14,5,9,1,0,1
-46,-43,-3,0,1,1
25,27,-2,0,1,1
-17,-25,8,1,1,0
-16,-23,7,1,1,0
-14,0,-14,0,1,1
-2,11,-13,0,1,1
-33,-23,-10,0,1,1
-41,-44,3,1,1,0
-15,-32,17,1,1,0
24,10,14,1,0,1
22,15,7,1,0,1
-16,1,-17,0,0,0
-56,-43,-13,0,0,0
32,17,15,1,0,1
-38,-42,4,1,0,1
-15,-19,4,1,0,1
-4,-10,6,1,0,1
22,33,-11,0,0,0
-12,-25,13,1,0,1
-38,-21,-17,0,0,0
-10,4,-14,0,0,0
-5,-23,18,1,0,1
-40,-20,-20,0,0,0
24,11,13,1,0,1
21,35,-14,0,0,0
-22,-21,-1,0,0,0
1,-10,11,1,0,1
14,-1,15,1,0,1
44,32,12,1,0,1
-13,-26,13,1,0,1
27,13,14,1,1,0
0,18,-18,0,1,1
-1,7,-8,0,1,1
-41,-32,-9,0,1,1
8,9,-1,0,1,1
-18,-1,-17,0,1,1
6,-4,10,1,1,0
31,40,-9,0,1,1
-3,-9,6,1,1,0
-26,-18,-8,0,1,1
-28,-17,-11,0,1,1
-6,0,-6,0,0,0
33,23,10,1,0,1
20,25,-5,0,0,0
-5,-23,18,1,0,1
-51,-38,-13,0,0,0
-3,-23,20,1,0,1
44,34,10,1,0,1
-31,-24,-7,0,0,0
4,21,-17,0,0,0
0,13,-13,0,0,0
-19,-29,10,1,0,1
6,-3,9,1,0,1
9,20,-11,0,0,0
-48,-35,-13,0,1,1
-34,-29,-5,0,1,1
-7,-14,7,1,1,0
24,4,20,1,1,0
13,7,6,1,1,0
51,31,20,1,1,0
32,20,12,1,1,0
-29,-39,10,1,1,0
-24,-39,15,1,1,0
-36,-28,-8,0,1,1
32,15,17,1,1,0
24,26,-2,0,1,1
-28,-31,3,1,1,0
31,36,-5,0,1,1
30,37,-7,0,0,0
-22,-21,-1,0,0,0
-40,-43,3,1,0,1
21,27,-6,0,0,0
-61,-43,-18,0,0,0
32,33,-1,0,0,0
-12,-5,-7,0,0,0
-25,-22,-3,0,0,0
-5,14,-19,0,0,0
12,-7,19,1,1,0
-2,-21,19,1,1,0
55,37,18,1,1,0
28,29,-1,0,1,1
5,-9,14,1,1,0
-29,-44,15,1,1,0
-12,-20,8,1,1,0
19,6,13,1,1,0
17,3,14,1,1,0
-1,-4,3,1,1,0
-9,10,-19,0,0,0
26,35,-9,0,0,0
-16,4,-20,0,0,0
14,5,9,1,0,1
51,32,19,1,0,1
28,28,0,0,0,0
19,18,1,1,0,1
52,42,10,1,0,1
2,-10,12,1,0,1
24,42,-18,0,0,0
2,7,-5,0,0,0
40,24,16,1,0,1
-45,-41,-4,0,0,0
11,11,0,0,0,0
57,38,19,1,0,1
47,40,7,1,0,1
-14,-8,-6,0,0,0
26,16,10,1,0,1
-14,-18,4,1,0,1
-12,5,-17,0,0,0
-36,-38,2,1,0,1
-30,-23,-7,0,1,1
1,-8,9,1,1,0
-16,-32,16,1,1,0
31,39,-8,0,1,1
-27,-25,-2,0,1,1
-24,-18,-6,0,1,1
33,43,-10,0,1,1
30,27,3,1,1,0
-32,-24,-8,0,1,1
-53,-38,-15,0,1,1
6,4,2,1,1,0
-9,-6,-3,0,1,1
-14,-7,-7,0,1,1
13,25,-12,0,1,1
25,5,20,1,0,1
32,12,20,1,0,1
-17,-29,12,1,0,1
-23,-34,11,1,0,1
-8,3,-11,0,0,0
-20,-19,-1,0,0,0
3,-8,11,1,0,1
-17,-22,5,1,0,1
-50,-30,-20,0,0,0
-38,-39,1,1,0,1
-14,-17,3,1,0,1
4,20,-16,0,0,0
-50,-42,-8,0,0,0
45,26,19,1,0,1
33,44,-11,0,0,0
-5,12,-17,0,0,0
7,21,-14,0,0,0
18,31,-13,0,1,1
13,-6,19,1,1,0
-26,-21,-5,0,1,1
37,26,11,1,1,0
-2,5,-7,0,1,1
29,20,9,1,1,0
18,27,-9,0,1,1
34,29,5,1,1,0
58,44,14,1,1,0
27,41,-14,0,1,1
23,22,1,1,1,0
-46,-40,-6,0,1,1
-25,-26,1,1,1,0
17,33,-16,0,1,1
21,22,-1,0,1,1
-3,-14,11,1,1,0
64,44,20,1,1,0
3,19,-16,0,1,1
50,36,14,1,1,0
11,15,-4,0,1,1
34,38,-4,0,1,1
6,13,-7,0,0,0
14,8,6,1,0,1
46,34,12,1,0,1
-35,-18,-17,0,0,0
-22,-39,17,1,0,1
-12,-25,13,1,0,1
-27,-11,-16,0,0,0
42,24,18,1,0,1
15,5,10,1,0,1
-24,-28,4,1,1,0
42,32,10,1,1,0
-11,-21,10,1,1,0
-4,0,-4,0,1,1
-1,-5,4,1,1,0
0,18,-18,0,1,1
-1,-3,2,1,1,0
-3,4,-7,0,1,1
-52,-44,-8,0,1,1
-23,-16,-7,0,1,1
-32,-45,13,1,1,0
-37,-25,-12,0,1,1
-22,-5,-17,0,0,0
17,0,17,1,0,1
19,36,-17,0,0,0
-14,-31,17,1,0,1
53,40,13,1,0,1
-8,-5,-3,0,0,0
-25,-27,2,1,0,1
21,19,2,1,0,1
6,-11,17,1,1,0
44,35,9,1,1,0
6,-5,11,1,1,0
11,18,-7,0,1,1
10,0,10,1,1,0
-46,-37,-9,0,1,1
-7,-26,19,1,1,0
37,28,9,1,1,0
18,9,9,1,1,0
22,20,2,1,1,0
13,28,-15,0,1,1
21,18,3,1,1,0
40,27,13,1,0,1
15,19,-4,0,0,0
54,36,18,1,0,1
-13,2,-15,0,0,0
-45,-34,-11,0,0,0
-5,-23,18,1,0,1
-15,-18,3,1,0,1
25,6,19,1,0,1
-13,-22,9,1,0,1
-55,-43,-12,0,0,0
-2,4,-6,0,0,0
51,37,14,1,1,0
-19,-15,-4,0,1,1
-35,-21,-14,0,1,1
-49,-40,-9,0,1,1
0,-7,7,1,1,0
48,38,10,1,1,0
-23,-40,17,1,1,0
19,30,-11,0,1,1
14,22,-8,0,1,1
1,13,-12,0,0,0
26,9,17,1,0,1
21,39,-18,0,0,0
33,39,-6,0,0,0
-14,-5,-9,0,0,0
5,23,-18,0,0,0
-1,18,-19,0,0,0
-25,-42,17,1,0,1
24,23,1,1,0,1
6,6,0,0,0,0
27,33,-6,0,0,0
18,5,13,1,0,1
26,44,-18,0,0,0
54,39,15,1,0,1
-30,-31,1,1,0,1
-34,-45,11,1,0,1
-2,15,-17,0,0,0
-15,-19,4,1,1,0
-32,-17,-15,0,1,1
-12,-31,19,1,1,0
22,23,-1,0,1,1
-14,-7,-7,0,1,1
-23,-9,-14,0,1,1
-36,-37,1,1,1,0
-14,-21,7,1,1,0
-19,-14,-5,0,1,1
-2,-10,8,1,1,0
-36,-37,1,1,1,0
18,26,-8,0,1,1
-6,-15,9,1,1,0
-16,0,-16,0,1,1
18,18,0,0,1,1
31,28,3,1,1,0
13,13,0,0,1,1
-37,-30,-7,0,1,1
-29,-18,-11,0,1,1
-40,-38,-2,0,1,1
-22,-9,-13,0,0,0
-17,-37,20,1,0,1
-56,-45,-11,0,0,0
5,13,-8,0,0,0
2,2,0,0,0,0
-27,-9,-18,0,0,0
-34,-40,6,1,0,1
49,44,5,1,0,1
-22,-11,-11,0,0,0
29,36,-7,0,0,0
36,44,-8,0,0,0
-40,-25,-15,0,0,0
4,7,-3,0,0,0
0,1,-1,0,0,0
14,13,1,1,0,1
-26,-45,19,1,1,0
22,29,-7,0,1,1
-7,4,-11,0,1,1
-9,-2,-7,0,1,1
-19,-38,19,1,1,0
-13,-28,15,1,1,0
20,27,-7,0,1,1
-22,-8,-14,0,1,1
-26,-44,18,1,1,0
34,19,15,1,1,0
26,9,17,1,1,0
-15,-19,4,1,1,0
29,37,-8,0,1,1
24,28,-4,0,1,1
15,18,-3,0,1,1
-28,-9,-19,0,1,1
-14,-17,3,1,1,0
-6,8,-14,0,1,1
-23,-3,-20,0,1,1
-3,-19,16,1,1,0
18,24,-6,0,1,1
19,14,5,1,0,1
13,12,1,1,0,1
47,44,3,1,0,1
-28,-26,-2,0,0,0
33,44,-11,0,0,0
32,41,-9,0,0,0
-24,-25,1,1,0,1
28,41,-13,0,0,0
-25,-13,-12,0,0,0
3,-6,9,1,0,1
-3,14,-17,0,0,0
-5,-21,16,1,0,1
-24,-20,-4,0,0,0
-42,-38,-4,0,0,0
31,35,-4,0,0,0
23,31,-8,0,1,1
-8,-28,20,1,1,0
-29,-14,-15,0,1,1
-58,-40,-18,0,1,1
-32,-40,8,1,1,0
-30,-39,9,1,1,0
-24,-20,-4,0,1,1
-46,-37,-9,0,1,1
9,-7,16,1,1,0
6,1,5,1,1,0
50,38,12,1,1,0
18,14,4,1,0,1
32,37,-5,0,0,0
47,36,11,1,0,1
-30,-35,5,1,0,1
-51,-36,-15,0,0,0
26,44,-18,0,0,0
21,24,-3,0,0,0
39,29,10,1,0,1
-7,-22,15,1,1,0
-34,-41,7,1,1,0
46,36,10,1,1,0
-7,7,-14,0,1,1
-23,-11,-12,0,1,1
12,-8,20,1,1,0
-5,3,-8,0,1,1
11,7,4,1,1,0
-10,1,-11,0,1,1
-11,-5,-6,0,1,1
-21,-12,-9,0,1,1
9,28,-19,0,1,1
-24,-30,6,1,1,0
-1,-5,4,1,0,1
-39,-25,-14,0,0,0
-38,-18,-20,0,0,0
17,35,-18,0,0,0
34,16,18,1,0,1
14,23,-9,0,0,0
-17,-1,-16,0,0,0
-22,-12,-10,0,0,0
-43,-35,-8,0,0,0
20,17,3,1,0,1
-15,0,-15,0,0,0
40,20,20,1,0,1
-13,-29,16,1,0,1
46,40,6,1,0,1
14,26,-12,0,0,0
-4,-17,13,1,0,1
29,28,1,1,0,1
-3,10,-13,0,0,0
21,27,-6,0,0,0
-30,-43,13,1,0,1
28,25,3,1,0,1
-23,-22,-1,0,1,1
-19,-7,-12,0,1,1
32,26,6,1,1,0
-12,-3,-9,0,1,1
3,5,-2,0,1,1
-47,-37,-10,0,1,1
27,39,-12,0,1,1
19,38,-19,0,1,1
-37,-29,-8,0,1,1
-7,9,-16,0,1,1
2,12,-10,0,1,1
-33,-25,-8,0,1,1
-10,-22,12,1,1,0
-1,7,-8,0,1,1
-19,-12,-7,0,1,1
-27,-23,-4,0,1,1
-45,-28,-17,0,1,1
-9,3,-12,0,1,1
8,17,-9,0,1,1
-15,-34,19,1,1,0
-14,-32,18,1,1,0
9,0,9,1,0,1
-4,-23,19,1,0,1
-19,-32,13,1,0,1
44,33,11,1,0,1
-20,-32,12,1,0,1
-52,-44,-8,0,0,0
3,14,-11,0,0,0
-54,-43,-11,0,0,0
-29,-43,14,1,0,1
-24,-22,-2,0,0,0
30,39,-9,0,0,0
-5,-9,4,1,1,0
0,-17,17,1,1,0
31,37,-6,0,1,1
17,0,17,1,1,0
-28,-25,-3,0,1,1
12,-6,18,1,1,0
48,37,11,1,1,0
62,43,19,1,1,0
17,3,14,1,1,0
40,30,10,1,1,0
38,35,3,1,1,0
-6,-1,-5,0,1,1
6,6,0,0,1,1
-4,-17,13,1,1,0
-29,-26,-3,0,1,1
-20,-16,-4,0,1,1
40,23,17,1,1,0
-43,-33,-10,0,0,0
-35,-41,6,1,0,1
16,24,-8,0,0,0
5,5,0,0,0,0
23,35,-12,0,0,0
9,-2,11,1,0,1
-37,-35,-2,0,0,0
53,44,9,1,0,1
16,13,3,1,0,1
-50,-30,-20,0,0,0
-37,-38,1,1,0,1
19,28,-9,0,0,0
5,-3,8,1,1,0
58,41,17,1,1,0
-31,-40,9,1,1,0
-29,-14,-15,0,1,1
39,35,4,1,1,0
5,7,-2,0,1,1
8,4,4,1,1,0
-17,-1,-16,0,1,1
3,20,-17,0,1,1
28,17,11,1,1,0
35,37,-2,0,1,1
-38,-32,-6,0,0,0
-15,-22,7,1,0,1
-16,-35,19,1,0,1
-17,-1,-16,0,0,0
-21,-40,19,1,0,1
-14,-26,12,1,0,1
16,1,15,1,0,1
-22,-25,3,1,0,1
34,26,8,1,1,0
8,16,-8,0,1,1
17,22,-5,0,1,1
-23,-42,19,1,1,0
13,19,-6,0,1,1
41,44,-3,0,1,1
-18,-29,11,1,1,0
-6,-22,16,1,1,0
-44,-39,-5,0,1,1
18,36,-18,0,1,1
-62,-42,-20,0,0,0
-41,-44,3,1,0,1
46,43,3,1,0,1
-14,-15,1,1,0,1
-43,-44,1,1,0,1
-1,-12,11,1,0,1
51,36,15,1,0,1
-15,-23,8,1,0,1
14,2,12,1,0,1
35,30,5,1,0,1
3,4,-1,0,1,1
-51,-44,-7,0,1,1
26,21,5,1,1,0
42,42,0,0,1,1
-9,6,-15,0,1,1
16,34,-18,0,1,1
-61,-44,-17,0,1,1
-56,-39,-17,0,1,1
-14,-28,14,1,1,0
10,4,6,1,1,0
-15,-30,15,1,1,0
-20,-35,15,1,1,0
-1,-1,0,0,1,1
2,-17,19,1,1,0
30,18,12,1,1,0
-35,-37,2,1,1,0
47,37,10,1,1,0
8,-3,11,1,1,0
-32,-43,11,1,1,0
-25,-33,8,1,1,0
11,3,8,1,1,0
15,7,8,1,0,1
31,28,3,1,0,1
1,7,-6,0,0,0
-5,-25,20,1,0,1
-32,-37,5,1,0,1
44,33,11,1,0,1
18,11,7,1,0,1
-29,-30,1,1,0,1
-25,-45,20,1,0,1
28,38,-10,0,0,0
8,12,-4,0,0,0
-33,-29,-4,0,0,0
17,8,9,1,0,1
43,33,10,1,0,1
18,3,15,1,0,1
-46,-31,-15,0,0,0
-26,-43,17,1,0,1
17,4,13,1,0,1
-24,-41,17,1,0,1
-49,-34,-15,0,0,0
-19,-18,-1,0,1,1
2,6,-4,0,1,1
-14,-5,-9,0,1,1
9,5,4,1,1,0
-11,2,-13,0,1,1
38,29,9,1,1,0
31,42,-11,0,1,1
-14,3,-17,0,1,1
26,37,-11,0,1,1
-10,-18,8,1,0,1
-31,-44,13,1,0,1
22,26,-4,0,0,0
-19,-27,8,1,0,1
5,1,4,1,0,1
9,-7,16,1,0,1
3,8,-5,0,0,0
-14,-24,10,1,0,1
2,-18,20,1,0,1
-12,-18,6,1,0,1
15,-4,19,1,0,1
29,23,6,1,1,0
-4,-4,0,0,1,1
-25,-11,-14,0,1,1
-29,-11,-18,0,1,1
-20,-33,13,1,1,0
4,18,-14,0,1,1
3,13,-10,0,1,1
30,17,13,1,1,0
39,33,6,1,0,1
-7,3,-10,0,0,0
19,15,4,1,0,1
3,5,-2,0,0,0
-43,-41,-2,0,0,0
51,37,14,1,0,1
10,10,0,0,0,0
-35,-39,4,1,0,1
-3,-23,20,1,0,1
4,-16,20,1,0,1
27,32,-5,0,0,0
-9,-27,18,1,0,1
14,-5,19,1,0,1
35,28,7,1,0,1
-8,-21,13,1,0,1
-42,-22,-20,0,0,0
-9,-13,4,1,0,1
19,3,16,1,0,1
24,38,-14,0,0,0
-24,-43,19,1,0,1
41,28,13,1,0,1
25,42,-17,0,1,1
38,24,14,1,1,0
-38,-29,-9,0,1,1
18,21,-3,0,1,1
-19,-26,7,1,1,0
29,40,-11,0,1,1
18,10,8,1,1,0
-41,-42,1,1,1,0
-31,-43,12,1,1,0
5,22,-17,0,0,0
20,29,-9,0,0,0
1,21,-20,0,0,0
-12,-12,0,0,0,0
32,33,-1,0,0,0
2,16,-14,0,0,0
-23,-14,-9,0,0,0
17,9,8,1,0,1
23,32,-9,0,0,0
-24,-33,9,1,0,1
34,28,6,1,0,1
8,-5,13,1,0,1
47,35,12,1,0,1
-28,-22,-6,0,0,0
-27,-32,5,1,0,1
-8,1,-9,0,0,0
3,-17,20,1,0,1
24,36,-12,0,0,0
0,-20,20,1,0,1
43,36,7,1,0,1
4,-15,19,1,0,1
29,13,16,1,1,0
-2,-17,15,1,1,0
-36,-21,-15,0,1,1
35,27,8,1,1,0
36,33,3,1,1,0
-34,-25,-9,0,1,1
21,38,-17,0,1,1
3,-16,19,1,1,0
-36,-27,-9,0,1,1
31,22,9,1,1,0
30,21,9,1,1,0
40,29,11,1,1,0
-20,-29,9,1,1,0
-16,-33,17,1,0,1
-22,-23,1,1,0,1
18,34,-16,0,0,0
51,36,15,1,0,1
-55,-37,-18,0,0,0
27,31,-4,0,0,0
-12,-14,2,1,0,1
-57,-41,-16,0,0,0
3,9,-6,0,0,0
48,41,7,1,0,1
-36,-32,-4,0,0,0
-38,-24,-14,0,0,0
30,33,-3,0,0,0
-23,-40,17,1,0,1
-13,-3,-10,0,0,0
40,33,7,1,1,0
-2,-5,3,1,1,0
-39,-33,-6,0,1,1
26,32,-6,0,1,1
6,1,5,1,1,0
39,37,2,1,1,0
-51,-31,-20,0,1,1
-1,-17,16,1,1,0
-33,-22,-11,0,1,1
-30,-32,2,1,1,0
5,-8,13,1,1,0
38,21,17,1,1,0
-18,0,-18,0,1,1
4,11,-7,0,1,1
8,22,-14,0,1,1
37,21,16,1,1,0
-13,-31,18,1,1,0
-2,-3,1,1,1,0
-15,-1,-14,0,1,1
-5,11,-16,0,1,1
18,29,-11,0,1,1
15,12,3,1,0,1
12,-3,15,1,0,1
47,37,10,1,0,1
-29,-14,-15,0,0,0
-7,-6,-1,0,0,0
43,40,3,1,0,1
-16,-30,14,1,0,1
-54,-36,-18,0,0,0
34,16,18,1,0,1
-59,-44,-15,0,0,0
-7,-1,-6,0,0,0
20,27,-7,0,0,0
-2,16,-18,0,0,0
11,1,10,1,0,1
-41,-31,-10,0,0,0
-20,-39,19,1,0,1
1,-4,5,1,0,1
2,4,-2,0,0,0
23,33,-10,0,0,0
-5,-17,12,1,0,1
-40,-41,1,1,0,1
17,25,-8,0,1,1
20,0,20,1,1,0
1,10,-9,0,1,1
-39,-27,-12,0,1,1
20,5,15,1,1,0
46,39,7,1,1,0
13,26,-13,0,1,1
-6,-9,3,1,1,0
-9,5,-14,0,1,1
8,2,6,1,1,0
36,34,2,1,1,0
-26,-33,7,1,1,0
16,-4,20,1,1,0
33,42,-9,0,1,1
-1,0,-1,0,1,1
-18,2,-20,0,1,1
46,41,5,1,1,0
-16,4,-20,0,1,1
16,0,16,1,0,1
34,18,16,1,0,1
-10,-20,10,1,0,1
11,28,-17,0,0,0
13,2,11,1,0,1
-34,-35,1,1,0,1
35,34,1,1,0,1
-42,-45,3,1,0,1
43,24,19,1,0,1
51,41,10,1,0,1
12,3,9,1,0,1
13,14,-1,0,0,0
-42,-24,-18,0,1,1
32,30,2,1,1,0
-41,-36,-5,0,1,1
-8,3,-11,0,1,1
16,15,1,1,1,0
-23,-8,-15,0,1,1
-29,-31,2,1,1,0
34,15,19,1,1,0
17,6,11,1,1,0
4,7,-3,0,0,0
2,-15,17,1,0,1
-11,-25,14,1,0,1
-2,9,-11,0,0,0
-30,-45,15,1,0,1
46,26,20,1,0,1
-31,-13,-18,0,0,0
-23,-10,-13,0,0,0
28,8,20,1,0,1
37,17,20,1,0,1
-15,-31,16,1,0,1
-28,-34,6,1,0,1
-25,-23,-2,0,0,0
-9,-16,7,1,0,1
34,34,0,0,0,0
6,26,-20,0,0,0
49,42,7,1,0,1
24,14,10,1,0,1
-47,-38,-9,0,0,0
-3,10,-13,0,0,0
-53,-33,-20,0,0,0
-6,7,-13,0,1,1
-4,1,-5,0,1,1
-30,-24,-6,0,1,1
-33,-31,-2,0,1,1
11,7,4,1,1,0
-23,-9,-14,0,1,1
-9,-6,-3,0,1,1
-36,-42,6,1,1,0
11,17,-6,0,1,1
28,39,-11,0,0,0
-51,-40,-11,0,0,0
19,9,10,1,0,1
-4,-19,15,1,0,1
-9,-7,-2,0,0,0
26,13,13,1,0,1
39,44,-5,0,0,0
16,7,9,1,0,1
34,28,6,1,0,1
34,30,4,1,0,1
-7,-20,13,1,0,1
-8,-14,6,1,0,1
23,22,1,1,0,1
48,43,5,1,1,0
13,32,-19,0,1,1
22,18,4,1,1,0
39,28,11,1,1,0
2,17,-15,0,1,1
-8,-5,-3,0,1,1
27,44,-17,0,1,1
-11,-1,-10,0,1,1
6,21,-15,0,1,1
-46,-40,-6,0,1,1
-30,-19,-11,0,1,1
21,19,2,1,1,0
-17,1,-18,0,1,1
-15,-27,12,1,1,0
-23,-33,10,1,1,0
2,2,0,0,1,1
19,7,12,1,1,0
-35,-43,8,1,0,1
-42,-40,-2,0,0,0
-50,-42,-8,0,0,0
31,27,4,1,0,1
43,36,7,1,0,1
-16,3,-19,0,0,0
-17,-16,-1,0,0,0
15,31,-16,0,0,0
48,32,16,1,0,1
-12,7,-19,0,0,0
-24,-16,-8,0,1,1
23,42,-19,0,1,1
-7,-18,11,1,1,0
9,-10,19,1,1,0
-26,-26,0,0,1,1
8,16,-8,0,1,1
-15,4,-19,0,1,1
-43,-28,-15,0,1,1
9,0,9,1,1,0
-31,-11,-20,0,0,0
49,34,15,1,0,1
-36,-34,-2,0,0,0
6,17,-11,0,0,0
19,35,-16,0,0,0
36,21,15,1,0,1
-21,-14,-7,0,0,0
5,-7,12,1,0,1
18,34,-16,0,0,0
-6,-14,8,1,0,1
-6,-13,7,1,0,1
-32,-45,13,1,0,1
-39,-40,1,1,0,1
24,31,-7,0,1,1
19,28,-9,0,1,1
15,22,-7,0,1,1
-3,-17,14,1,1,0
-6,-15,9,1,1,0
32,27,5,1,1,0
-44,-31,-13,0,1,1
-9,-5,-4,0,1,1
-55,-44,-11,0,1,1
-29,-34,5,1,1,0
24,21,3,1,1,0
24,39,-15,0,1,1
14,20,-6,0,1,1
-19,-33,14,1,1,0
-27,-10,-17,0,1,1
37,18,19,1,1,0
-46,-35,-11,0,1,1
41,43,-2,0,1,1
-36,-16,-20,0,1,1
-23,-20,-3,0,1,1
46,35,11,1,1,0
4,-15,19,1,0,1
25,13,12,1,0,1
-56,-42,-14,0,0,0
3,4,-1,0,0,0
41,37,4,1,0,1
-15,-27,12,1,0,1
27,28,-1,0,0,0
3,4,-1,0,0,0
1,-1,2,1,0,1
-61,-43,-18,0,1,1
-21,-20,-1,0,1,1
31,17,14,1,1,0
-36,-19,-17,0,1,1
-13,-4,-9,0,1,1
38,21,17,1,1,0
35,40,-5,0,1,1
-25,-15,-10,0,1,1
33,25,8,1,0,1
-55,-37,-18,0,0,0
41,29,12,1,0,1
-12,3,-15,0,0,0
-35,-38,3,1,0,1
12,13,-1,0,0,0
-43,-45,2,1,0,1
25,34,-9,0,0,0
31,36,-5,0,0,0
10,-5,15,1,0,1
9,-10,19,1,0,1
-23,-33,10,1,0,1
27,10,17,1,0,1
25,6,19,1,0,1
19,27,-8,0,1,1
-4,7,-11,0,1,1
-17,-10,-7,0,1,1
18,33,-15,0,1,1
-9,5,-14,0,1,1
52,39,13,1,1,0
19,30,-11,0,1,1
-4,2,-6,0,1,1
13,29,-16,0,1,1
27,18,9,1,1,0
-32,-18,-14,0,1,1
-24,-12,-12,0,1,1
31,31,0,0,0,0
29,12,17,1,0,1
12,1,11,1,0,1
31,29,2,1,0,1
50,44,6,1,0,1
-58,-45,-13,0,0,0
-43,-23,-20,0,0,0
-45,-42,-3,0,0,0
-14,-31,17,1,0,1
30,42,-12,0,0,0
42,44,-2,0,1,1
-33,-28,-5,0,1,1
-27,-15,-12,0,1,1
25,10,15,1,1,0
-30,-14,-16,0,1,1
48,36,12,1,1,0
-37,-42,5,1,1,0
24,19,5,1,1,0
-17,-11,-6,0,1,1
-16,1,-17,0,1,1
-19,-29,10,1,1,0
31,33,-2,0,1,1
15,7,8,1,1,0
-33,-45,12,1,1,0
-5,-20,15,1,0,1
8,21,-13,0,0,0
-10,-18,8,1,0,1
-44,-39,-5,0,0,0
7,-11,18,1,0,1
28,31,-3,0,0,0
-63,-45,-18,0,0,0
-6,9,-15,0,0,0
9,2,7,1,0,1
-35,-24,-11,0,0,0
-14,-34,20,1,0,1
42,38,4,1,0,1
17,11,6,1,0,1
-10,4,-14,0,0,0
21,10,11,1,0,1
15,5,10,1,0,1
0,10,-10,0,0,0
48,38,10,1,0,1
-18,-2,-16,0,0,0
-36,-41,5,1,0,1
-20,-9,-11,0,0,0
-39,-22,-17,0,1,1
31,44,-13,0,1,1
37,36,1,1,1,0
-4,-10,6,1,1,0
-39,-24,-15,0,1,1
-6,-11,5,1,1,0
37,35,2,1,1,0
-21,-6,-15,0,1,1
16,24,-8,0,1,1
-28,-36,8,1,1,0
35,24,11,1,1,0
0,-2,2,1,1,0
0,12,-12,0,1,1
-19,-19,0,0,1,1
-12,-13,1,1,1,0
15,1,14,1,1,0
20,14,6,1,1,0
-40,-44,4,1,1,0
-42,-24,-18,0,1,1
-4,0,-4,0,0,0
31,37,-6,0,0,0
13,21,-8,0,0,0
39,23,16,1,0,1
22,32,-10,0,0,0
50,41,9,1,0,1
21,41,-20,0,0,0
-19,-17,-2,0,0,0
16,3,13,1,0,1
-36,-37,1,1,0,1
-32,-43,11,1,0,1
-21,-29,8,1,0,1
-11,-4,-7,0,0,0
-47,-30,-17,0,0,0
1,-9,10,1,0,1
-20,-10,-10,0,1,1
-31,-35,4,1,1,0
-49,-42,-7,0,1,1
44,39,5,1,1,0
-27,-22,-5,0,1,1
-38,-40,2,1,1,0
-30,-25,-5,0,1,1
-51,-32,-19,0,1,1
-7,-7,0,0,1,1
-11,7,-18,0,0,0
-33,-32,-1,0,0,0
13,2,11,1,0,1
10,6,4,1,0,1
29,18,11,1,0,1
18,19,-1,0,0,0
30,33,-3,0,0,0
-16,-31,15,1,0,1
-9,-23,14,1,0,1
10,12,-2,0,0,0
42,35,7,1,0,1
23,33,-10,0,1,1
-7,7,-14,0,1,1
7,6,1,1,1,0
16,26,-10,0,1,1
13,20,-7,0,1,1
12,21,-9,0,1,1
32,13,19,1,1,0
-15,-30,15,1,1,0
-6,-7,1,1,1,0
-2,-17,15,1,1,0
13,31,-18,0,1,1
-30,-15,-15,0,1,1
16,7,9,1,1,0
22,14,8,1,1,0
-16,-15,-1,0,1,1
27,39,-12,0,1,1
10,-8,18,1,1,0
-23,-12,-11,0,1,1
30,37,-7,0,1,1
-5,-17,12,1,1,0
-31,-26,-5,0,1,1
-14,2,-16,0,0,0
-20,-4,-16,0,0,0
-2,-20,18,1,0,1
-19,-20,1,1,0,1
10,21,-11,0,0,0
3,0,3,1,0,1
10,29,-19,0,0,0
-17,-7,-10,0,0,0
24,42,-18,0,0,0
51,39,12,1,0,1
52,37,15,1,0,1
15,26,-11,0,0,0
-13,-22,9,1,0,1
-14,-5,-9,0,0,0
-22,-11,-11,0,0,0
4,-1,5,1,0,1
24,16,8,1,0,1
-17,-9,-8,0,0,0
13,6,7,1,0,1
16,7,9,1,0,1
6,-9,15,1,0,1
-31,-45,14,1,1,0
-37,-19,-18,0,1,1
-23,-25,2,1,1,0
-5,-10,5,1,1,0
-5,-13,8,1,1,0
-15,-25,10,1,1,0
18,6,12,1,1,0
18,29,-11,0,1,1
-35,-28,-7,0,1,1
-19,-11,-8,0,0,0
-48,-30,-18,0,0,0
-6,-1,-5,0,0,0
-9,0,-9,0,0,0
-24,-7,-17,0,0,0
-26,-21,-5,0,0,0
7,-3,10,1,0,1
-15,-13,-2,0,0,0
43,43,0,0,0,0
51,33,18,1,0,1
-30,-45,15,1,0,1
51,37,14,1,0,1
25,44,-19,0,0,0
29,38,-9,0,0,0
-38,-45,7,1,0,1
14,24,-10,0,0,0
8,0,8,1,0,1
-18,-8,-10,0,0,0
49,41,8,1,0,1
9,14,-5,0,0,0
19,15,4,1,1,0
62,42,20,1,1,0
-53,-41,-12,0,1,1
-2,-18,16,1,1,0
35,24,11,1,1,0
-11,-29,18,1,1,0
-35,-36,1,1,1,0
-8,-12,4,1,1,0
-36,-43,7,1,1,0
1,13,-12,0,1,1
18,31,-13,0,1,1
15,25,-10,0,1,1
-28,-43,15,1,1,0
2,22,-20,0,0,0
18,8,10,1,0,1
-34,-22,-12,0,0,0
16,22,-6,0,0,0
-23,-9,-14,0,0,0
-46,-36,-10,0,0,0
44,34,10,1,0,1
21,12,9,1,0,1
27,44,-17,0,0,0
18,18,0,0,0,0
-14,-13,-1,0,0,0
-27,-36,9,1,0,1
-1,-7,6,1,0,1
-59,-41,-18,0,0,0
-38,-28,-10,0,0,0
44,33,11,1,0,1
-20,-23,3,1,0,1
-23,-14,-9,0,0,0
-32,-41,9,1,0,1
11,28,-17,0,0,0
14,1,13,1,0,1
3,-11,14,1,1,0
13,4,9,1,1,0
-4,3,-7,0,1,1
23,38,-15,0,1,1
31,28,3,1,1,0
-47,-33,-14,0,1,1
19,18,1,1,1,0
5,-15,20,1,1,0
-25,-38,13,1,0,1
18,38,-20,0,0,0
-22,-36,14,1,0,1
60,43,17,1,0,1
19,17,2,1,0,1
-41,-23,-18,0,0,0
-10,-18,8,1,0,1
33,33,0,0,0,0
-48,-41,-7,0,1,1
-49,-41,-8,0,1,1
14,31,-17,0,1,1
-21,-11,-10,0,1,1
31,18,13,1,1,0
23,3,20,1,1,0
28,16,12,1,1,0
-17,-34,17,1,1,0
7,-3,10,1,1,0
-6,-20,14,1,1,0
-10,3,-13,0,1,1
-33,-24,-9,0,1,1
7,15,-8,0,1,1
-39,-32,-7,0,1,1
16,34,-18,0,1,1
10,29,-19,0,1,1
40,42,-2,0,1,1
-14,-27,13,1,1,0
-23,-35,12,1,1,0
-58,-44,-14,0,1,1
20,36,-16,0,1,1
29,17,12,1,0,1
3,-4,7,1,0,1
34,40,-6,0,0,0
46,28,18,1,0,1
-40,-21,-19,0,0,0
19,1,18,1,0,1
6,-1,7,1,0,1
19,19,0,0,0,0
45,43,2,1,1,0
-20,-24,4,1,1,0
-2,-4,2,1,1,0
35,24,11,1,1,0
32,19,13,1,1,0
-24,-6,-18,0,1,1
10,26,-16,0,1,1
2,15,-13,0,1,1
-11,2,-13,0,1,1
-21,-24,3,1,1,0
16,7,9,1,1,0
-27,-33,6,1,1,0
10,27,-17,0,1,1
6,2,4,1,0,1
-26,-34,8,1,0,1
13,11,2,1,0,1
-20,-18,-2,0,0,0
0,11,-11,0,0,0
11,16,-5,0,0,0
42,34,8,1,0,1
48,33,15,1,0,1
-7,-12,5,1,0,1
-30,-38,8,1,1,0
-10,-1,-9,0,1,1
19,11,8,1,1,0
-20,-24,4,1,1,0
-46,-27,-19,0,1,1
2,-12,14,1,1,0
51,41,10,1,1,0
15,11,4,1,1,0
-7,6,-13,0,1,1
24,16,8,1,1,0
-10,-11,1,1,1,0
-44,-32,-12,0,1,1
-26,-7,-19,0,1,1
-6,-16,10,1,0,1
-5,-18,13,1,0,1
-3,-10,7,1,0,1
41,28,13,1,0,1
-24,-25,1,1,0,1
6,17,-11,0,0,0
-9,-5,-4,0,0,0
-30,-28,-2,0,0,0
36,37,-1,0,0,0
-15,-6,-9,0,0,0
41,42,-1,0,0,0
40,43,-3,0,0,0
-45,-28,-17,0,0,0
-27,-35,8,1,0,1
-31,-25,-6,0,0,0
6,-7,13,1,0,1
-57,-42,-15,0,0,0
-35,-16,-19,0,0,0
-32,-31,-1,0,0,0
28,19,9,1,1,0
5,0,5,1,1,0
-8,-19,11,1,1,0
-58,-42,-16,0,1,1
1,16,-15,0,1,1
10,0,10,1,1,0
45,35,10,1,1,0
63,44,19,1,1,0
12,-1,13,1,1,0
30,27,3,1,1,0
-57,-40,-17,0,1,1
38,34,4,1,1,0
55,44,11,1,1,0
37,32,5,1,1,0
53,41,12,1,1,0
-38,-29,-9,0,1,1
15,10,5,1,1,0
-45,-35,-10,0,1,1
38,24,14,1,0,1
-16,-31,15,1,0,1
7,9,-2,0,0,0
9,24,-15,0,0,0
36,21,15,1,0,1
28,12,16,1,0,1
-14,-14,0,0,0,0
17,10,7,1,0,1
1,-16,17,1,0,1
4,7,-3,0,0,0
60,41,19,1,0,1
-25,-8,-17,0,0,0
5,-14,19,1,0,1
62,44,18,1,0,1
-12,-18,6,1,0,1
-23,-21,-2,0,0,0
2,18,-16,0,0,0
-33,-16,-17,0,0,0
-45,-35,-10,0,0,0
16,28,-12,0,0,0
23,9,14,1,1,0
31,29,2,1,1,0
27,44,-17,0,1,1
38,19,19,1,1,0
16,11,5,1,1,0
-12,-1,-11,0,1,1
9,23,-14,0,1,1
7,23,-16,0,1,1
-27,-22,-5,0,1,1
28,14,14,1,1,0
-2,-1,-1,0,1,1
-2,7,-9,0,1,1
23,17,6,1,1,0
15,25,-10,0,1,1
52,38,14,1,1,0
-3,-5,2,1,1,0
18,37,-19,0,1,1
3,2,1,1,1,0
-26,-9,-17,0,1,1
-4,-5,1,1,1,0
-34,-24,-10,0,1,1
-39,-38,-1,0,0,0
-16,-2,-14,0,0,0
21,7,14,1,0,1
-20,-10,-10,0,0,0
39,27,12,1,0,1
13,18,-5,0,0,0
-36,-31,-5,0,0,0
-38,-21,-17,0,0,0
-11,4,-15,0,0,0
35,18,17,1,0,1
-2,5,-7,0,1,1
15,19,-4,0,1,1
31,42,-11,0,1,1
-48,-32,-16,0,1,1
-31,-26,-5,0,1,1
-13,-1,-12,0,1,1
7,27,-20,0,1,1
22,32,-10,0,1,1
-4,-2,-2,0,1,1
-28,-19,-9,0,1,1
23,21,2,1,1,0
4,8,-4,0,1,1
1,10,-9,0,1,1
3,-12,15,1,1,0
-29,-41,12,1,1,0
-8,9,-17,0,1,1
37,22,15,1,1,0
16,7,9,1,1,0
33,41,-8,0,1,1
-1,7,-8,0,1,1
18,29,-11,0,1,1
24,29,-5,0,0,0
23,10,13,1,0,1
62,42,20,1,0,1
-16,-1,-15,0,0,0
48,29,19,1,0,1
-39,-34,-5,0,0,0
20,24,-4,0,0,0
-9,-22,13,1,0,1
41,40,1,1,1,0
-13,0,-13,0,1,1
-17,-2,-15,0,1,1
-1,-2,1,1,1,0
40,43,-3,0,1,1
-40,-27,-13,0,1,1
-2,7,-9,0,1,1
44,29,15,1,1,0
-14,-11,-3,0,0,0
-5,-12,7,1,0,1
45,28,17,1,0,1
14,20,-6,0,0,0
4,24,-20,0,0,0
-12,-6,-6,0,0,0
3,9,-6,0,0,0
-23,-21,-2,0,0,0
-22,-14,-8,0,0,0
-35,-28,-7,0,0,0
-14,-3,-11,0,0,0
-39,-27,-12,0,0,0
37,24,13,1,0,1
11,2,9,1,0,1
-36,-20,-16,0,0,0
10,19,-9,0,0,0
34,44,-10,0,0,0
37,32,5,1,1,0
-13,-22,9,1,1,0
43,26,17,1,1,0
-2,2,-4,0,1,1
9,-11,20,1,1,0
18,12,6,1,1,0
14,-4,18,1,1,0
21,15,6,1,1,0
32,43,-11,0,1,1
-19,-36,17,1,1,0
16,4,12,1,1,0
24,29,-5,0,1,1
21,12,9,1,1,0
-48,-32,-16,0,1,1
12,-7,19,1,1,0
22,33,-11,0,1,1
22,31,-9,0,1,1
-26,-19,-7,0,1,1
23,5,18,1,1,0
-13,-32,19,1,1,0
2,-11,13,1,1,0
23,7,16,1,0,1
-7,-24,17,1,0,1
-30,-36,6,1,0,1
27,37,-10,0,0,0
-17,-18,1,1,0,1
9,-7,16,1,0,1
42,42,0,0,0,0
-17,-10,-7,0,0,0
38,32,6,1,0,1
-40,-35,-5,0,0,0
-33,-29,-4,0,0,0
13,-6,19,1,0,1
33,34,-1,0,0,0
-32,-30,-2,0,0,0
-27,-12,-15,0,0,0
11,0,11,1,0,1
27,26,1,1,0,1
-38,-44,6,1,0,1
-22,-33,11,1,0,1
38,22,16,1,0,1
-38,-40,2,1,0,1
-31,-30,-1,0,1,1
8,4,4,1,1,0
12,20,-8,0,1,1
-27,-33,6,1,1,0
5,21,-16,0,1,1
1,-5,6,1,1,0
-19,0,-19,0,1,1
-40,-44,4,1,1,0
-14,-30,16,1,1,0
35,36,-1,0,1,1
-46,-35,-11,0,1,1
25,13,12,1,1,0
-11,-14,3,1,1,0
55,43,12,1,1,0
-33,-40,7,1,1,0
0,-17,17,1,1,0
-21,-32,11,1,1,0
-15,-25,10,1,1,0
18,37,-19,0,1,1
27,44,-17,0,1,1
17,33,-16,0,1,1
0,-9,9,1,0,1
9,24,-15,0,0,0
-5,-1,-4,0,0,0
6,8,-2,0,0,0
8,22,-14,0,0,0
5,-13,18,1,0,1
-17,-9,-8,0,0,0
-8,9,-17,0,0,0
10,-2,12,1,0,1
-29,-13,-16,0,0,0
10,24,-14,0,0,0
-29,-19,-10,0,0,0
29,9,20,1,0,1
9,21,-12,0,0,0
7,8,-1,0,0,0
-22,-15,-7,0,0,0
29,14,15,1,0,1
-7,-24,17,1,1,0
22,13,9,1,1,0
0,11,-11,0,1,1
19,26,-7,0,1,1
-16,-32,16,1,1,0
-4,-4,0,0,1,1
17,4,13,1,1,0
-46,-45,-1,0,1,1
22,7,15,1,1,0
11,23,-12,0,1,1
-56,-42,-14,0,1,1
11,2,9,1,1,0
-41,-36,-5,0,0,0
-26,-14,-12,0,0,0
8,11,-3,0,0,0
47,27,20,1,0,1
-27,-35,8,1,0,1
-17,-22,5,1,0,1
-19,-13,-6,0,0,0
25,23,2,1,0,1
-2,-3,1,1,0,1
44,33,11,1,1,0
-46,-29,-17,0,1,1
47,32,15,1,1,0
-16,-26,10,1,1,0
23,34,-11,0,1,1
1,-14,15,1,1,0
13,6,7,1,1,0
-35,-15,-20,0,1,1
-10,-19,9,1,0,1
-5,11,-16,0,0,0
3,-9,12,1,0,1
-35,-19,-16,0,0,0
-30,-44,14,1,0,1
0,0,0,0,0,0
36,32,4,1,0,1
41,42,-1,0,0,0
37,40,-3,0,0,0
-50,-34,-16,0,0,0
22,28,-6,0,0,0
47,43,4,1,0,1
54,35,19,1,0,1
7,-2,9,1,0,1
-28,-31,3,1,0,1
-27,-11,-16,0,0,0
16,3,13,1,0,1
2,-2,4,1,1,0
-35,-26,-9,0,1,1
19,27,-8,0,1,1
-37,-30,-7,0,1,1
-32,-12,-20,0,1,1
4,-5,9,1,1,0
-22,-27,5,1,1,0
-19,-6,-13,0,1,1
-32,-13,-19,0,1,1
13,26,-13,0,1,1
39,33,6,1,0,1
36,34,2,1,0,1
7,23,-16,0,0,0
23,19,4,1,0,1
17,36,-19,0,0,0
22,33,-11,0,0,0
0,5,-5,0,0,0
-16,3,-19,0,0,0
-3,-18,15,1,1,0
-2,-16,14,1,1,0
22,13,9,1,1,0
-35,-23,-12,0,1,1
-37,-34,-3,0,1,1
-21,-29,8,1,1,0
-15,-13,-2,0,1,1
-9,-7,-2,0,1,1
33,41,-8,0,0,0
-2,4,-6,0,0,0
-14,-21,7,1,0,1
34,28,6,1,0,1
0,5,-5,0,0,0
50,40,10,1,0,1
-52,-34,-18,0,0,0
-11,-4,-7,0,0,0
-3,12,-15,0,0,0
-5,-8,3,1,0,1
21,32,-11,0,0,0
-26,-17,-9,0,0,0
21,21,0,0,0,0
30,32,-2,0,0,0
39,41,-2,0,1,1
30,43,-13,0,1,1
-49,-29,-20,0,1,1
0,6,-6,0,1,1
-47,-34,-13,0,1,1
12,1,11,1,1,0
-26,-7,-19,0,1,1
-8,-12,4,1,1,0
6,12,-6,0,1,1
-19,-26,7,1,1,0
-51,-37,-14,0,1,1
-24,-16,-8,0,1,1
34,34,0,0,0,0
26,26,0,0,0,0
54,43,11,1,0,1
52,40,12,1,0,1
-43,-42,-1,0,0,0
14,12,2,1,0,1
-23,-17,-6,0,0,0
19,25,-6,0,0,0
42,38,4,1,0,1
-16,-33,17,1,0,1
52,34,18,1,0,1
-28,-39,11,1,1,0
-13,-20,7,1,1,0
21,5,16,1,1,0
23,15,8,1,1,0
-51,-36,-15,0,1,1
15,-5,20,1,1,0
-40,-39,-1,0,1,1
-21,-33,12,1,1,0
-36,-28,-8,0,0,0
26,18,8,1,0,1
0,-11,11,1,0,1
-5,-16,11,1,0,1
-10,-5,-5,0,0,0
51,35,16,1,0,1
47,36,11,1,0,1
-53,-34,-19,0,0,0
8,27,-19,0,0,0
24,28,-4,0,0,0
-42,-26,-16,0,0,0
-15,-4,-11,0,0,0
19,2,17,1,0,1
-37,-24,-13,0,0,0
-27,-11,-16,0,0,0
61,43,18,1,0,1
-15,-12,-3,0,0,0
-10,-5,-5,0,0,0
28,14,14,1,0,1
4,11,-7,0,0,0
35,37,-2,0,0,0
-32,-37,5,1,1,0
-13,-28,15,1,1,0
43,42,1,1,1,0
19,36,-17,0,1,1
9,26,-17,0,1,1
-27,-36,9,1,1,0
34,30,4,1,1,0
-52,-43,-9,0,1,1
-1,3,-4,0,1,1
-23,-24,1,1,1,0
11,-6,17,1,1,0
7,13,-6,0,1,1
-23,-3,-20,0,1,1
-18,-21,3,1,1,0
-2,9,-11,0,1,1
-8,-5,-3,0,0,0
-16,-19,3,1,0,1
42,28,14,1,0,1
-38,-26,-12,0,0,0
-14,-25,11,1,0,1
25,34,-9,0,0,0
-47,-29,-18,0,0,0
56,36,20,1,0,1
11,-5,16,1,0,1
11,25,-14,0,0,0
3,-10,13,1,0,1
-6,11,-17,0,0,0
19,18,1,1,0,1
18,28,-10,0,0,0
51,37,14,1,0,1
50,40,10,1,0,1
-39,-25,-14,0,0,0
28,10,18,1,0,1
-44,-38,-6,0,0,0
20,14,6,1,0,1
25,29,-4,0,0,0
11,26,-15,0,1,1
-14,-26,12,1,1,0
-3,7,-10,0,1,1
-3,-11,8,1,1,0
29,12,17,1,1,0
4,9,-5,0,1,1
-6,-17,11,1,1,0
34,44,-10,0,1,1
-50,-43,-7,0,1,1
16,24,-8,0,1,1
40,23,17,1,1,0
-34,-45,11,1,1,0
-13,4,-17,0,1,1
9,9,0,0,1,1
-37,-24,-13,0,0,0
-2,-13,11,1,0,1
36,24,12,1,0,1
-12,-19,7,1,0,1
-29,-21,-8,0,0,0
-2,-4,2,1,0,1
-30,-42,12,1,0,1
6,15,-9,0,0,0
-1,16,-17,0,0,0
9,13,-4,0,0,0
-48,-29,-19,0,0,0
-22,-21,-1,0,0,0
-24,-20,-4,0,0,0
2,-5,7,1,0,1
-49,-41,-8,0,0,0
-39,-30,-9,0,0,0
-37,-35,-2,0,0,0
32,24,8,1,0,1
-11,-27,16,1,1,0
-15,-22,7,1,1,0
40,25,15,1,1,0
-39,-34,-5,0,1,1
19,4,15,1,1,0
-39,-21,-18,0,1,1
24,6,18,1,1,0
-12,-25,13,1,1,0
-17,-25,8,1,1,0
0,19,-19,0,1,1
-19,-28,9,1,1,0
-13,-31,18,1,1,0
-4,-7,3,1,1,0
-18,-37,19,1,1,0
-27,-41,14,1,1,0
45,33,12,1,1,0
35,25,10,1,1,0
17,33,-16,0,0,0
-16,-7,-9,0,0,0
34,33,1,1,0,1
17,30,-13,0,0,0
-50,-31,-19,0,0,0
-38,-21,-17,0,0,0
-2,-22,20,1,0,1
-22,-12,-10,0,0,0
-32,-37,5,1,0,1
-36,-30,-6,0,0,0
-28,-12,-16,0,0,0
23,27,-4,0,0,0
-8,-24,16,1,0,1
-31,-45,14,1,0,1
-2,-4,2,1,0,1
32,19,13,1,0,1
14,21,-7,0,0,0
22,23,-1,0,0,0
16,35,-19,0,1,1
-3,-17,14,1,1,0
16,35,-19,0,1,1
-7,-10,3,1,1,0
15,34,-19,0,1,1
6,-1,7,1,1,0
3,-17,20,1,1,0
-16,-17,1,1,1,0
-11,-10,-1,0,1,1
-42,-33,-9,0,1,1
-23,-4,-19,0,1,1
4,17,-13,0,1,1
51,42,9,1,1,0
31,43,-12,0,1,1
-10,10,-20,0,1,1
-33,-23,-10,0,1,1
38,18,20,1,1,0
7,-3,10,1,1,0
22,29,-7,0,1,1
-19,-30,11,1,1,0
11,17,-6,0,1,1
-39,-27,-12,0,0,0
-39,-43,4,1,0,1
17,24,-7,0,0,0
54,43,11,1,0,1
12,5,7,1,0,1
-50,-45,-5,0,0,0
-39,-27,-12,0,0,0
-31,-41,10,1,0,1
30,26,4,1,0,1
-20,-7,-13,0,0,0
-42,-28,-14,0,0,0
-28,-18,-10,0,0,0
38,19,19,1,0,1
32,20,12,1,0,1
48,40,8,1,1,0
-31,-31,0,0,1,1
-26,-26,0,0,1,1
-47,-41,-6,0,1,1
-47,-27,-20,0,1,1
-51,-42,-9,0,1,1
29,11,18,1,1,0
9,16,-7,0,1,1
-53,-42,-11,0,0,0
25,6,19,1,0,1
26,37,-11,0,0,0
26,34,-8,0,0,0
-7,5,-12,0,0,0
-25,-15,-10,0,0,0
10,-10,20,1,0,1
8,15,-7,0,0,0
-24,-32,8,1,0,1
-33,-27,-6,0,0,0
19,27,-8,0,0,0
-28,-8,-20,0,0,0
46,37,9,1,0,1
-9,-28,19,1,0,1
25,6,19,1,0,1
-10,-17,7,1,0,1
24,10,14,1,1,0
-31,-26,-5,0,1,1
26,42,-16,0,1,1
-6,-4,-2,0,1,1
-42,-30,-12,0,1,1
-23,-33,10,1,1,0
-20,-11,-9,0,1,1
-1,-15,14,1,1,0
52,40,12,1,1,0
-26,-45,19,1,1,0
-54,-42,-12,0,1,1
-46,-39,-7,0,1,1
12,-6,18,1,1,0
25,12,13,1,1,0
0,-20,20,1,0,1
20,15,5,1,0,1
-30,-33,3,1,0,1
1,-11,12,1,0,1
6,12,-6,0,0,0
-7,-10,3,1,0,1
-40,-36,-4,0,0,0
33,19,14,1,0,1
-8,-27,19,1,0,1
-11,2,-13,0,0,0
51,39,12,1,0,1
50,42,8,1,0,1
19,6,13,1,0,1
-22,-26,4,1,1,0
-50,-30,-20,0,1,1
7,14,-7,0,1,1
-56,-36,-20,0,1,1
31,13,18,1,1,0
55,40,15,1,1,0
-20,-4,-16,0,1,1
55,39,16,1,1,0
15,6,9,1,1,0
42,27,15,1,1,0
-4,-12,8,1,0,1
17,-3,20,1,0,1
-19,-7,-12,0,0,0
14,29,-15,0,0,0
-13,1,-14,0,0,0
21,9,12,1,0,1
-11,-18,7,1,0,1
-38,-38,0,0,0,0
32,14,18,1,0,1
36,37,-1,0,0,0
19,23,-4,0,0,0
40,40,0,0,1,1
51,44,7,1,1,0
-24,-18,-6,0,1,1
14,8,6,1,1,0
-10,-4,-6,0,1,1
58,38,20,1,1,0
14,19,-5,0,1,1
-45,-32,-13,0,1,1
-32,-44,12,1,1,0
3,-12,15,1,1,0
-10,-9,-1,0,1,1
-12,-2,-10,0,0,0
36,22,14,1,0,1
-6,-5,-1,0,0,0
-35,-31,-4,0,0,0
36,33,3,1,0,1
2,13,-11,0,0,0
-7,-7,0,0,0,0
33,15,18,1,0,1
-25,-11,-14,0,0,0
41,26,15,1,0,1
-32,-20,-12,0,0,0
-42,-29,-13,0,0,0
39,44,-5,0,0,0
-55,-36,-19,0,1,1
38,22,16,1,1,0
-26,-38,12,1,1,0
23,25,-2,0,1,1
-14,1,-15,0,1,1
-34,-45,11,1,1,0
-33,-13,-20,0,1,1
-18,-17,-1,0,1,1
-9,-5,-4,0,0,0
17,20,-3,0,0,0
-22,-10,-12,0,0,0
-17,-35,18,1,0,1
36,16,20,1,0,1
-44,-45,1,1,0,1
-30,-45,15,1,0,1
18,33,-15,0,0,0
-39,-44,5,1,0,1
4,13,-9,0,0,0
-16,-2,-14,0,0,0
8,-10,18,1,0,1
-1,3,-4,0,0,0
-32,-18,-14,0,0,0
0,-6,6,1,0,1
14,22,-8,0,0,0
18,28,-10,0,0,0
6,-14,20,1,0,1
-46,-39,-7,0,0,0
-43,-26,-17,0,0,0
-42,-39,-3,0,1,1
-23,-19,-4,0,1,1
18,28,-10,0,1,1
6,-10,16,1,1,0
-17,-15,-2,0,1,1
41,25,16,1,1,0
45,43,2,1,1,0
-26,-45,19,1,1,0
26,11,15,1,1,0
46,39,7,1,1,0
-17,-15,-2,0,1,1
-44,-29,-15,0,1,1
-30,-23,-7,0,1,1
-13,-1,-12,0,1,1
52,40,12,1,1,0
-53,-44,-9,0,1,1
24,25,-1,0,1,1
43,40,3,1,0,1
24,7,17,1,0,1
14,-5,19,1,0,1
15,2,13,1,0,1
-56,-36,-20,0,0,0
-40,-28,-12,0,0,0
-30,-42,12,1,0,1
-25,-38,13,1,0,1
33,17,16,1,1,0
9,27,-18,0,1,1
-15,-18,3,1,1,0
-9,11,-20,0,1,1
-27,-9,-18,0,1,1
8,2,6,1,1,0
33,33,0,0,1,1
1,-6,7,1,1,0
49,42,7,1,1,0
-9,-8,-1,0,1,1
18,5,13,1,1,0
40,34,6,1,1,0
47,29,18,1,1,0
25,25,0,0,1,1
-46,-34,-12,0,1,1
20,12,8,1,1,0
48,31,17,1,1,0
39,28,11,1,1,0
32,14,18,1,1,0
-14,-19,5,1,1,0
-8,-7,-1,0,0,0
-25,-21,-4,0,0,0
37,28,9,1,0,1
-13,-31,18,1,0,1
-11,-15,4,1,0,1
-3,6,-9,0,0,0
43,37,6,1,0,1
12,7,5,1,0,1
21,11,10,1,0,1
-3,-11,8,1,0,1
45,29,16,1,1,0
-59,-45,-14,0,1,1
-36,-30,-6,0,1,1
-26,-34,8,1,1,0
-45,-30,-15,0,1,1
-47,-39,-8,0,1,1
22,11,11,1,1,0
-21,-19,-2,0,1,1
37,42,-5,0,1,1
-54,-36,-18,0,1,1
25,5,20,1,1,0
-40,-38,-2,0,1,1
51,40,11,1,1,0
35,28,7,1,1,0
11,20,-9,0,1,1
-28,-28,0,0,1,1
21,17,4,1,1,0
1,2,-1,0,0,0
12,18,-6,0,0,0
44,37,7,1,0,1
-36,-37,1,1,0,1
-4,0,-4,0,0,0
45,32,13,1,0,1
18,18,0,0,0,0
3,-5,8,1,0,1
4,18,-14,0,0,0
-25,-33,8,1,0,1
34,43,-9,0,0,0
-7,-15,8,1,0,1
-3,-17,14,1,0,1
-7,10,-17,0,0,0
-1,-8,7,1,0,1
-26,-28,2,1,0,1
49,34,15,1,0,1
-24,-17,-7,0,0,0
-12,-6,-6,0,0,0
6,-7,13,1,0,1
-1,7,-8,0,0,0
61,41,20,1,1,0
-23,-23,0,0,1,1
18,10,8,1,1,0
18,34,-16,0,1,1
25,12,13,1,1,0
5,21,-16,0,1,1
-30,-33,3,1,1,0
23,4,19,1,1,0
17,3,14,1,1,0
18,17,1,1,1,0
54,40,14,1,1,0
21,34,-13,0,1,1
42,27,15,1,1,0
26,26,0,0,1,1
-49,-30,-19,0,1,1
28,20,8,1,1,0
25,29,-4,0,1,1
-62,-45,-17,0,1,1
4,14,-10,0,1,1
-1,10,-11,0,1,1
-51,-33,-18,0,1,1
14,-5,19,1,0,1
27,27,0,0,0,0
51,41,10,1,0,1
-41,-22,-19,0,0,0
-7,2,-9,0,0,0
18,5,13,1,0,1
-64,-45,-19,0,0,0
-46,-31,-15,0,0,0
-28,-13,-15,0,0,0
9,6,3,1,0,1
3,-11,14,1,0,1
50,41,9,1,0,1
44,37,7,1,0,1
-27,-11,-16,0,0,0
16,29,-13,0,0,0
-19,1,-20,0,0,0
41,21,20,1,0,1
-1,1,-2,0,0,0
26,44,-18,0,0,0
-25,-27,2,1,0,1
12,-8,20,1,0,1
-47,-43,-4,0,1,1
-51,-34,-17,0,1,1
17,36,-19,0,1,1
3,6,-3,0,1,1
-19,-28,9,1,1,0
-1,-5,4,1,1,0
42,29,13,1,1,0
-19,-29,10,1,1,0
36,36,0,0,1,1
-34,-18,-16,0,0,0
-18,-23,5,1,0,1
3,9,-6,0,0,0
-14,0,-14,0,0,0
34,43,-9,0,0,0
-1,-21,20,1,0,1
37,31,6,1,0,1
3,7,-4,0,0,0
30,33,-3,0,0,0
36,34,2,1,0,1
-29,-24,-5,0,0,0
-25,-36,11,1,0,1
34,24,10,1,0,1
26,34,-8,0,1,1
26,22,4,1,1,0
-18,-14,-4,0,1,1
3,16,-13,0,1,1
43,27,16,1,1,0
11,-1,12,1,1,0
-10,-20,10,1,1,0
-59,-42,-17,0,1,1
-7,10,-17,0,1,1
24,20,4,1,1,0
38,27,11,1,1,0
-40,-44,4,1,0,1
27,26,1,1,0,1
25,12,13,1,0,1
27,20,7,1,0,1
14,8,6,1,0,1
23,33,-10,0,0,0
44,39,5,1,0,1
-15,-11,-4,0,0,0
-10,-2,-8,0,0,0
56,42,14,1,0,1
31,20,11,1,0,1
-4,-5,1,1,0,1
15,32,-17,0,0,0
-29,-16,-13,0,0,0
34,29,5,1,0,1
-8,8,-16,0,0,0
-48,-34,-14,0,0,0
-7,-9,2,1,0,1
-11,6,-17,0,0,0
5,2,3,1,0,1
-4,7,-11,0,0,0
-41,-35,-6,0,1,1
-7,13,-20,0,1,1
29,18,11,1,1,0
15,28,-13,0,1,1
-25,-17,-8,0,1,1
55,37,18,1,1,0
18,37,-19,0,1,1
-36,-19,-17,0,1,1
-1,14,-15,0,1,1
60,43,17,1,1,0
21,32,-11,0,1,1
41,21,20,1,1,0
19,39,-20,0,1,1
-26,-32,6,1,1,0
-22,-35,13,1,0,1
-6,-15,9,1,0,1
-36,-43,7,1,0,1
-1,18,-19,0,0,0
23,16,7,1,0,1
-4,11,-15,0,0,0
53,35,18,1,0,1
-8,-5,-3,0,0,0
-1,-18,17,1,0,1
44,27,17,1,0,1
2,4,-2,0,0,0
-2,17,-19,0,0,0
-21,-7,-14,0,0,0
21,32,-11,0,0,0
-60,-40,-20,0,0,0
5,-7,12,1,0,1
32,16,16,1,0,1
46,40,6,1,0,1
22,15,7,1,0,1
-25,-40,15,1,0,1
-8,-19,11,1,0,1
-19,-34,15,1,1,0
-33,-40,7,1,1,0
10,-1,11,1,1,0
50,37,13,1,1,0
-55,-39,-16,0,1,1
35,16,19,1,1,0
-30,-26,-4,0,1,1
18,9,9,1,1,0
-40,-33,-7,0,1,1
17,17,0,0,1,1
49,36,13,1,1,0
47,35,12,1,1,0
6,-5,11,1,1,0
-37,-36,-1,0,1,1
-23,-26,3,1,1,0
-1,-13,12,1,1,0
-26,-28,2,1,1,0
-42,-26,-16,0,1,1
48,41,7,1,1,0
-4,-10,6,1,1,0
35,30,5,1,1,0
36,36,0,0,0,0
-22,-39,17,1,0,1
39,35,4,1,0,1
-19,-8,-11,0,0,0
6,-9,15,1,0,1
13,11,2,1,0,1
34,35,-1,0,0,0
-10,7,-17,0,0,0
18,26,-8,0,0,0
22,12,10,1,0,1
0,-6,6,1,0,1
1,12,-11,0,0,0
32,23,9,1,0,1
22,24,-2,0,0,0
12,23,-11,0,0,0
-25,-18,-7,0,0,0
-1,-14,13,1,1,0
-29,-14,-15,0,1,1
-10,-29,19,1,1,0
-15,1,-16,0,1,1
-29,-13,-16,0,1,1
29,17,12,1,1,0
35,22,13,1,1,0
-41,-31,-10,0,1,1
18,12,6,1,1,0
34,15,19,1,1,0
-1,-18,17,1,1,0
18,30,-12,0,1,1
-12,-17,5,1,1,0
15,24,-9,0,1,1
54,40,14,1,0,1
-18,-10,-8,0,0,0
17,35,-18,0,0,0
-8,-9,1,1,0,1
-39,-44,5,1,0,1
-62,-45,-17,0,0,0
19,21,-2,0,0,0
29,16,13,1,0,1
-54,-39,-15,0,1,1
45,28,17,1,1,0
-34,-19,-15,0,1,1
42,33,9,1,1,0
20,28,-8,0,1,1
31,20,11,1,1,0
42,32,10,1,1,0
32,12,20,1,1,0
13,28,-15,0,1,1
14,9,5,1,1,0
-14,-4,-10,0,1,1
28,22,6,1,1,0
8,27,-19,0,1,1
-13,-7,-6,0,1,1
20,7,13,1,1,0
14,13,1,1,1,0
-22,-27,5,1,1,0
-17,-15,-2,0,1,1
-18,1,-19,0,1,1
51,40,11,1,1,0
-17,-15,-2,0,1,1
8,-9,17,1,0,1
10,-3,13,1,0,1
-16,-21,5,1,0,1
-16,-23,7,1,0,1
27,32,-5,0,0,0
47,34,13,1,0,1
56,40,16,1,0,1
17,0,17,1,0,1
-22,-42,20,1,0,1
28,27,1,1,0,1
-12,-27,15,1,0,1
32,34,-2,0,0,0
41,31,10,1,1,0
-18,-37,19,1,1,0
8,-1,9,1,1,0
43,34,9,1,1,0
-30,-40,10,1,1,0
43,44,-1,0,1,1
20,33,-13,0,1,1
46,43,3,1,1,0
21,2,19,1,1,0
49,39,10,1,1,0
30,13,17,1,1,0
-4,-18,14,1,1,0
30,31,-1,0,1,1
6,10,-4,0,1,1
33,27,6,1,1,0
33,42,-9,0,0,0
-18,-27,9,1,0,1
-18,-12,-6,0,0,0
-29,-38,9,1,0,1
30,44,-14,0,0,0
-51,-35,-16,0,0,0
-3,-18,15,1,0,1
-6,-24,18,1,0,1
-31,-19,-12,0,0,0
47,33,14,1,0,1
30,24,6,1,0,1
4,19,-15,0,1,1
14,-5,19,1,1,0
-32,-12,-20,0,1,1
35,43,-8,0,1,1
16,12,4,1,1,0
-15,-19,4,1,1,0
16,36,-20,0,1,1
27,10,17,1,1,0
-31,-12,-19,0,1,1
8,27,-19,0,1,1
24,27,-3,0,0,0
-38,-35,-3,0,0,0
-52,-36,-16,0,0,0
29,23,6,1,0,1
-35,-42,7,1,0,1
-26,-42,16,1,0,1
-17,-29,12,1,0,1
44,36,8,1,0,1
-24,-11,-13,0,0,0
-3,15,-18,0,1,1
-17,-21,4,1,1,0
12,28,-16,0,1,1
36,35,1,1,1,0
-22,-11,-11,0,1,1
11,5,6,1,1,0
-41,-36,-5,0,1,1
36,43,-7,0,1,1
-20,-18,-2,0,1,1
30,16,14,1,1,0
-59,-44,-15,0,1,1
2,7,-5,0,1,1
-20,-39,19,1,1,0
58,44,14,1,1,0
-45,-32,-13,0,1,1
9,27,-18,0,1,1
25,29,-4,0,1,1
-27,-42,15,1,1,0
-51,-43,-8,0,1,1
15,15,0,0,1,1
8,-7,15,1,1,0
-6,-5,-1,0,0,0
-29,-27,-2,0,0,0
-28,-29,1,1,0,1
37,35,2,1,0,1
52,33,19,1,0,1
23,41,-18,0,0,0
-17,-16,-1,0,0,0
20,28,-8,0,0,0
17,30,-13,0,0,0
30,21,9,1,0,1
-1,7,-8,0,1,1
-54,-36,-18,0,1,1
-4,14,-18,0,1,1
-53,-39,-14,0,1,1
-34,-45,11,1,1,0
8,5,3,1,1,0
2,-15,17,1,1,0
23,21,2,1,1,0
-15,-11,-4,0,1,1
-11,-8,-3,0,1,1
-15,-6,-9,0,1,1
-18,-7,-11,0,1,1
1,-17,18,1,1,0
-60,-42,-18,0,1,1
-24,-28,4,1,1,0
-7,-10,3,1,1,0
15,19,-4,0,1,1
-38,-22,-16,0,1,1
-41,-32,-9,0,1,1
-29,-37,8,1,1,0
46,30,16,1,1,0
-9,-21,12,1,0,1
1,16,-15,0,0,0
-31,-29,-2,0,0,0
-19,-23,4,1,0,1
58,42,16,1,0,1
53,40,13,1,0,1
20,29,-9,0,0,0
-8,-14,6,1,0,1
17,18,-1,0,0,0
-21,-10,-11,0,0,0
-21,-27,6,1,0,1
-41,-34,-7,0,0,0
37,36,1,1,0,1
-17,-33,16,1,0,1
20,5,15,1,0,1
48,33,15,1,0,1
5,-7,12,1,0,1
50,39,11,1,1,0
-55,-36,-19,0,1,1
-47,-35,-12,0,1,1
-45,-25,-20,0,1,1
21,37,-16,0,1,1
-45,-27,-18,0,1,1
-36,-38,2,1,1,0
20,18,2,1,1,0
-23,-12,-11,0,1,1
28,44,-16,0,1,1
0,5,-5,0,1,1
-10,-12,2,1,1,0
-13,-6,-7,0,1,1
-59,-44,-15,0,1,1
25,15,10,1,0,1
20,14,6,1,0,1
48,34,14,1,0,1
-57,-40,-17,0,0,0
19,13,6,1,0,1
54,36,18,1,0,1
6,21,-15,0,0,0
-44,-43,-1,0,0,0
7,7,0,0,0,0
4,-10,14,1,0,1
22,12,10,1,0,1
40,21,19,1,0,1
-25,-16,-9,0,0,0
-14,-20,6,1,0,1
32,36,-4,0,0,0
-31,-45,14,1,0,1
38,43,-5,0,0,0
24,38,-14,0,0,0
-14,-20,6,1,0,1
20,40,-20,0,0,0
-21,-33,12,1,0,1
-10,3,-13,0,1,1
19,38,-19,0,1,1
6,-5,11,1,1,0
-25,-13,-12,0,1,1
-29,-17,-12,0,1,1
28,11,17,1,1,0
-25,-40,15,1,1,0
2,-13,15,1,1,0
-6,-8,2,1,1,0
14,15,-1,0,1,1
-45,-40,-5,0,1,1
39,42,-3,0,1,1
-37,-44,7,1,1,0
36,31,5,1,0,1
37,44,-7,0,0,0
-35,-42,7,1,0,1
3,-4,7,1,0,1
-17,-11,-6,0,0,0
51,32,19,1,0,1
-22,-18,-4,0,0,0
12,7,5,1,0,1
-13,-18,5,1,0,1
36,31,5,1,1,0
-31,-25,-6,0,1,1
39,41,-2,0,1,1
-18,-36,18,1,1,0
47,30,17,1,1,0
-13,5,-18,0,1,1
20,24,-4,0,1,1
-22,-36,14,1,1,0
-27,-24,-3,0,1,1
18,10,8,1,1,0
3,23,-20,0,1,1
-60,-40,-20,0,1,1
-3,-14,11,1,1,0
-55,-42,-13,0,1,1
5,2,3,1,1,0
32,23,9,1,1,0
0,-14,14,1,1,0
9,12,-3,0,1,1
5,20,-15,0,1,1
-30,-24,-6,0,1,1
15,-3,18,1,1,0
30,19,11,1,0,1
-51,-33,-18,0,0,0
-38,-20,-18,0,0,0
-21,-22,1,1,0,1
-26,-23,-3,0,0,0
-8,2,-10,0,0,0
24,4,20,1,0,1
59,42,17,1,0,1
23,31,-8,0,0,0
-20,-8,-12,0,0,0
-9,-7,-2,0,0,0
7,26,-19,0,1,1
-42,-31,-11,0,1,1
12,12,0,0,1,1
-12,-21,9,1,1,0
1,8,-7,0,1,1
-2,-11,9,1,1,0
-33,-41,8,1,1,0
8,6,2,1,1,0
-43,-39,-4,0,1,1
-14,-5,-9,0,1,1
-44,-27,-17,0,0,0
20,21,-1,0,0,0
-18,-7,-11,0,0,0
-47,-44,-3,0,0,0
16,28,-12,0,0,0
3,12,-9,0,0,0
14,19,-5,0,0,0
33,39,-6,0,0,0
12,20,-8,0,0,0
-8,-5,-3,0,0,0
-30,-33,3,1,0,1
31,42,-11,0,0,0
-23,-3,-20,0,0,0
-10,-6,-4,0,0,0
4,-12,16,1,0,1
-2,17,-19,0,0,0
7,-2,9,1,0,1
11,28,-17,0,0,0
-44,-31,-13,0,0,0
0,19,-19,0,0,0
22,25,-3,0,0,0
-19,-21,2,1,1,0
18,12,6,1,1,0
16,16,0,0,1,1
-49,-36,-13,0,1,1
-12,-28,16,1,1,0
9,16,-7,0,1,1
10,10,0,0,1,1
-41,-37,-4,0,1,1
-26,-41,15,1,1,0
8,10,-2,0,1,1
-6,12,-18,0,1,1
-13,-8,-5,0,1,1
-24,-12,-12,0,1,1
-6,-2,-4,0,1,1
-2,-7,5,1,1,0
40,31,9,1,0,1
-31,-13,-18,0,0,0
-22,-31,9,1,0,1
41,43,-2,0,0,0
-22,-10,-12,0,0,0
-3,10,-13,0,0,0
6,8,-2,0,0,0
29,32,-3,0,0,0
31,29,2,1,0,1
13,20,-7,0,0,0
38,34,4,1,0,1
0,5,-5,0,0,0
-13,-11,-2,0,0,0
-36,-41,5,1,0,1
-31,-39,8,1,0,1
-26,-14,-12,0,0,0
-1,6,-7,0,0,0
33,17,16,1,0,1
-12,6,-18,0,1,1
20,39,-19,0,1,1
60,41,19,1,1,0
58,42,16,1,1,0
-29,-28,-1,0,1,1
3,22,-19,0,1,1
-11,8,-19,0,1,1
13,32,-19,0,1,1
-42,-26,-16,0,1,1
15,12,3,1,1,0
51,37,14,1,1,0
-27,-45,18,1,1,0
31,43,-12,0,0,0
-19,-14,-5,0,0,0
8,15,-7,0,0,0
-20,-13,-7,0,0,0
0,-2,2,1,0,1
23,39,-16,0,0,0
5,-7,12,1,0,1
-60,-45,-15,0,0,0
5,18,-13,0,0,0
-23,-37,14,1,0,1
-34,-33,-1,0,0,0
-25,-37,12,1,0,1
19,15,4,1,0,1
-60,-42,-18,0,0,0
-19,-30,11,1,0,1
4,16,-12,0,0,0
-38,-40,2,1,0,1
17,14,3,1,0,1
4,1,3,1,0,1
9,12,-3,0,0,0
3,0,3,1,0,1
27,15,12,1,1,0
-15,-24,9,1,1,0
-7,-27,20,1,1,0
17,7,10,1,1,0
2,-10,12,1,1,0
-30,-41,11,1,1,0
15,13,2,1,1,0
41,29,12,1,1,0
17,31,-14,0,1,1
15,0,15,1,1,0
7,11,-4,0,1,1
14,11,3,1,0,1
-4,-21,17,1,0,1
4,9,-5,0,0,0
21,31,-10,0,0,0
-9,-14,5,1,0,1
43,40,3,1,0,1
7,2,5,1,0,1
-2,-12,10,1,0,1
-6,-10,4,1,0,1
-8,3,-11,0,0,0
1,21,-20,0,1,1
22,39,-17,0,1,1
36,25,11,1,1,0
-16,-1,-15,0,1,1
-22,-18,-4,0,1,1
-58,-43,-15,0,1,1
3,-6,9,1,1,0
-26,-45,19,1,1,0
17,31,-14,0,1,1
-13,-3,-10,0,0,0
13,23,-10,0,0,0
-51,-38,-13,0,0,0
4,1,3,1,0,1
29,36,-7,0,0,0
17,8,9,1,0,1
14,33,-19,0,0,0
30,24,6,1,0,1
-14,4,-18,0,1,1
-33,-26,-7,0,1,1
23,22,1,1,1,0
-43,-29,-14,0,1,1
-36,-18,-18,0,1,1
42,40,2,1,1,0
23,30,-7,0,1,1
15,11,4,1,1,0
-19,-31,12,1,1,0
23,37,-14,0,1,1
47,30,17,1,1,0
3,-1,4,1,1,0
-47,-32,-15,0,1,1
-14,-30,16,1,1,0
36,28,8,1,1,0
13,19,-6,0,1,1
-15,-31,16,1,1,0
-5,-12,7,1,1,0
13,20,-7,0,1,1
42,40,2,1,0,1
14,24,-10,0,0,0
-30,-10,-20,0,0,0
31,35,-4,0,0,0
45,32,13,1,0,1
10,6,4,1,0,1
-35,-16,-19,0,0,0
-26,-40,14,1,0,1
34,25,9,1,0,1
30,22,8,1,0,1
-24,-41,17,1,0,1
-50,-33,-17,0,1,1
19,31,-12,0,1,1
45,35,10,1,1,0
59,41,18,1,1,0
24,6,18,1,1,0
-18,-7,-11,0,1,1
-1,7,-8,0,1,1
-16,-27,11,1,1,0
-35,-24,-11,0,1,1
37,43,-6,0,1,1
54,38,16,1,1,0
12,20,-8,0,1,1
-35,-17,-18,0,1,1
41,24,17,1,1,0
45,26,19,1,1,0
-37,-31,-6,0,1,1
33,18,15,1,1,0
31,15,16,1,1,0
-41,-30,-11,0,1,1
-42,-36,-6,0,0,0
-33,-23,-10,0,0,0
-62,-44,-18,0,0,0
54,35,19,1,0,1
4,11,-7,0,0,0
-27,-17,-10,0,0,0
24,29,-5,0,0,0
11,30,-19,0,0,0
8,22,-14,0,0,0
3,-6,9,1,0,1
-3,-12,9,1,0,1
-34,-18,-16,0,1,1
20,18,2,1,1,0
14,1,13,1,1,0
-30,-29,-1,0,1,1
46,37,9,1,1,0
-57,-41,-16,0,1,1
2,8,-6,0,1,1
15,35,-20,0,1,1
-7,-8,1,1,1,0
-44,-42,-2,0,0,0
40,30,10,1,0,1
34,38,-4,0,0,0
18,17,1,1,0,1
10,7,3,1,0,1
-31,-28,-3,0,0,0
15,30,-15,0,0,0
-35,-22,-13,0,0,0
-25,-11,-14,0,0,0
58,44,14,1,0,1
51,39,12,1,0,1
36,38,-2,0,0,0
-2,-20,18,1,0,1
-46,-36,-10,0,0,0
-48,-45,-3,0,0,0
4,-1,5,1,0,1
-45,-32,-13,0,0,0
49,39,10,1,0,1
16,19,-3,0,0,0
-11,-1,-10,0,0,0
-22,-29,7,1,0,1
-33,-39,6,1,1,0
6,22,-16,0,1,1
36,35,1,1,1,0
20,2,18,1,1,0
50,36,14,1,1,0
-52,-38,-14,0,1,1
-56,-43,-13,0,1,1
-21,-31,10,1,1,0
-11,8,-19,0,1,1
-31,-24,-7,0,0,0
30,34,-4,0,0,0
25,23,2,1,0,1
26,26,0,0,0,0
-46,-43,-3,0,0,0
-11,2,-13,0,0,0
-36,-37,1,1,0,1
9,-11,20,1,0,1
29,30,-1,0,0,0
14,-3,17,1,0,1
-15,-31,16,1,0,1
-20,-3,-17,0,0,0
38,21,17,1,1,0
9,18,-9,0,1,1
-3,1,-4,0,1,1
1,-7,8,1,1,0
33,29,4,1,1,0
54,37,17,1,1,0
33,34,-1,0,1,1
40,24,16,1,1,0
6,6,0,0,1,1
4,-1,5,1,1,0
53,38,15,1,1,0
-5,-22,17,1,1,0
46,33,13,1,1,0
-11,-4,-7,0,1,1
-21,-36,15,1,0,1
11,31,-20,0,0,0
-52,-36,-16,0,0,0
19,19,0,0,0,0
-13,-5,-8,0,0,0
-37,-39,2,1,0,1
-19,-12,-7,0,0,0
38,31,7,1,0,1
-53,-45,-8,0,0,0
2,-16,18,1,0,1
32,43,-11,0,0,0
-54,-38,-16,0,0,0
-21,-20,-1,0,0,0
44,43,1,1,0,1
-16,-33,17,1,0,1
-21,-17,-4,0,1,1
7,-9,16,1,1,0
36,37,-1,0,1,1
-46,-31,-15,0,1,1
-12,-22,10,1,1,0
-23,-43,20,1,1,0
-20,-4,-16,0,1,1
-11,-10,-1,0,1,1
-40,-27,-13,0,1,1
-9,-27,18,1,1,0
49,30,19,1,1,0
-50,-44,-6,0,1,1
30,29,1,1,1,0
-48,-40,-8,0,1,1
-56,-42,-14,0,0,0
-25,-10,-15,0,0,0
-62,-44,-18,0,0,0
42,37,5,1,0,1
16,25,-9,0,0,0
-6,-3,-3,0,0,0
-10,5,-15,0,0,0
-37,-23,-14,0,0,0
-9,-24,15,1,0,1
-7,9,-16,0,1,1
-30,-25,-5,0,1,1
56,42,14,1,1,0
33,34,-1,0,1,1
-23,-40,17,1,1,0
-33,-34,1,1,1,0
-8,-15,7,1,1,0
-40,-23,-17,0,1,1
-15,-31,16,1,1,0
-12,4,-16,0,0,0
-29,-14,-15,0,0,0
-23,-42,19,1,0,1
-43,-40,-3,0,0,0
-6,-25,19,1,0,1
-28,-32,4,1,0,1
-1,8,-9,0,0,0
-25,-37,12,1,0,1
-35,-31,-4,0,0,0
-40,-24,-16,0,0,0
34,38,-4,0,1,1
-18,-27,9,1,1,0
-26,-42,16,1,1,0
-45,-38,-7,0,1,1
-1,-18,17,1,1,0
8,24,-16,0,1,1
-8,-6,-2,0,1,1
7,-10,17,1,1,0
35,38,-3,0,1,1
-23,-29,6,1,1,0
-21,-38,17,1,1,0
-9,10,-19,0,1,1
-16,-7,-9,0,1,1
-38,-27,-11,0,1,1
56,42,14,1,1,0
-13,-25,12,1,1,0
24,10,14,1,1,0
36,29,7,1,1,0
-25,-9,-16,0,1,1
33,42,-9,0,1,1
40,37,3,1,1,0
23,6,17,1,0,1
-36,-18,-18,0,0,0
29,40,-11,0,0,0
33,43,-10,0,0,0
1,10,-9,0,0,0
-40,-24,-16,0,0,0
-30,-29,-1,0,0,0
19,38,-19,0,0,0
-1,-9,8,1,1,0
-12,-22,10,1,1,0
-37,-31,-6,0,1,1
62,43,19,1,1,0
2,-15,17,1,1,0
-28,-9,-19,0,1,1
11,7,4,1,1,0
57,41,16,1,1,0
21,10,11,1,1,0
-27,-23,-4,0,1,1
32,29,3,1,1,0
21,41,-20,0,1,1
-29,-41,12,1,0,1
16,1,15,1,0,1
24,25,-1,0,0,0
2,10,-8,0,0,0
-2,-2,0,0,0,0
-34,-33,-1,0,0,0
50,37,13,1,0,1
-46,-42,-4,0,0,0
-48,-43,-5,0,0,0
7,4,3,1,0,1
45,34,11,1,1,0
-11,-4,-7,0,1,1
-31,-17,-14,0,1,1
-38,-20,-18,0,1,1
-12,3,-15,0,1,1
35,33,2,1,1,0
-34,-15,-19,0,1,1
-34,-27,-7,0,1,1
-48,-37,-11,0,1,1
2,11,-9,0,1,1
-57,-44,-13,0,0,0
29,33,-4,0,0,0
-12,-29,17,1,0,1
-14,-22,8,1,0,1
30,20,10,1,0,1
27,41,-14,0,0,0
-22,-15,-7,0,0,0
-33,-40,7,1,0,1
22,11,11,1,0,1
-38,-31,-7,0,0,0
-10,-17,7,1,0,1
2,-3,5,1,0,1
11,-9,20,1,0,1
-2,-7,5,1,0,1
8,25,-17,0,0,0
-20,0,-20,0,0,0
-31,-11,-20,0,0,0
59,39,20,1,0,1
-29,-44,15,1,1,0
16,29,-13,0,1,1
6,-2,8,1,1,0
27,38,-11,0,1,1
17,-1,18,1,1,0
5,24,-19,0,1,1
-60,-42,-18,0,1,1
-12,1,-13,0,1,1
60,43,17,1,1,0
-15,-18,3,1,1,0
6,-14,20,1,1,0
-10,-26,16,1,0,1
-36,-30,-6,0,0,0
45,36,9,1,0,1
54,36,18,1,0,1
-15,-17,2,1,0,1
16,15,1,1,0,1
40,44,-4,0,0,0
-54,-45,-9,0,0,0
32,31,1,1,0,1
52,40,12,1,0,1
-35,-31,-4,0,0,0
3,-5,8,1,0,1
1,-9,10,1,0,1
24,35,-11,0,0,0
-35,-17,-18,0,1,1
21,21,0,0,1,1
29,39,-10,0,1,1
23,23,0,0,1,1
-2,13,-15,0,1,1
41,42,-1,0,1,1
-12,-14,2,1,1,0
15,27,-12,0,1,1
9,23,-14,0,1,1
26,34,-8,0,1,1
34,43,-9,0,1,1
52,43,9,1,1,0
-25,-35,10,1,1,0
-36,-44,8,1,1,0
-37,-20,-17,0,1,1
-45,-36,-9,0,1,1
-45,-43,-2,0,1,1
-30,-32,2,1,1,0
-29,-43,14,1,1,0
-16,-30,14,1,1,0
-11,-12,1,1,1,0
-36,-36,0,0,0,0
-10,-11,1,1,0,1
27,39,-12,0,0,0
-8,-1,-7,0,0,0
12,9,3,1,0,1
4,21,-17,0,0,0
42,35,7,1,0,1
19,14,5,1,0,1
53,34,19,1,0,1
-23,-25,2,1,0,1
5,0,5,1,0,1
40,37,3,1,0,1
28,35,-7,0,0,0
7,3,4,1,0,1
-27,-31,4,1,1,0
59,44,15,1,1,0
15,32,-17,0,1,1
0,-4,4,1,1,0
24,29,-5,0,1,1
-30,-17,-13,0,1,1
-14,-30,16,1,1,0
61,43,18,1,1,0
-42,-42,0,0,1,1
-35,-23,-12,0,1,1
34,23,11,1,1,0
3,-11,14,1,1,0
-36,-32,-4,0,1,1
-26,-11,-15,0,1,1
20,32,-12,0,1,1
21,16,5,1,1,0
-51,-36,-15,0,1,1
2,-6,8,1,1,0
-8,-3,-5,0,1,1
23,35,-12,0,1,1
-2,9,-11,0,1,1
-1,-19,18,1,0,1
-20,-6,-14,0,0,0
-40,-30,-10,0,0,0
36,28,8,1,0,1
-54,-43,-11,0,0,0
-7,0,-7,0,0,0
-26,-11,-15,0,0,0
-43,-35,-8,0,0,0
14,21,-7,0,0,0
6,19,-13,0,0,0
-32,-27,-5,0,0,0
31,16,15,1,0,1
22,17,5,1,0,1
30,15,15,1,0,1
-5,13,-18,0,0,0
21,4,17,1,0,1
19,11,8,1,0,1
-22,-31,9,1,0,1
-60,-43,-17,0,0,0
26,29,-3,0,0,0
-18,-31,13,1,0,1
-36,-40,4,1,1,0
-30,-39,9,1,1,0
-36,-29,-7,0,1,1
36,27,9,1,1,0
51,33,18,1,1,0
29,11,18,1,1,0
12,20,-8,0,1,1
26,12,14,1,1,0
-23,-41,18,1,1,0
11,-6,17,1,1,0
-39,-43,4,1,1,0
14,-3,17,1,0,1
34,22,12,1,0,1
32,21,11,1,0,1
6,25,-19,0,0,0
-1,9,-10,0,0,0
-31,-14,-17,0,0,0
-10,-11,1,1,0,1
47,29,18,1,0,1
-45,-34,-11,0,0,0
-32,-37,5,1,0,1
20,0,20,1,0,1
23,4,19,1,1,0
-37,-37,0,0,1,1
-18,-8,-10,0,1,1
43,41,2,1,1,0
-17,-15,-2,0,1,1
12,8,4,1,1,0
-21,-35,14,1,1,0
30,40,-10,0,1,1
24,18,6,1,1,0
-14,-3,-11,0,1,1
7,4,3,1,1,0
-20,-29,9,1,1,0
31,29,2,1,1,0
-27,-29,2,1,1,0
26,28,-2,0,1,1
-16,-19,3,1,1,0
14,-6,20,1,1,0
-33,-38,5,1,1,0
-31,-25,-6,0,1,1
48,37,11,1,1,0
-11,-8,-3,0,1,1
21,39,-18,0,0,0
-1,-19,18,1,0,1
-12,-5,-7,0,0,0
23,7,16,1,0,1
-27,-7,-20,0,0,0
13,18,-5,0,0,0
19,2,17,1,0,1
15,25,-10,0,0,0
-10,-19,9,1,0,1
-9,9,-18,0,1,1
-1,17,-18,0,1,1
-17,-34,17,1,1,0
-13,-15,2,1,1,0
-18,-8,-10,0,1,1
-27,-29,2,1,1,0
-13,-5,-8,0,1,1
27,43,-16,0,1,1
-21,-39,18,1,1,0
-12,-3,-9,0,1,1
-24,-21,-3,0,1,1
-13,-20,7,1,1,0
-29,-31,2,1,1,0
37,36,1,1,0,1
-14,-17,3,1,0,1
-34,-34,0,0,0,0
-37,-45,8,1,0,1
14,14,0,0,0,0
-20,-25,5,1,0,1
31,41,-10,0,0,0
19,9,10,1,0,1
-52,-40,-12,0,0,0
-40,-42,2,1,1,0
5,-6,11,1,1,0
3,-11,14,1,1,0
-54,-44,-10,0,1,1
40,35,5,1,1,0
5,19,-14,0,1,1
30,19,11,1,1,0
-11,8,-19,0,1,1
34,20,14,1,1,0
-20,-29,9,1,1,0
-45,-34,-11,0,0,0
16,18,-2,0,0,0
2,-9,11,1,0,1
52,33,19,1,0,1
32,27,5,1,0,1
-9,-18,9,1,0,1
-9,-20,11,1,0,1
46,37,9,1,0,1
-11,-3,-8,0,0,0
-8,-6,-2,0,0,0
-14,-29,15,1,0,1
38,19,19,1,0,1
8,3,5,1,0,1
37,33,4,1,0,1
-23,-18,-5,0,1,1
-21,-12,-9,0,1,1
-5,-24,19,1,1,0
31,39,-8,0,1,1
-2,5,-7,0,1,1
-17,-37,20,1,1,0
-5,-13,8,1,1,0
9,9,0,0,1,1
3,-5,8,1,1,0
41,22,19,1,1,0
-36,-35,-1,0,1,1
33,39,-6,0,0,0
4,18,-14,0,0,0
-4,1,-5,0,0,0
21,40,-19,0,0,0
-28,-12,-16,0,0,0
36,34,2,1,0,1
2,-7,9,1,0,1
-47,-30,-17,0,0,0
-26,-15,-11,0,0,0
9,-9,18,1,0,1
14,19,-5,0,0,0
13,5,8,1,0,1
32,25,7,1,0,1
-28,-13,-15,0,0,0
13,12,1,1,0,1
34,15,19,1,0,1
-41,-31,-10,0,0,0
43,28,15,1,0,1
50,44,6,1,0,1
12,18,-6,0,0,0
16,8,8,1,0,1
-37,-30,-7,0,1,1
56,37,19,1,1,0
-1,-10,9,1,1,0
-36,-19,-17,0,1,1
-14,-6,-8,0,1,1
-36,-42,6,1,1,0
-24,-22,-2,0,1,1
12,20,-8,0,1,1
-17,-20,3,1,1,0
32,40,-8,0,1,1
-47,-37,-10,0,1,1
-12,0,-12,0,0,0
35,16,19,1,0,1
-3,-14,11,1,0,1
42,32,10,1,0,1
-19,-21,2,1,0,1
-30,-24,-6,0,0,0
-48,-35,-13,0,0,0
-26,-43,17,1,0,1
35,17,18,1,1,0
30,25,5,1,1,0
-7,-5,-2,0,1,1
-25,-18,-7,0,1,1
-22,-20,-2,0,1,1
-21,-4,-17,0,1,1
-49,-40,-9,0,1,1
-38,-35,-3,0,1,1
21,2,19,1,1,0
-23,-28,5,1,1,0
-55,-42,-13,0,1,1
-38,-28,-10,0,1,1
6,26,-20,0,1,1
5,0,5,1,1,0
22,38,-16,0,1,1
-29,-35,6,1,1,0
6,25,-19,0,1,1
-18,-21,3,1,1,0
-7,5,-12,0,1,1
37,22,15,1,1,0
0,14,-14,0,1,1
21,30,-9,0,0,0
18,17,1,1,0,1
-29,-23,-6,0,0,0
-1,-5,4,1,0,1
-37,-25,-12,0,0,0
8,-6,14,1,0,1
-20,-32,12,1,0,1
23,4,19,1,0,1
8,-10,18,1,0,1
-27,-44,17,1,0,1
24,43,-19,0,0,0
-28,-33,5,1,0,1
49,42,7,1,0,1
-40,-21,-19,0,0,0
-42,-28,-14,0,0,0
-41,-32,-9,0,0,0
33,33,0,0,0,0
-44,-41,-3,0,0,0
-21,-23,2,1,0,1
24,18,6,1,0,1
33,31,2,1,0,1
25,29,-4,0,1,1
-47,-35,-12,0,1,1
-6,0,-6,0,1,1
17,35,-18,0,1,1
35,23,12,1,1,0
-58,-40,-18,0,1,1
51,33,18,1,1,0
10,4,6,1,1,0
-44,-45,1,1,1,0
10,-8,18,1,0,1
3,19,-16,0,0,0
8,-5,13,1,0,1
25,23,2,1,0,1
32,32,0,0,0,0
-17,3,-20,0,0,0
10,27,-17,0,0,0
37,38,-1,0,0,0
24,8,16,1,0,1
13,-1,14,1,1,0
-34,-35,1,1,1,0
-29,-31,2,1,1,0
32,15,17,1,1,0
22,29,-7,0,1,1
40,37,3,1,1,0
-14,-16,2,1,1,0
-49,-36,-13,0,1,1
-35,-29,-6,0,1,1
39,31,8,1,1,0
-25,-28,3,1,0,1
21,7,14,1,0,1
-8,-9,1,1,0,1
11,31,-20,0,0,0
-1,18,-19,0,0,0
39,42,-3,0,0,0
-5,7,-12,0,0,0
-17,-26,9,1,0,1
-38,-29,-9,0,0,0
12,-7,19,1,0,1
5,19,-14,0,0,0
3,16,-13,0,0,0
-27,-19,-8,0,0,0
-13,-9,-4,0,0,0
-24,-18,-6,0,0,0
11,5,6,1,0,1
-48,-31,-17,0,1,1
-4,0,-4,0,1,1
-18,-4,-14,0,1,1
-8,1,-9,0,1,1
10,-7,17,1,1,0
45,42,3,1,1,0
20,4,16,1,1,0
-39,-23,-16,0,1,1
-54,-41,-13,0,1,1
-26,-28,2,1,1,0
19,36,-17,0,1,1
-13,-16,3,1,1,0
9,8,1,1,0,1
15,25,-10,0,0,0
30,19,11,1,0,1
-12,2,-14,0,0,0
27,22,5,1,0,1
-2,3,-5,0,0,0
45,36,9,1,0,1
1,9,-8,0,0,0
40,24,16,1,0,1
-8,-10,2,1,1,0
21,23,-2,0,1,1
10,-9,19,1,1,0
-1,16,-17,0,1,1
-47,-37,-10,0,1,1
-50,-33,-17,0,1,1
-23,-10,-13,0,1,1
29,43,-14,0,1,1
15,-4,19,1,0,1
18,35,-17,0,0,0
11,-7,18,1,0,1
58,41,17,1,0,1
-56,-36,-20,0,0,0
-53,-34,-19,0,0,0
-3,-18,15,1,0,1
-42,-33,-9,0,0,0
36,39,-3,0,0,0
-29,-31,2,1,0,1
3,-11,14,1,1,0
29,42,-13,0,1,1
-4,15,-19,0,1,1
17,6,11,1,1,0
5,0,5,1,1,0
-42,-44,2,1,1,0
1,5,-4,0,1,1
-16,-27,11,1,1,0
4,20,-16,0,1,1
21,26,-5,0,0,0
-12,-23,11,1,0,1
-36,-20,-16,0,0,0
61,44,17,1,0,1
15,29,-14,0,0,0
43,44,-1,0,0,0
-33,-41,8,1,0,1
6,-7,13,1,0,1
-32,-34,2,1,1,0
-7,-18,11,1,1,0
-24,-30,6,1,1,0
13,-1,14,1,1,0
35,16,19,1,1,0
59,44,15,1,1,0
-9,-9,0,0,1,1
-28,-24,-4,0,1,1
16,9,7,1,1,0
-16,-8,-8,0,0,0
-15,-32,17,1,0,1
-29,-26,-3,0,0,0
7,13,-6,0,0,0
-7,-8,1,1,0,1
51,31,20,1,0,1
18,0,18,1,0,1
-34,-26,-8,0,0,0
31,44,-13,0,0,0
-39,-32,-7,0,1,1
-42,-39,-3,0,1,1
28,12,16,1,1,0
-44,-39,-5,0,1,1
36,40,-4,0,1,1
-17,-26,9,1,1,0
-40,-35,-5,0,1,1
42,39,3,1,1,0
14,15,-1,0,1,1
0,-1,1,1,1,0
-20,-4,-16,0,1,1
-45,-35,-10,0,1,1
-28,-25,-3,0,0,0
-28,-42,14,1,0,1
-42,-24,-18,0,0,0
18,13,5,1,0,1
-28,-25,-3,0,0,0
30,34,-4,0,0,0
-5,-7,2,1,0,1
23,24,-1,0,0,0
-32,-43,11,1,0,1
-59,-40,-19,0,0,0
1,0,1,1,0,1
30,11,19,1,0,1
42,38,4,1,0,1
62,44,18,1,0,1
13,20,-7,0,0,0
-3,-16,13,1,1,0
-14,4,-18,0,1,1
37,29,8,1,1,0
-31,-30,-1,0,1,1
56,41,15,1,1,0
-29,-22,-7,0,1,1
27,7,20,1,1,0
-21,-3,-18,0,1,1
-7,8,-15,0,1,1
-7,-11,4,1,1,0
13,16,-3,0,1,1
7,17,-10,0,1,1
-23,-28,5,1,1,0
-13,-22,9,1,1,0
27,9,18,1,1,0
35,42,-7,0,1,1
-7,-10,3,1,1,0
18,-2,20,1,1,0
15,22,-7,0,1,1
12,18,-6,0,1,1
59,43,16,1,0,1
-11,9,-20,0,0,0
26,9,17,1,0,1
3,6,-3,0,0,0
52,40,12,1,0,1
35,30,5,1,0,1
-14,5,-19,0,0,0
32,12,20,1,0,1
35,41,-6,0,0,0
-57,-39,-18,0,0,0
-2,1,-3,0,0,0
5,-1,6,1,1,0
-26,-44,18,1,1,0
18,25,-7,0,1,1
33,23,10,1,1,0
34,23,11,1,1,0
21,14,7,1,1,0
17,22,-5,0,1,1
12,-3,15,1,1,0
-26,-7,-19,0,1,1
-35,-33,-2,0,1,1
10,10,0,0,1,1
-20,-23,3,1,1,0
47,32,15,1,1,0
-32,-25,-7,0,1,1
19,21,-2,0,1,1
53,33,20,1,1,0
-2,-5,3,1,1,0
-53,-41,-12,0,0,0
30,14,16,1,0,1
55,42,13,1,0,1
22,26,-4,0,0,0
-3,-23,20,1,0,1
-31,-15,-16,0,0,0
-12,-30,18,1,0,1
-34,-37,3,1,0,1
-33,-22,-11,0,0,0
-44,-35,-9,0,0,0
19,34,-15,0,0,0
8,16,-8,0,0,0
-37,-42,5,1,0,1
-20,-36,16,1,0,1
20,15,5,1,0,1
-15,-32,17,1,0,1
-35,-41,6,1,0,1
0,-4,4,1,0,1
-24,-23,-1,0,0,0
-37,-18,-19,0,0,0
40,32,8,1,0,1
19,29,-10,0,1,1
53,38,15,1,1,0
23,43,-20,0,1,1
-25,-19,-6,0,1,1
26,11,15,1,1,0
19,6,13,1,1,0
-17,-5,-12,0,1,1
34,25,9,1,1,0
22,14,8,1,1,0
-6,-9,3,1,1,0
51,38,13,1,1,0
-35,-37,2,1,1,0
12,27,-15,0,1,1
-1,5,-6,0,1,1
-15,-1,-14,0,0,0
47,43,4,1,0,1
2,3,-1,0,0,0
21,37,-16,0,0,0
7,11,-4,0,0,0
-23,-17,-6,0,0,0
-3,-11,8,1,0,1
7,-5,12,1,0,1
-37,-41,4,1,0,1
50,38,12,1,0,1
0,14,-14,0,0,0
-19,-29,10,1,0,1
-28,-36,8,1,0,1
-46,-32,-14,0,0,0
29,19,10,1,0,1
-26,-43,17,1,0,1
31,17,14,1,0,1
3,-14,17,1,0,1
18,8,10,1,0,1
24,37,-13,0,0,0
-11,-5,-6,0,0,0
-45,-32,-13,0,1,1
-42,-30,-12,0,1,1
13,18,-5,0,1,1
12,21,-9,0,1,1
32,27,5,1,1,0
8,21,-13,0,1,1
-34,-23,-11,0,1,1
29,41,-12,0,1,1
38,38,0,0,1,1
-38,-28,-10,0,1,1
-9,0,-9,0,1,1
53,35,18,1,1,0
18,21,-3,0,1,1
-58,-41,-17,0,1,1
48,43,5,1,1,0
-24,-27,3,1,1,0
-42,-27,-15,0,1,1
-42,-40,-2,0,1,1
9,-9,18,1,1,0
-46,-26,-20,0,1,1
38,20,18,1,1,0
-11,-27,16,1,0,1
32,42,-10,0,0,0
49,36,13,1,0,1
6,23,-17,0,0,0
-9,-12,3,1,0,1
-24,-11,-13,0,0,0
-34,-39,5,1,0,1
-48,-42,-6,0,0,0
25,12,13,1,1,0
45,35,10,1,1,0
29,42,-13,0,1,1
-4,5,-9,0,1,1
14,0,14,1,1,0
-11,-30,19,1,1,0
-21,-9,-12,0,1,1
4,10,-6,0,1,1
-41,-27,-14,0,1,1
16,27,-11,0,1,1
-17,-12,-5,0,1,1
-34,-43,9,1,1,0
-31,-26,-5,0,1,1
-38,-19,-19,0,1,1
39,29,10,1,0,1
23,19,4,1,0,1
-24,-8,-16,0,0,0
35,44,-9,0,0,0
-24,-7,-17,0,0,0
-22,-33,11,1,0,1
-9,5,-14,0,0,0
3,18,-15,0,0,0
-62,-43,-19,0,0,0
-14,-8,-6,0,0,0
3,9,-6,0,0,0
8,27,-19,0,0,0
7,20,-13,0,0,0
49,30,19,1,0,1
-36,-37,1,1,0,1
-54,-44,-10,0,0,0
10,17,-7,0,0,0
4,4,0,0,0,0
8,-1,9,1,0,1
1,-8,9,1,0,1
36,43,-7,0,0,0
7,17,-10,0,1,1
32,17,15,1,1,0
-14,-22,8,1,1,0
27,27,0,0,1,1
-27,-16,-11,0,1,1
31,39,-8,0,1,1
-20,-28,8,1,1,0
-46,-41,-5,0,1,1
-32,-34,2,1,1,0
-6,-2,-4,0,0,0
16,31,-15,0,0,0
3,1,2,1,0,1
-30,-45,15,1,0,1
-31,-13,-18,0,0,0
-22,-11,-11,0,0,0
-23,-15,-8,0,0,0
13,11,2,1,0,1
21,18,3,1,0,1
-28,-29,1,1,1,0
9,-10,19,1,1,0
21,15,6,1,1,0
8,26,-18,0,1,1
37,26,11,1,1,0
33,37,-4,0,1,1
39,40,-1,0,1,1
-45,-36,-9,0,1,1
-16,-33,17,1,1,0
39,34,5,1,1,0
-18,-7,-11,0,1,1
2,-10,12,1,1,0
19,2,17,1,1,0
-7,-9,2,1,1,0
-5,11,-16,0,1,1
-1,-16,15,1,1,0
42,34,8,1,0,1
25,17,8,1,0,1
0,-14,14,1,0,1
29,29,0,0,0,0
43,32,11,1,0,1
-3,1,-4,0,0,0
16,27,-11,0,0,0
-12,-4,-8,0,0,0
-11,-19,8,1,0,1
57,43,14,1,0,1
-33,-45,12,1,0,1
-22,-41,19,1,0,1
25,31,-6,0,0,0
5,-11,16,1,0,1
18,34,-16,0,0,0
-6,-5,-1,0,0,0
33,28,5,1,0,1
24,17,7,1,0,1
45,42,3,1,0,1
-36,-37,1,1,0,1
-38,-32,-6,0,0,0
10,9,1,1,1,0
7,16,-9,0,1,1
40,26,14,1,1,0
8,26,-18,0,1,1
-23,-23,0,0,1,1
55,40,15,1,1,0
-26,-45,19,1,1,0
-6,-17,11,1,1,0
-10,-13,3,1,1,0
16,21,-5,0,1,1
-20,-35,15,1,1,0
-3,-21,18,1,1,0
-4,-24,20,1,1,0
-53,-38,-15,0,1,1
-1,-18,17,1,1,0
23,37,-14,0,1,1
56,40,16,1,1,0
-33,-25,-8,0,1,1
-39,-19,-20,0,1,1
32,16,16,1,0,1
-27,-16,-11,0,0,0
32,37,-5,0,0,0
-49,-37,-12,0,0,0
-12,-7,-5,0,0,0
22,22,0,0,0,0
18,-1,19,1,0,1
6,16,-10,0,0,0
-10,-21,11,1,0,1
-4,-14,10,1,0,1
-40,-31,-9,0,0,0
-6,6,-12,0,0,0
11,16,-5,0,0,0
-25,-5,-20,0,0,0
-18,-5,-13,0,0,0
-23,-19,-4,0,0,0
22,35,-13,0,0,0
0,-11,11,1,0,1
8,25,-17,0,1,1
-9,-17,8,1,1,0
-20,-4,-16,0,1,1
2,-18,20,1,1,0
-43,-26,-17,0,1,1
-1,17,-18,0,1,1
-17,-24,7,1,1,0
-44,-39,-5,0,1,1
31,22,9,1,1,0
36,26,10,1,1,0
-11,-14,3,1,1,0
0,-19,19,1,1,0
-34,-33,-1,0,0,0
-13,-9,-4,0,0,0
-17,0,-17,0,0,0
-21,-6,-15,0,0,0
-18,-21,3,1,0,1
-42,-44,2,1,0,1
-34,-26,-8,0,0,0
-51,-43,-8,0,0,0
31,22,9,1,1,0
-32,-32,0,0,1,1
15,17,-2,0,1,1
2,13,-11,0,1,1
30,20,10,1,1,0
28,28,0,0,1,1
-19,-37,18,1,1,0
23,7,16,1,1,0
29,10,19,1,1,0
-2,-9,7,1,1,0
5,-12,17,1,1,0
45,34,11,1,1,0
16,19,-3,0,1,1
-37,-42,5,1,1,0
-10,0,-10,0,1,1
23,5,18,1,0,1
-10,1,-11,0,0,0
24,14,10,1,0,1
-52,-32,-20,0,0,0
-28,-24,-4,0,0,0
-58,-42,-16,0,0,0
27,12,15,1,0,1
-47,-29,-18,0,0,0
9,-6,15,1,0,1
-13,-10,-3,0,1,1
6,-1,7,1,1,0
-19,-9,-10,0,1,1
50,35,15,1,1,0
3,-4,7,1,1,0
0,-10,10,1,1,0
37,28,9,1,1,0
-10,-10,0,0,1,1
46,29,17,1,1,0
35,33,2,1,1,0
-8,-16,8,1,1,0
4,3,1,1,1,0
8,27,-19,0,1,1
-24,-27,3,1,1,0
29,29,0,0,1,1
-56,-43,-13,0,1,1
-34,-27,-7,0,1,1
-29,-28,-1,0,1,1
-26,-7,-19,0,1,1
34,14,20,1,1,0
11,0,11,1,0,1
-60,-40,-20,0,0,0
-4,-8,4,1,0,1
-26,-12,-14,0,0,0
31,19,12,1,0,1
49,41,8,1,0,1
-28,-21,-7,0,0,0
33,16,17,1,0,1
-42,-22,-20,0,0,0
-1,12,-13,0,0,0
-17,-14,-3,0,0,0
37,19,18,1,0,1
12,14,-2,0,0,0
-48,-40,-8,0,0,0
-20,-9,-11,0,0,0
9,-4,13,1,0,1
11,19,-8,0,0,0
-21,-26,5,1,0,1
-31,-44,13,1,1,0
30,14,16,1,1,0
48,34,14,1,1,0
-23,-38,15,1,1,0
10,-4,14,1,1,0
-15,-33,18,1,1,0
19,27,-8,0,1,1
-50,-31,-19,0,1,1
25,22,3,1,1,0
14,12,2,1,1,0
32,37,-5,0,1,1
49,40,9,1,1,0
-35,-42,7,1,1,0
-6,-4,-2,0,1,1
-7,-17,10,1,1,0
21,13,8,1,1,0
23,3,20,1,1,0
-20,-15,-5,0,1,1
-2,-17,15,1,0,1
-2,-7,5,1,0,1
21,36,-15,0,0,0
-22,-20,-2,0,0,0
53,35,18,1,0,1
5,23,-18,0,0,0
-39,-42,3,1,0,1
-35,-32,-3,0,0,0
9,21,-12,0,0,0
30,43,-13,0,1,1
24,40,-16,0,1,1
-19,0,-19,0,1,1
12,-2,14,1,1,0
2,9,-7,0,1,1
-36,-18,-18,0,1,1
42,30,12,1,1,0
61,44,17,1,1,0
-31,-36,5,1,0,1
33,22,11,1,0,1
-15,-34,19,1,0,1
-40,-27,-13,0,0,0
-39,-31,-8,0,0,0
45,27,18,1,0,1
-16,-31,15,1,0,1
-41,-31,-10,0,0,0
-49,-39,-10,0,0,0
-12,-24,12,1,0,1
44,34,10,1,0,1
-57,-42,-15,0,0,0
46,29,17,1,0,1
-22,-38,16,1,0,1
19,16,3,1,1,0
27,38,-11,0,1,1
41,35,6,1,1,0
-22,-6,-16,0,1,1
-37,-25,-12,0,1,1
7,-7,14,1,1,0
-5,-15,10,1,1,0
39,40,-1,0,1,1
11,3,8,1,1,0
-42,-37,-5,0,1,1
31,11,20,1,1,0
-19,-26,7,1,1,0
14,12,2,1,1,0
38,24,14,1,1,0
-30,-14,-16,0,1,1
9,27,-18,0,1,1
59,44,15,1,1,0
4,20,-16,0,1,1
40,32,8,1,1,0
-5,-3,-2,0,1,1
4,8,-4,0,1,1
34,27,7,1,0,1
-58,-41,-17,0,0,0
-3,-15,12,1,0,1
-44,-35,-9,0,0,0
42,24,18,1,0,1
20,32,-12,0,0,0
-9,-22,13,1,0,1
35,42,-7,0,0,0
-34,-19,-15,0,0,0
-5,-17,12,1,0,1
-28,-12,-16,0,0,0
17,33,-16,0,0,0
-37,-26,-11,0,0,0
-47,-37,-10,0,0,0
22,23,-1,0,0,0
26,39,-13,0,0,0
-4,-20,16,1,0,1
13,12,1,1,1,0
-42,-26,-16,0,1,1
-26,-43,17,1,1,0
57,38,19,1,1,0
46,31,15,1,1,0
-24,-9,-15,0,1,1
27,24,3,1,1,0
-30,-27,-3,0,1,1
-24,-19,-5,0,1,1
22,10,12,1,1,0
42,29,13,1,1,0
-2,-1,-1,0,1,1
27,30,-3,0,1,1
-3,-20,17,1,1,0
-24,-37,13,1,1,0
0,-7,7,1,1,0
27,42,-15,0,1,1
42,24,18,1,1,0
47,42,5,1,1,0
28,28,0,0,1,1
25,44,-19,0,1,1
-5,-8,3,1,0,1
-50,-44,-6,0,0,0
-38,-28,-10,0,0,0
-43,-41,-2,0,0,0
17,9,8,1,0,1
50,30,20,1,0,1
40,37,3,1,0,1
-36,-18,-18,0,0,0
-39,-27,-12,0,0,0
-39,-20,-19,0,0,0
25,37,-12,0,0,0
-38,-43,5,1,0,1
-23,-41,18,1,0,1
12,21,-9,0,1,1
-28,-27,-1,0,1,1
-21,-23,2,1,1,0
23,40,-17,0,1,1
13,8,5,1,1,0
46,44,2,1,1,0
-22,-5,-17,0,1,1
21,14,7,1,1,0
-5,-5,0,0,1,1
55,38,17,1,1,0
-23,-27,4,1,1,0
34,15,19,1,1,0
45,43,2,1,1,0
36,35,1,1,1,0
-38,-32,-6,0,1,1
59,43,16,1,1,0
21,33,-12,0,0,0
-3,0,-3,0,0,0
-11,-14,3,1,0,1
17,6,11,1,0,1
-18,-24,6,1,0,1
-43,-41,-2,0,0,0
-31,-11,-20,0,0,0
-46,-39,-7,0,0,0
5,-8,13,1,0,1
32,29,3,1,1,0
-44,-31,-13,0,1,1
-35,-39,4,1,1,0
25,39,-14,0,1,1
10,29,-19,0,1,1
20,7,13,1,1,0
-49,-34,-15,0,1,1
-29,-32,3,1,1,0
10,0,10,1,1,0
-3,-20,17,1,1,0
21,31,-10,0,1,1
-30,-20,-10,0,1,1
5,-5,10,1,1,0
4,-7,11,1,1,0
-21,-20,-1,0,1,1
-7,2,-9,0,1,1
-62,-45,-17,0,1,1
-19,-29,10,1,1,0
37,29,8,1,1,0
9,-8,17,1,1,0
-12,-9,-3,0,1,1
-43,-27,-16,0,0,0
-35,-23,-12,0,0,0
-33,-41,8,1,0,1
-12,7,-19,0,0,0
-13,3,-16,0,0,0
34,20,14,1,0,1
-12,-23,11,1,0,1
5,13,-8,0,0,0
-10,8,-18,0,0,0
50,40,10,1,0,1
17,37,-20,0,0,0
-12,-19,7,1,0,1
9,6,3,1,0,1
22,3,19,1,0,1
12,15,-3,0,0,0
-48,-39,-9,0,0,0
-38,-24,-14,0,0,0
-39,-26,-13,0,0,0
29,36,-7,0,0,0
-40,-45,5,1,0,1
1,11,-10,0,0,0
33,28,5,1,1,0
-2,11,-13,0,1,1
42,40,2,1,1,0
-55,-38,-17,0,1,1
24,10,14,1,1,0
-58,-39,-19,0,1,1
-17,-18,1,1,1,0
-34,-25,-9,0,1,1
-7,0,-7,0,1,1
-5,10,-15,0,1,1
-10,8,-18,0,0,0
8,-3,11,1,0,1
21,26,-5,0,0,0
-31,-16,-15,0,0,0
-6,-22,16,1,0,1
-52,-33,-19,0,0,0
-30,-13,-17,0,0,0
39,41,-2,0,0,0
-2,13,-15,0,0,0
-16,-12,-4,0,0,0
-31,-38,7,1,0,1
1,13,-12,0,0,0
-23,-29,6,1,0,1
4,-6,10,1,0,1
3,-10,13,1,0,1
40,41,-1,0,0,0
-20,-6,-14,0,0,0
-32,-13,-19,0,0,0
-2,3,-5,0,0,0
-48,-44,-4,0,0,0
-37,-20,-17,0,0,0
-47,-31,-16,0,1,1
-39,-38,-1,0,1,1
-23,-36,13,1,1,0
19,17,2,1,1,0
-52,-41,-11,0,1,1
20,22,-2,0,1,1
-20,-22,2,1,1,0
-23,-32,9,1,1,0
28,30,-2,0,1,1
30,18,12,1,1,0
12,9,3,1,1,0
-10,6,-16,0,1,1
-9,-8,-1,0,1,1
-35,-22,-13,0,1,1
26,37,-11,0,1,1
8,12,-4,0,1,1
-6,-16,10,1,0,1
5,-2,7,1,0,1
37,40,-3,0,0,0
40,30,10,1,0,1
26,27,-1,0,0,0
-47,-37,-10,0,0,0
8,16,-8,0,0,0
-30,-38,8,1,0,1
-35,-39,4,1,0,1
25,12,13,1,1,0
-8,-12,4,1,1,0
10,4,6,1,1,0
47,35,12,1,1,0
29,41,-12,0,1,1
10,16,-6,0,1,1
8,22,-14,0,1,1
-4,-20,16,1,1,0
0,-10,10,1,0,1
22,35,-13,0,0,0
-26,-36,10,1,0,1
-21,-16,-5,0,0,0
-10,-7,-3,0,0,0
25,31,-6,0,0,0
12,3,9,1,0,1
11,-5,16,1,0,1
-9,10,-19,0,1,1
-45,-44,-1,0,1,1
-33,-34,1,1,1,0
-38,-35,-3,0,1,1
22,21,1,1,1,0
27,41,-14,0,1,1
11,23,-12,0,1,1
-12,6,-18,0,1,1
-10,-26,16,1,1,0
-62,-42,-20,0,1,1
-2,4,-6,0,1,1
-7,-24,17,1,1,0
6,16,-10,0,0,0
39,31,8,1,0,1
25,17,8,1,0,1
-37,-40,3,1,0,1
30,12,18,1,0,1
-17,-36,19,1,0,1
-27,-30,3,1,0,1
-22,-17,-5,0,0,0
-4,-20,16,1,0,1
-6,13,-19,0,0,0
-18,-27,9,1,0,1
-18,-25,7,1,0,1
15,31,-16,0,0,0
50,33,17,1,0,1
7,24,-17,0,1,1
59,43,16,1,1,0
-40,-22,-18,0,1,1
-24,-42,18,1,1,0
-48,-31,-17,0,1,1
-56,-45,-11,0,1,1
37,44,-7,0,1,1
2,-4,6,1,1,0
33,41,-8,0,1,1
38,43,-5,0,1,1
-8,-23,15,1,1,0
-10,2,-12,0,0,0
-31,-13,-18,0,0,0
-20,-34,14,1,0,1
-3,-8,5,1,0,1
-18,-13,-5,0,0,0
9,-6,15,1,0,1
-42,-42,0,0,0,0
-28,-14,-14,0,0,0
-44,-36,-8,0,0,0
-19,-9,-10,0,0,0
9,15,-6,0,0,0
-33,-43,10,1,0,1
26,38,-12,0,0,0
-21,-26,5,1,0,1
-21,-10,-11,0,0,0
8,-5,13,1,0,1
30,12,18,1,0,1
-12,-32,20,1,0,1
43,23,20,1,0,1
35,36,-1,0,0,0
7,23,-16,0,0,0
63,44,19,1,1,0
53,44,9,1,1,0
13,29,-16,0,1,1
0,2,-2,0,1,1
-42,-29,-13,0,1,1
25,19,6,1,1,0
33,23,10,1,1,0
17,-1,18,1,1,0
25,20,5,1,1,0
44,42,2,1,1,0
35,30,5,1,1,0
45,44,1,1,1,0
-17,-19,2,1,1,0
-17,-6,-11,0,1,1
-48,-35,-13,0,1,1
-16,-30,14,1,1,0
-6,-15,9,1,1,0
-18,0,-18,0,1,1
28,8,20,1,1,0
-24,-27,3,1,1,0
-27,-25,-2,0,0,0
38,20,18,1,0,1
4,-4,8,1,0,1
-8,-19,11,1,0,1
-16,-18,2,1,0,1
-25,-27,2,1,0,1
-2,1,-3,0,0,0
-42,-38,-4,0,0,0
32,38,-6,0,0,0
11,6,5,1,0,1
4,2,2,1,0,1
-28,-37,9,1,0,1
44,29,15,1,0,1
28,11,17,1,0,1
-4,-13,9,1,0,1
18,13,5,1,0,1
16,27,-11,0,0,0
64,44,20,1,0,1
30,15,15,1,0,1
15,10,5,1,1,0
-19,-15,-4,0,1,1
-52,-36,-16,0,1,1
-38,-32,-6,0,1,1
41,24,17,1,1,0
34,42,-8,0,1,1
10,16,-6,0,1,1
0,3,-3,0,1,1
-59,-40,-19,0,1,1
5,2,3,1,1,0
51,32,19,1,1,0
-48,-42,-6,0,1,1
44,44,0,0,1,1
3,7,-4,0,1,1
3,12,-9,0,1,1
-6,-16,10,1,1,0
43,43,0,0,1,1
21,8,13,1,1,0
-57,-39,-18,0,1,1
-18,-12,-6,0,1,1
-30,-28,-2,0,1,1
21,15,6,1,0,1
-39,-26,-13,0,0,0
-46,-31,-15,0,0,0
-25,-23,-2,0,0,0
56,37,19,1,0,1
-58,-44,-14,0,0,0
4,-13,17,1,0,1
-20,-38,18,1,0,1
9,26,-17,0,0,0
-15,-10,-5,0,0,0
-50,-34,-16,0,0,0
-48,-45,-3,0,0,0
27,15,12,1,0,1
-15,-22,7,1,0,1
34,14,20,1,0,1
19,38,-19,0,0,0
-1,13,-14,0,0,0
15,13,2,1,0,1
-10,0,-10,0,0,0
-16,-26,10,1,0,1
10,-8,18,1,0,1
1,6,-5,0,1,1
-39,-28,-11,0,1,1
26,6,20,1,1,0
-10,-8,-2,0,1,1
29,44,-15,0,1,1
4,-14,18,1,1,0
-5,-21,16,1,1,0
-16,-33,17,1,1,0
21,15,6,1,1,0
41,28,13,1,1,0
-1,2,-3,0,1,1
18,0,18,1,1,0
-31,-28,-3,0,1,1
48,42,6,1,1,0
-4,-5,1,1,1,0
-39,-35,-4,0,1,1
-19,-9,-10,0,1,1
52,36,16,1,1,0
19,32,-13,0,1,1
33,41,-8,0,1,1
7,25,-18,0,1,1
29,20,9,1,0,1
33,28,5,1,0,1
18,15,3,1,0,1
0,-11,11,1,0,1
42,41,1,1,0,1
-43,-27,-16,0,0,0
34,32,2,1,0,1
-6,-26,20,1,0,1
52,44,8,1,1,0
28,8,20,1,1,0
-25,-5,-20,0,1,1
-26,-36,10,1,1,0
26,14,12,1,1,0
43,42,1,1,1,0
-48,-35,-13,0,1,1
17,-1,18,1,1,0
3,11,-8,0,1,1
-6,-26,20,1,1,0
-17,-23,6,1,1,0
-16,-21,5,1,1,0
-39,-32,-7,0,1,1
-13,3,-16,0,0,0
0,0,0,0,0,0
-20,-3,-17,0,0,0
-56,-43,-13,0,0,0
21,30,-9,0,0,0
50,37,13,1,0,1
-51,-40,-11,0,0,0
41,32,9,1,0,1
-28,-21,-7,0,1,1
-61,-45,-16,0,1,1
26,40,-14,0,1,1
21,15,6,1,1,0
-35,-42,7,1,1,0
3,2,1,1,1,0
-21,-10,-11,0,1,1
5,-7,12,1,1,0
60,40,20,1,1,0
44,33,11,1,1,0
-27,-15,-12,0,1,1
0,10,-10,0,1,1
23,13,10,1,1,0
54,39,15,1,1,0
18,6,12,1,1,0
-30,-20,-10,0,1,1
33,16,17,1,0,1
-19,-1,-18,0,0,0
51,37,14,1,0,1
27,12,15,1,0,1
-25,-18,-7,0,0,0
-11,-9,-2,0,0,0
30,18,12,1,0,1
22,40,-18,0,0,0
-56,-36,-20,0,0,0
-15,-12,-3,0,1,1
31,31,0,0,1,1
27,31,-4,0,1,1
-38,-40,2,1,1,0
-16,-5,-11,0,1,1
41,33,8,1,1,0
-55,-43,-12,0,1,1
26,16,10,1,1,0
4,-6,10,1,0,1
-25,-38,13,1,0,1
25,27,-2,0,0,0
-45,-44,-1,0,0,0
-25,-21,-4,0,0,0
1,10,-9,0,0,0
-28,-37,9,1,0,1
3,3,0,0,0,0
-1,6,-7,0,0,0
32,39,-7,0,0,0
-2,4,-6,0,1,1
-5,14,-19,0,1,1
-17,2,-19,0,1,1
-55,-37,-18,0,1,1
33,23,10,1,1,0
-38,-31,-7,0,1,1
-3,-13,10,1,1,0
27,38,-11,0,1,1
62,44,18,1,1,0
10,25,-15,0,1,1
-39,-40,1,1,1,0
-30,-28,-2,0,1,1
18,35,-17,0,1,1
-11,-23,12,1,1,0
-24,-24,0,0,1,1
-10,-9,-1,0,1,1
-23,-39,16,1,1,0
-40,-38,-2,0,1,1
-17,-17,0,0,1,1
-19,-32,13,1,1,0
-28,-13,-15,0,1,1
-35,-45,10,1,0,1
4,-14,18,1,0,1
-62,-42,-20,0,0,0
-6,12,-18,0,0,0
-15,2,-17,0,0,0
13,13,0,0,0,0
17,30,-13,0,0,0
-15,-6,-9,0,0,0
18,8,10,1,0,1
0,-8,8,1,0,1
-39,-25,-14,0,1,1
38,30,8,1,1,0
48,44,4,1,1,0
-44,-44,0,0,1,1
2,16,-14,0,1,1
22,3,19,1,1,0
8,4,4,1,1,0
18,23,-5,0,1,1
32,42,-10,0,1,1
35,40,-5,0,0,0
-14,-22,8,1,0,1
5,-1,6,1,0,1
-27,-45,18,1,0,1
4,-1,5,1,0,1
-11,-22,11,1,0,1
-40,-22,-18,0,0,0
-3,-18,15,1,0,1
2,3,-1,0,0,0
-43,-44,1,1,0,1
-1,3,-4,0,0,0
11,5,6,1,0,1
-42,-23,-19,0,0,0
-23,-28,5,1,0,1
-35,-37,2,1,0,1
39,42,-3,0,0,0
7,13,-6,0,0,0
-21,-2,-19,0,0,0
-23,-28,5,1,0,1
-8,2,-10,0,0,0
-5,-9,4,1,0,1
12,1,11,1,1,0
-19,1,-20,0,1,1
33,13,20,1,1,0
-9,-17,8,1,1,0
-46,-29,-17,0,1,1
-30,-32,2,1,1,0
29,29,0,0,1,1
8,25,-17,0,1,1
-16,-19,3,1,1,0
-27,-13,-14,0,1,1
31,39,-8,0,1,1
24,27,-3,0,1,1
7,-1,8,1,1,0
7,4,3,1,1,0
62,43,19,1,0,1
1,2,-1,0,0,0
29,32,-3,0,0,0
-6,-26,20,1,0,1
-5,-4,-1,0,0,0
34,44,-10,0,0,0
-36,-21,-15,0,0,0
2,-7,9,1,0,1
-21,-33,12,1,0,1
12,27,-15,0,0,0
-32,-12,-20,0,0,0
-41,-35,-6,0,0,0
-8,-22,14,1,1,0
36,20,16,1,1,0
-16,-14,-2,0,1,1
6,20,-14,0,1,1
22,35,-13,0,1,1
1,11,-10,0,1,1
-26,-23,-3,0,1,1
22,14,8,1,1,0
1,4,-3,0,1,1
-38,-25,-13,0,1,1
-24,-5,-19,0,1,1
21,39,-18,0,1,1
37,43,-6,0,1,1
-22,-18,-4,0,1,1
-15,-14,-1,0,1,1
-47,-37,-10,0,1,1
0,-1,1,1,1,0
-10,6,-16,0,1,1
-20,-38,18,1,1,0
-21,-28,7,1,0,1
-9,-7,-2,0,0,0
0,-20,20,1,0,1
-24,-7,-17,0,0,0
-15,5,-20,0,0,0
-41,-44,3,1,0,1
-30,-32,2,1,0,1
-56,-40,-16,0,0,0
-47,-45,-2,0,0,0
-58,-39,-19,0,0,0
25,29,-4,0,1,1
-24,-28,4,1,1,0
32,23,9,1,1,0
-58,-39,-19,0,1,1
19,4,15,1,1,0
-55,-42,-13,0,1,1
-12,-21,9,1,1,0
-13,-1,-12,0,1,1
-44,-29,-15,0,1,1
5,1,4,1,1,0
-44,-45,1,1,1,0
-33,-45,12,1,1,0
-2,-16,14,1,1,0
29,42,-13,0,1,1
-24,-28,4,1,1,0
-23,-4,-19,0,1,1
10,9,1,1,0,1
-18,-28,10,1,0,1
-30,-23,-7,0,0,0
-18,-14,-4,0,0,0
10,4,6,1,0,1
-35,-30,-5,0,0,0
54,41,13,1,0,1
-1,-16,15,1,0,1
-6,3,-9,0,0,0
-10,-14,4,1,0,1
-5,5,-10,0,0,0
30,28,2,1,0,1
-40,-26,-14,0,0,0
-23,-38,15,1,0,1
-13,-28,15,1,1,0
24,24,0,0,1,1
-39,-34,-5,0,1,1
-11,-28,17,1,1,0
-32,-42,10,1,1,0
20,27,-7,0,1,1
-18,-2,-16,0,1,1
-23,-5,-18,0,1,1
7,23,-16,0,1,1
1,-13,14,1,1,0
-5,-20,15,1,1,0
5,2,3,1,0,1
-32,-19,-13,0,0,0
18,22,-4,0,0,0
-21,-1,-20,0,0,0
-34,-30,-4,0,0,0
-8,-1,-7,0,0,0
3,-10,13,1,0,1
10,22,-12,0,0,0
36,34,2,1,0,1
48,42,6,1,0,1
18,35,-17,0,0,0
24,44,-20,0,0,0
-37,-20,-17,0,0,0
41,32,9,1,0,1
41,40,1,1,0,1
27,41,-14,0,0,0
34,40,-6,0,0,0
-25,-16,-9,0,0,0
-32,-35,3,1,0,1
26,8,18,1,0,1
-30,-26,-4,0,0,0
-6,11,-17,0,1,1
-1,-8,7,1,1,0
-26,-45,19,1,1,0
10,-9,19,1,1,0
-11,3,-14,0,1,1
-38,-38,0,0,1,1
-16,-7,-9,0,1,1
-22,-5,-17,0,1,1
16,-2,18,1,1,0
57,42,15,1,0,1
-8,-2,-6,0,0,0
-19,-8,-11,0,0,0
-32,-20,-12,0,0,0
-40,-24,-16,0,0,0
-3,-2,-1,0,0,0
22,36,-14,0,0,0
-21,-34,13,1,0,1
43,30,13,1,0,1
-6,-24,18,1,0,1
-40,-29,-11,0,0,0
-4,7,-11,0,0,0
25,26,-1,0,0,0
19,20,-1,0,0,0
4,11,-7,0,0,0
23,31,-8,0,0,0
40,30,10,1,0,1
28,37,-9,0,0,0
28,33,-5,0,0,0
-32,-28,-4,0,0,0
-15,4,-19,0,0,0
57,41,16,1,1,0
-34,-29,-5,0,1,1
14,12,2,1,1,0
-24,-15,-9,0,1,1
-43,-24,-19,0,1,1
-1,-8,7,1,1,0
-50,-44,-6,0,1,1
34,24,10,1,1,0
-28,-15,-13,0,0,0
2,11,-9,0,0,0
-33,-18,-15,0,0,0
39,24,15,1,0,1
38,29,9,1,0,1
2,-5,7,1,0,1
22,9,13,1,0,1
-8,-16,8,1,0,1
33,17,16,1,0,1
-35,-26,-9,0,0,0
-16,-29,13,1,0,1
25,13,12,1,0,1
-14,-30,16,1,0,1
6,-2,8,1,0,1
-38,-21,-17,0,0,0
-19,-16,-3,0,0,0
30,34,-4,0,0,0
-45,-39,-6,0,1,1
26,6,20,1,1,0
8,-5,13,1,1,0
-52,-32,-20,0,1,1
-35,-35,0,0,1,1
-17,-8,-9,0,1,1
11,27,-16,0,1,1
34,32,2,1,1,0
-48,-37,-11,0,1,1
-27,-22,-5,0,1,1
23,31,-8,0,1,1
20,36,-16,0,1,1
-46,-42,-4,0,1,1
-12,-8,-4,0,1,1
-64,-44,-20,0,0,0
4,15,-11,0,0,0
16,29,-13,0,0,0
19,10,9,1,0,1
-36,-30,-6,0,0,0
-48,-37,-11,0,0,0
-5,10,-15,0,0,0
-26,-25,-1,0,0,0
-26,-7,-19,0,0,0
-55,-37,-18,0,0,0
-43,-42,-1,0,0,0
-32,-33,1,1,0,1
-52,-35,-17,0,0,0
-16,-29,13,1,1,0
30,25,5,1,1,0
-1,-1,0,0,1,1
18,37,-19,0,1,1
-19,-20,1,1,1,0
22,17,5,1,1,0
16,3,13,1,1,0
8,23,-15,0,1,1
-54,-42,-12,0,0,0
40,44,-4,0,0,0
14,3,11,1,0,1
36,20,16,1,0,1
39,28,11,1,0,1
53,43,10,1,0,1
-35,-34,-1,0,0,0
-12,-28,16,1,0,1
-9,8,-17,0,0,0
3,12,-9,0,0,0
20,23,-3,0,0,0
-13,-4,-9,0,0,0
41,24,17,1,0,1
-4,-14,10,1,0,1
33,44,-11,0,0,0
-39,-37,-2,0,1,1
-12,-17,5,1,1,0
-49,-35,-14,0,1,1
8,19,-11,0,1,1
27,11,16,1,1,0
50,36,14,1,1,0
37,41,-4,0,1,1
4,-2,6,1,1,0
-21,-4,-17,0,1,1
-18,-27,9,1,1,0
-11,-3,-8,0,0,0
4,-7,11,1,0,1
-51,-40,-11,0,0,0
37,32,5,1,0,1
-28,-41,13,1,0,1
-38,-38,0,0,0,0
-51,-34,-17,0,0,0
-29,-19,-10,0,0,0
29,20,9,1,0,1
29,18,11,1,0,1
49,44,5,1,1,0
-23,-40,17,1,1,0
-19,-38,19,1,1,0
-35,-25,-10,0,1,1
-30,-43,13,1,1,0
-47,-28,-19,0,1,1
-3,0,-3,0,1,1
-3,-17,14,1,1,0
-1,-20,19,1,1,0
-22,-9,-13,0,1,1
-13,-14,1,1,1,0
-11,7,-18,0,1,1
36,39,-3,0,0,0
3,22,-19,0,0,0
57,42,15,1,0,1
27,26,1,1,0,1
-41,-30,-11,0,0,0
-50,-33,-17,0,0,0
21,33,-12,0,0,0
-19,-30,11,1,0,1
-10,4,-14,0,0,0
-11,-13,2,1,0,1
29,20,9,1,0,1
42,30,12,1,0,1
24,32,-8,0,0,0
-25,-42,17,1,0,1
17,14,3,1,0,1
27,13,14,1,0,1
-24,-21,-3,0,0,0
53,37,16,1,0,1
-6,7,-13,0,0,0
-11,-21,10,1,0,1
20,12,8,1,0,1
13,-1,14,1,1,0
18,9,9,1,1,0
54,43,11,1,1,0
24,6,18,1,1,0
35,25,10,1,1,0
52,34,18,1,1,0
-13,-27,14,1,1,0
16,27,-11,0,1,1
-19,-39,20,1,1,0
-27,-38,11,1,1,0
24,19,5,1,1,0
-31,-31,0,0,1,1
22,41,-19,0,1,1
9,12,-3,0,0,0
27,44,-17,0,0,0
46,41,5,1,0,1
-5,-19,14,1,0,1
-14,-13,-1,0,0,0
14,2,12,1,0,1
-50,-42,-8,0,0,0
40,35,5,1,0,1
-1,4,-5,0,0,0
-5,-12,7,1,0,1
12,32,-20,0,0,0
-30,-11,-19,0,0,0
22,41,-19,0,0,0
50,38,12,1,0,1
8,1,7,1,1,0
-15,5,-20,0,1,1
-1,5,-6,0,1,1
-43,-45,2,1,1,0
3,14,-11,0,1,1
-5,-14,9,1,1,0
-14,-5,-9,0,1,1
-1,-12,11,1,1,0
8,19,-11,0,1,1
-5,7,-12,0,1,1
23,14,9,1,1,0
-34,-25,-9,0,1,1
-16,-16,0,0,1,1
31,20,11,1,1,0
60,42,18,1,1,0
-16,-6,-10,0,1,1
11,30,-19,0,1,1
19,26,-7,0,1,1
20,17,3,1,1,0
2,3,-1,0,1,1
21,33,-12,0,1,1
-55,-36,-19,0,0,0
10,-1,11,1,0,1
8,-8,16,1,0,1
-5,-8,3,1,0,1
-58,-42,-16,0,0,0
42,38,4,1,0,1
-32,-19,-13,0,0,0
16,-2,18,1,0,1
46,40,6,1,0,1
5,-13,18,1,0,1
25,19,6,1,1,0
14,0,14,1,1,0
-19,-16,-3,0,1,1
-16,-6,-10,0,1,1
30,22,8,1,1,0
-51,-32,-19,0,1,1
23,33,-10,0,1,1
22,2,20,1,1,0
-10,-4,-6,0,0,0
46,37,9,1,0,1
15,-4,19,1,0,1
-20,-3,-17,0,0,0
-25,-17,-8,0,0,0
-39,-31,-8,0,0,0
-24,-16,-8,0,0,0
-1,9,-10,0,0,0
44,34,10,1,0,1
30,32,-2,0,0,0
57,40,17,1,0,1
-34,-28,-6,0,0,0
12,5,7,1,0,1
-33,-32,-1,0,0,0
53,43,10,1,0,1
-28,-25,-3,0,0,0
26,28,-2,0,0,0
-28,-25,-3,0,0,0
28,28,0,0,0,0
10,-10,20,1,1,0
-17,-1,-16,0,1,1
18,32,-14,0,1,1
-12,-22,10,1,1,0
-3,1,-4,0,1,1
31,19,12,1,1,0
-7,-9,2,1,1,0
-33,-37,4,1,1,0
2,13,-11,0,1,1
-41,-21,-20,0,0,0
4,5,-1,0,0,0
-21,-23,2,1,0,1
18,36,-18,0,0,0
-17,-1,-16,0,0,0
37,36,1,1,0,1
48,44,4,1,0,1
-41,-37,-4,0,0,0
13,13,0,0,0,0
30,28,2,1,0,1
-25,-36,11,1,0,1
20,8,12,1,0,1
-34,-38,4,1,0,1
-18,-22,4,1,0,1
-30,-11,-19,0,0,0
-25,-35,10,1,0,1
34,34,0,0,0,0
-22,-33,11,1,0,1
39,29,10,1,1,0
20,4,16,1,1,0
-19,-4,-15,0,1,1
14,4,10,1,1,0
40,22,18,1,1,0
-6,-4,-2,0,1,1
32,17,15,1,1,0
-11,-31,20,1,1,0
41,42,-1,0,1,1
23,14,9,1,1,0
-59,-39,-20,0,1,1
17,14,3,1,0,1
-49,-36,-13,0,0,0
7,20,-13,0,0,0
23,25,-2,0,0,0
25,20,5,1,0,1
-25,-14,-11,0,0,0
7,5,2,1,0,1
-51,-41,-10,0,0,0
-17,-13,-4,0,0,0
-36,-33,-3,0,0,0
55,40,15,1,0,1
44,36,8,1,0,1
37,36,1,1,0,1
-26,-12,-14,0,0,0
-29,-45,16,1,0,1
6,19,-13,0,0,0
-25,-17,-8,0,0,0
-43,-36,-7,0,1,1
8,-9,17,1,1,0
16,5,11,1,1,0
55,35,20,1,1,0
20,39,-19,0,1,1
16,11,5,1,1,0
30,13,17,1,1,0
15,-2,17,1,1,0
3,-17,20,1,1,0
-20,-1,-19,0,1,1
7,-5,12,1,1,0
-4,3,-7,0,1,1
43,43,0,0,1,1
36,23,13,1,1,0
-49,-45,-4,0,1,1
-6,-1,-5,0,1,1
-24,-36,12,1,1,0
-48,-39,-9,0,1,1
10,8,2,1,1,0
40,30,10,1,1,0
38,31,7,1,0,1
9,5,4,1,0,1
27,29,-2,0,0,0
19,8,11,1,0,1
-1,-18,17,1,0,1
4,24,-20,0,0,0
-14,-28,14,1,0,1
-17,-29,12,1,0,1
0,-13,13,1,0,1
-25,-30,5,1,0,1
8,7,1,1,0,1
11,23,-12,0,0,0
14,2,12,1,0,1
-12,-4,-8,0,0,0
3,-15,18,1,0,1
-37,-39,2,1,1,0
-2,17,-19,0,1,1
34,16,18,1,1,0
42,44,-2,0,1,1
42,28,14,1,1,0
-47,-35,-12,0,1,1
8,27,-19,0,1,1
29,23,6,1,1,0
54,34,20,1,1,0
-45,-36,-9,0,1,1
-16,-14,-2,0,0,0
-51,-39,-12,0,0,0
7,-9,16,1,0,1
57,40,17,1,0,1
13,23,-10,0,0,0
42,39,3,1,0,1
-9,-26,17,1,0,1
15,-3,18,1,0,1
40,23,17,1,0,1
-2,-16,14,1,0,1
35,18,17,1,1,0
-2,-22,20,1,1,0
-20,-28,8,1,1,0
-3,-14,11,1,1,0
27,38,-11,0,1,1
21,25,-4,0,1,1
-37,-28,-9,0,1,1
0,-4,4,1,1,0
-33,-30,-3,0,1,1
-40,-20,-20,0,1,1
44,35,9,1,1,0
50,31,19,1,1,0
24,26,-2,0,1,1
-6,-11,5,1,1,0
-22,-2,-20,0,1,1
-9,-2,-7,0,1,1
31,15,16,1,1,0
-8,5,-13,0,1,1
32,32,0,0,1,1
19,35,-16,0,1,1
44,42,2,1,1,0
11,-6,17,1,0,1
-12,-11,-1,0,0,0
12,32,-20,0,0,0
30,16,14,1,0,1
-7,-5,-2,0,0,0
4,22,-18,0,0,0
-6,-9,3,1,0,1
-15,3,-18,0,0,0
6,12,-6,0,0,0
41,42,-1,0,0,0
-12,4,-16,0,1,1
-18,-10,-8,0,1,1
46,40,6,1,1,0
10,10,0,0,1,1
30,33,-3,0,1,1
23,25,-2,0,1,1
-49,-45,-4,0,1,1
4,4,0,0,1,1
31,26,5,1,1,0
23,39,-16,0,1,1
35,25,10,1,1,0
8,-2,10,1,1,0
-10,-9,-1,0,1,1
-3,-6,3,1,1,0
35,28,7,1,1,0
46,43,3,1,1,0
16,34,-18,0,1,1
-4,-15,11,1,1,0
-13,-30,17,1,1,0
8,6,2,1,1,0
-7,6,-13,0,1,1
41,22,19,1,0,1
8,-5,13,1,0,1
36,16,20,1,0,1
-38,-38,0,0,0,0
-3,-7,4,1,0,1
21,15,6,1,0,1
46,27,19,1,0,1
-45,-41,-4,0,0,0
38,22,16,1,1,0
3,5,-2,0,1,1
-4,-14,10,1,1,0
16,29,-13,0,1,1
-4,-10,6,1,1,0
39,39,0,0,1,1
-3,2,-5,0,1,1
43,33,10,1,1,0
36,28,8,1,1,0
-30,-42,12,1,1,0
-39,-23,-16,0,1,1
-30,-15,-15,0,1,1
8,9,-1,0,0,0
-30,-11,-19,0,0,0
6,-7,13,1,0,1
-38,-28,-10,0,0,0
26,14,12,1,0,1
5,0,5,1,0,1
31,29,2,1,0,1
-14,-9,-5,0,0,0
46,33,13,1,0,1
7,24,-17,0,0,0
-16,-4,-12,0,0,0
3,-16,19,1,0,1
4,-4,8,1,0,1
-17,-11,-6,0,0,0
-18,-9,-9,0,1,1
-27,-8,-19,0,1,1
40,32,8,1,1,0
21,16,5,1,1,0
43,28,15,1,1,0
17,3,14,1,1,0
13,14,-1,0,1,1
-35,-41,6,1,1,0
-36,-42,6,1,0,1
25,40,-15,0,0,0
28,39,-11,0,0,0
18,29,-11,0,0,0
-5,5,-10,0,0,0
6,19,-13,0,0,0
17,20,-3,0,0,0
-24,-36,12,1,0,1
-37,-23,-14,0,1,1
-40,-25,-15,0,1,1
-6,-24,18,1,1,0
21,17,4,1,1,0
-32,-28,-4,0,1,1
0,7,-7,0,1,1
-15,1,-16,0,1,1
13,-4,17,1,1,0
1,-10,11,1,1,0
12,20,-8,0,1,1
1,-15,16,1,1,0
18,-2,20,1,1,0
-11,-26,15,1,1,0
11,18,-7,0,0,0
-39,-37,-2,0,0,0
4,-14,18,1,0,1
-7,-26,19,1,0,1
-14,-31,17,1,0,1
-28,-11,-17,0,0,0
-31,-35,4,1,0,1
-3,-21,18,1,0,1
-48,-31,-17,0,1,1
-32,-41,9,1,1,0
9,18,-9,0,1,1
21,15,6,1,1,0
-34,-38,4,1,1,0
35,33,2,1,1,0
31,24,7,1,1,0
54,44,10,1,1,0
-58,-39,-19,0,1,1
-23,-30,7,1,1,0
59,43,16,1,1,0
33,13,20,1,1,0
-8,12,-20,0,1,1
31,15,16,1,1,0
49,42,7,1,0,1
-48,-39,-9,0,0,0
45,28,17,1,0,1
38,26,12,1,0,1
17,3,14,1,0,1
-28,-9,-19,0,0,0
-15,-22,7,1,0,1
1,-2,3,1,0,1
-49,-37,-12,0,0,0
-21,-32,11,1,0,1
19,5,14,1,0,1
41,42,-1,0,1,1
2,-12,14,1,1,0
57,39,18,1,1,0
2,11,-9,0,1,1
6,18,-12,0,1,1
30,37,-7,0,1,1
-12,0,-12,0,1,1
1,14,-13,0,1,1
-43,-37,-6,0,1,1
46,35,11,1,1,0
38,32,6,1,1,0
-36,-39,3,1,1,0
29,18,11,1,1,0
29,33,-4,0,1,1
24,32,-8,0,1,1
17,25,-8,0,1,1
-18,-19,1,1,1,0
-20,0,-20,0,1,1
10,23,-13,0,1,1
-39,-32,-7,0,1,1
-38,-28,-10,0,1,1
29,44,-15,0,0,0
52,44,8,1,0,1
28,10,18,1,0,1
16,29,-13,0,0,0
-29,-43,14,1,0,1
32,36,-4,0,0,0
48,39,9,1,0,1
53,44,9,1,0,1
38,25,13,1,0,1
-16,-20,4,1,0,1
-40,-27,-13,0,0,0
34,36,-2,0,0,0
-4,3,-7,0,0,0
24,23,1,1,0,1
20,1,19,1,0,1
2,-14,16,1,0,1
34,21,13,1,0,1
-25,-41,16,1,0,1
27,18,9,1,0,1
-40,-40,0,0,0,0
1,-9,10,1,0,1
37,30,7,1,1,0
-8,6,-14,0,1,1
43,37,6,1,1,0
-19,-22,3,1,1,0
12,-4,16,1,1,0
18,31,-13,0,1,1
-25,-15,-10,0,1,1
1,-10,11,1,1,0
-12,-16,4,1,0,1
5,5,0,0,0,0
2,9,-7,0,0,0
-28,-15,-13,0,0,0
11,-5,16,1,0,1
53,42,11,1,0,1
47,44,3,1,0,1
41,21,20,1,0,1
-11,-17,6,1,1,0
-33,-21,-12,0,1,1
30,14,16,1,1,0
-16,3,-19,0,1,1
-11,-2,-9,0,1,1
-1,-21,20,1,1,0
24,8,16,1,1,0
41,30,11,1,1,0
25,32,-7,0,1,1
19,0,19,1,1,0
28,23,5,1,0,1
41,39,2,1,0,1
6,14,-8,0,0,0
27,16,11,1,0,1
-5,7,-12,0,0,0
4,10,-6,0,0,0
32,17,15,1,0,1
26,6,20,1,0,1
-12,7,-19,0,0,0
20,11,9,1,0,1
-53,-41,-12,0,0,0
-8,-21,13,1,0,1
-15,-31,16,1,0,1
25,17,8,1,1,0
-27,-42,15,1,1,0
30,13,17,1,1,0
43,29,14,1,1,0
12,13,-1,0,1,1
16,24,-8,0,1,1
-31,-18,-13,0,1,1
-30,-43,13,1,1,0
-20,-40,20,1,1,0
23,4,19,1,1,0
-9,-3,-6,0,1,1
9,19,-10,0,1,1
11,1,10,1,1,0
9,13,-4,0,1,1
41,31,10,1,1,0
-18,1,-19,0,1,1
-29,-20,-9,0,1,1
-27,-15,-12,0,1,1
-34,-20,-14,0,1,1
24,41,-17,0,1,1
6,10,-4,0,1,1
-35,-28,-7,0,0,0
50,31,19,1,0,1
0,18,-18,0,0,0
-13,0,-13,0,0,0
8,-2,10,1,0,1
-40,-44,4,1,0,1
35,26,9,1,0,1
-42,-36,-6,0,0,0
40,25,15,1,0,1
-22,-19,-3,0,0,0
63,44,19,1,0,1
-19,-37,18,1,0,1
0,19,-19,0,1,1
47,34,13,1,1,0
59,41,18,1,1,0
-20,-34,14,1,1,0
-32,-16,-16,0,1,1
22,40,-18,0,1,1
-28,-20,-8,0,1,1
-64,-44,-20,0,1,1
16,32,-16,0,1,1
-34,-22,-12,0,1,1
3,14,-11,0,1,1
-8,-17,9,1,1,0
38,39,-1,0,1,1
-41,-39,-2,0,1,1
55,41,14,1,0,1
-63,-45,-18,0,0,0
-2,-11,9,1,0,1
-36,-24,-12,0,0,0
-15,-32,17,1,0,1
-2,2,-4,0,0,0
-30,-23,-7,0,0,0
2,2,0,0,0,0
-22,-30,8,1,1,0
5,15,-10,0,1,1
18,23,-5,0,1,1
37,33,4,1,1,0
-35,-21,-14,0,1,1
-2,-8,6,1,1,0
1,-12,13,1,1,0
0,-14,14,1,1,0
39,19,20,1,1,0
9,12,-3,0,1,1
-41,-39,-2,0,1,1
-57,-45,-12,0,1,1
-20,-13,-7,0,1,1
12,7,5,1,1,0
-11,-17,6,1,1,0
-34,-31,-3,0,1,1
-30,-45,15,1,1,0
34,34,0,0,1,1
19,19,0,0,1,1
-13,-9,-4,0,1,1
2,0,2,1,1,0
12,-7,19,1,0,1
7,12,-5,0,0,0
-15,-21,6,1,0,1
-33,-36,3,1,0,1
2,12,-10,0,0,0
9,28,-19,0,0,0
-23,-12,-11,0,0,0
-19,-6,-13,0,0,0
7,10,-3,0,0,0
-2,-13,11,1,1,0
19,9,10,1,1,0
29,11,18,1,1,0
-21,-26,5,1,1,0
5,18,-13,0,1,1
-25,-14,-11,0,1,1
-35,-25,-10,0,1,1
3,-10,13,1,1,0
25,43,-18,0,1,1
6,-11,17,1,1,0
-13,-19,6,1,1,0
37,17,20,1,1,0
28,41,-13,0,1,1
-11,-17,6,1,1,0
7,-5,12,1,1,0
18,30,-12,0,1,1
-12,2,-14,0,1,1
14,-1,15,1,1,0
-58,-40,-18,0,1,1
37,23,14,1,1,0
23,42,-19,0,1,1
9,20,-11,0,0,0
36,39,-3,0,0,0
-49,-39,-10,0,0,0
35,17,18,1,0,1
-7,-12,5,1,0,1
-32,-31,-1,0,0,0
10,-4,14,1,0,1
-24,-15,-9,0,0,0
7,12,-5,0,0,0
-9,2,-11,0,0,0
-27,-30,3,1,0,1
-30,-30,0,0,0,0
-20,-15,-5,0,0,0
-32,-21,-11,0,0,0
-6,-8,2,1,0,1
-12,-18,6,1,0,1
28,37,-9,0,0,0
-11,-15,4,1,0,1
17,26,-9,0,0,0
24,20,4,1,0,1
-15,-27,12,1,0,1
1,-2,3,1,1,0
-37,-42,5,1,1,0
-20,-30,10,1,1,0
13,23,-10,0,1,1
-4,-10,6,1,1,0
-18,-2,-16,0,1,1
-57,-44,-13,0,1,1
4,-6,10,1,1,0
3,19,-16,0,1,1
26,32,-6,0,1,1
-12,-15,3,1,0,1
6,19,-13,0,0,0
-20,-40,20,1,0,1
25,10,15,1,0,1
58,39,19,1,0,1
-12,-14,2,1,0,1
8,2,6,1,0,1
-39,-30,-9,0,0,0
-23,-31,8,1,0,1
-3,-12,9,1,0,1
-49,-38,-11,0,0,0
-31,-28,-3,0,0,0
-9,-17,8,1,0,1
24,5,19,1,1,0
-27,-36,9,1,1,0
15,22,-7,0,1,1
29,37,-8,0,1,1
-45,-30,-15,0,1,1
16,11,5,1,1,0
-1,-11,10,1,1,0
-12,7,-19,0,1,1
15,24,-9,0,1,1
2,21,-19,0,1,1
-25,-16,-9,0,1,1
8,0,8,1,1,0
-27,-33,6,1,1,0
40,36,4,1,1,0
-24,-32,8,1,1,0
25,23,2,1,1,0
43,34,9,1,1,0
9,18,-9,0,1,1
32,18,14,1,1,0
-35,-45,10,1,1,0
5,-3,8,1,1,0
-22,-5,-17,0,0,0
16,21,-5,0,0,0
-18,-26,8,1,0,1
51,38,13,1,0,1
-12,-12,0,0,0,0
-38,-43,5,1,0,1
38,21,17,1,0,1
-11,-30,19,1,0,1
-23,-32,9,1,0,1
21,12,9,1,0,1
30,14,16,1,0,1
-24,-35,11,1,0,1
-16,-22,6,1,0,1
38,29,9,1,0,1
41,32,9,1,0,1
2,-5,7,1,1,0
-48,-37,-11,0,1,1
-58,-38,-20,0,1,1
28,19,9,1,1,0
19,-1,20,1,1,0
17,10,7,1,1,0
-58,-38,-20,0,1,1
26,39,-13,0,1,1
8,22,-14,0,1,1
-6,-23,17,1,1,0
25,29,-4,0,1,1
39,31,8,1,1,0
6,12,-6,0,1,1
-20,-36,16,1,1,0
2,-13,15,1,1,0
-33,-43,10,1,0,1
-35,-28,-7,0,0,0
28,25,3,1,0,1
-42,-33,-9,0,0,0
-1,-16,15,1,0,1
-43,-28,-15,0,0,0
10,-10,20,1,0,1
-31,-23,-8,0,0,0
0,-11,11,1,0,1
23,11,12,1,0,1
-23,-28,5,1,0,1
10,28,-18,0,0,0
39,36,3,1,0,1
-16,-10,-6,0,1,1
26,21,5,1,1,0
-33,-22,-11,0,1,1
-46,-26,-20,0,1,1
-30,-13,-17,0,1,1
-20,-10,-10,0,1,1
-32,-42,10,1,1,0
29,34,-5,0,1,1
20,23,-3,0,1,1
22,5,17,1,1,0
10,12,-2,0,1,1
-36,-26,-10,0,1,1
-36,-24,-12,0,1,1
12,-6,18,1,1,0
17,6,11,1,1,0
-26,-37,11,1,1,0
48,36,12,1,0,1
-25,-7,-18,0,0,0
-18,-8,-10,0,0,0
-49,-42,-7,0,0,0
-57,-41,-16,0,0,0
-61,-43,-18,0,0,0
30,15,15,1,0,1
30,10,20,1,0,1
-44,-29,-15,0,0,0
12,29,-17,0,1,1
32,25,7,1,1,0
-30,-41,11,1,1,0
-27,-16,-11,0,1,1
28,35,-7,0,1,1
-26,-11,-15,0,1,1
10,5,5,1,1,0
26,14,12,1,1,0
36,33,3,1,1,0
-35,-30,-5,0,1,1
27,11,16,1,1,0
18,10,8,1,1,0
-9,-21,12,1,1,0
28,25,3,1,1,0
-25,-16,-9,0,1,1
-2,6,-8,0,1,1
32,29,3,1,1,0
43,42,1,1,1,0
-28,-26,-2,0,1,1
-39,-35,-4,0,0,0
-2,1,-3,0,0,0
-21,-38,17,1,0,1
-45,-37,-8,0,0,0
-23,-21,-2,0,0,0
37,34,3,1,0,1
-5,-22,17,1,0,1
26,43,-17,0,0,0
43,37,6,1,0,1
-20,-33,13,1,0,1
-10,-25,15,1,0,1
-10,-14,4,1,0,1
33,38,-5,0,0,0
-32,-24,-8,0,0,0
24,39,-15,0,0,0
-7,-24,17,1,0,1
-11,-7,-4,0,0,0
21,34,-13,0,0,0
-5,-6,1,1,0,1
-38,-18,-20,0,1,1
35,17,18,1,1,0
-12,-17,5,1,1,0
-2,14,-16,0,1,1
43,28,15,1,1,0
40,29,11,1,1,0
21,2,19,1,1,0
0,-11,11,1,1,0
-42,-26,-16,0,1,1
-12,-22,10,1,1,0
-40,-43,3,1,1,0
49,39,10,1,1,0
-6,-26,20,1,1,0
-26,-33,7,1,1,0
-53,-44,-9,0,0,0
22,40,-18,0,0,0
39,25,14,1,0,1
15,20,-5,0,0,0
-24,-30,6,1,0,1
30,31,-1,0,0,0
-10,-13,3,1,0,1
-19,-27,8,1,0,1
25,36,-11,0,0,0
-21,-19,-2,0,0,0
33,19,14,1,0,1
45,30,15,1,0,1
22,37,-15,0,0,0
31,23,8,1,1,0
-22,-17,-5,0,1,1
-16,4,-20,0,1,1
-2,-3,1,1,1,0
39,40,-1,0,1,1
3,-1,4,1,1,0
-20,-9,-11,0,1,1
-14,-10,-4,0,1,1
-5,-5,0,0,1,1
-3,14,-17,0,1,1
34,17,17,1,0,1
-25,-5,-20,0,0,0
29,24,5,1,0,1
-24,-8,-16,0,0,0
10,-3,13,1,0,1
43,40,3,1,0,1
-52,-35,-17,0,0,0
-34,-31,-3,0,0,0
57,37,20,1,0,1
-26,-29,3,1,0,1
-18,-20,2,1,0,1
56,43,13,1,0,1
11,6,5,1,0,1
-8,-9,1,1,0,1
-46,-27,-19,0,0,0
12,-2,14,1,1,0
-23,-32,9,1,1,0
-15,-15,0,0,1,1
-32,-37,5,1,1,0
42,32,10,1,1,0
22,33,-11,0,1,1
41,27,14,1,1,0
-9,-1,-8,0,1,1
-49,-30,-19,0,1,1
9,2,7,1,1,0
12,14,-2,0,1,1
36,33,3,1,1,0
-13,-1,-12,0,1,1
-26,-42,16,1,1,0
17,0,17,1,1,0
-10,-27,17,1,1,0
12,25,-13,0,1,1
-35,-21,-14,0,1,1
5,19,-14,0,1,1
-9,-18,9,1,1,0
-21,-14,-7,0,1,1
13,17,-4,0,0,0
-12,-32,20,1,0,1
-34,-43,9,1,0,1
-17,-4,-13,0,0,0
4,6,-2,0,0,0
27,19,8,1,0,1
-34,-25,-9,0,0,0
22,6,16,1,0,1
0,-13,13,1,0,1
-7,10,-17,0,0,0
-18,-15,-3,0,1,1
-11,7,-18,0,1,1
-12,-14,2,1,1,0
10,14,-4,0,1,1
-7,5,-12,0,1,1
-35,-33,-2,0,1,1
35,28,7,1,1,0
-7,-8,1,1,1,0
-25,-34,9,1,1,0
19,7,12,1,1,0
9,-10,19,1,1,0
34,39,-5,0,1,1
39,44,-5,0,1,1
50,36,14,1,0,1
-24,-39,15,1,0,1
11,15,-4,0,0,0
1,3,-2,0,0,0
35,24,11,1,0,1
47,37,10,1,0,1
-42,-25,-17,0,0,0
2,18,-16,0,0,0
40,40,0,0,0,0
57,41,16,1,1,0
-22,-25,3,1,1,0
-13,-19,6,1,1,0
-21,-3,-18,0,1,1
32,33,-1,0,1,1
31,30,1,1,1,0
8,22,-14,0,1,1
1,-10,11,1,1,0
0,19,-19,0,1,1
-3,-11,8,1,1,0
-21,-10,-11,0,1,1
-27,-27,0,0,1,1
49,29,20,1,1,0
2,-2,4,1,0,1
-4,-8,4,1,0,1
29,15,14,1,0,1
54,37,17,1,0,1
31,14,17,1,0,1
-29,-31,2,1,0,1
-45,-27,-18,0,0,0
-31,-37,6,1,0,1
-22,-4,-18,0,1,1
-22,-12,-10,0,1,1
29,28,1,1,1,0
25,31,-6,0,1,1
39,24,15,1,1,0
-24,-24,0,0,1,1
22,36,-14,0,1,1
29,13,16,1,1,0
-1,4,-5,0,1,1
-3,2,-5,0,1,1
33,27,6,1,1,0
-25,-16,-9,0,1,1
15,28,-13,0,1,1
-25,-7,-18,0,1,1
-22,-23,1,1,1,0
-22,-3,-19,0,1,1
5,-14,19,1,1,0
-37,-38,1,1,1,0
21,13,8,1,0,1
-5,-22,17,1,0,1
-4,10,-14,0,0,0
16,1,15,1,0,1
11,21,-10,0,0,0
17,23,-6,0,0,0
3,7,-4,0,0,0
49,33,16,1,0,1
-10,-13,3,1,0,1
5,20,-15,0,0,0
2,1,1,1,0,1
18,16,2,1,1,0
18,29,-11,0,1,1
-12,-6,-6,0,1,1
33,16,17,1,1,0
58,42,16,1,1,0
-7,-2,-5,0,1,1
-27,-9,-18,0,1,1
-19,-7,-12,0,1,1
0,8,-8,0,1,1
-33,-22,-11,0,1,1
-3,15,-18,0,0,0
56,38,18,1,0,1
-37,-24,-13,0,0,0
-3,9,-12,0,0,0
42,33,9,1,0,1
-33,-42,9,1,0,1
-22,-17,-5,0,0,0
29,29,0,0,0,0
-30,-41,11,1,0,1
-30,-32,2,1,0,1
-18,-2,-16,0,1,1
39,42,-3,0,1,1
-37,-29,-8,0,1,1
3,-14,17,1,1,0
20,16,4,1,1,0
12,-5,17,1,1,0
18,19,-1,0,1,1
14,-1,15,1,1,0
32,16,16,1,1,0
14,18,-4,0,1,1
-10,-20,10,1,1,0
41,22,19,1,1,0
-26,-42,16,1,0,1
-42,-26,-16,0,0,0
-46,-36,-10,0,0,0
-26,-30,4,1,0,1
23,8,15,1,0,1
56,38,18,1,0,1
8,14,-6,0,0,0
42,23,19,1,0,1
-11,-4,-7,0,0,0
-26,-6,-20,0,1,1
29,36,-7,0,1,1
-7,11,-18,0,1,1
25,8,17,1,1,0
-30,-32,2,1,1,0
-21,-9,-12,0,1,1
21,10,11,1,1,0
-20,-18,-2,0,1,1
-11,-14,3,1,1,0
-1,-17,16,1,1,0
-36,-33,-3,0,1,1
-9,-6,-3,0,1,1
-29,-13,-16,0,1,1
-11,0,-11,0,1,1
-52,-33,-19,0,1,1
36,38,-2,0,1,1
53,34,19,1,1,0
-42,-45,3,1,1,0
5,9,-4,0,0,0
-23,-30,7,1,0,1
-23,-23,0,0,0,0
-46,-28,-18,0,0,0
35,24,11,1,0,1
40,23,17,1,0,1
-20,-24,4,1,0,1
-13,2,-15,0,0,0
-26,-29,3,1,0,1
17,20,-3,0,0,0
13,23,-10,0,0,0
-20,-39,19,1,0,1
-11,1,-12,0,0,0
17,36,-19,0,0,0
-21,-39,18,1,0,1
-41,-33,-8,0,0,0
-19,-26,7,1,0,1
-46,-33,-13,0,0,0
-10,-6,-4,0,0,0
-30,-15,-15,0,0,0
33,26,7,1,0,1
31,39,-8,0,1,1
-37,-36,-1,0,1,1
-32,-13,-19,0,1,1
-22,-39,17,1,1,0
12,17,-5,0,1,1
9,0,9,1,1,0
17,-3,20,1,1,0
-33,-44,11,1,1,0
-41,-29,-12,0,1,1
-18,-22,4,1,1,0
-23,-29,6,1,1,0
23,36,-13,0,1,1
20,24,-4,0,1,1
-25,-5,-20,0,1,1
18,5,13,1,1,0
1,-6,7,1,1,0
-48,-45,-3,0,1,1
-14,-23,9,1,1,0
18,38,-20,0,1,1
23,31,-8,0,1,1
5,10,-5,0,1,1
10,3,7,1,0,1
-14,-14,0,0,0,0
3,-3,6,1,0,1
54,42,12,1,0,1
-10,-28,18,1,0,1
26,28,-2,0,0,0
0,16,-16,0,0,0
-7,12,-19,0,0,0
28,25,3,1,0,1
44,26,18,1,0,1
55,39,16,1,0,1
3,-8,11,1,0,1
-36,-31,-5,0,0,0
-21,-37,16,1,0,1
-20,-27,7,1,0,1
41,26,15,1,0,1
33,30,3,1,0,1
43,41,2,1,0,1
-24,-16,-8,0,0,0
-22,-19,-3,0,0,0
-25,-11,-14,0,0,0
-18,0,-18,0,1,1
16,17,-1,0,1,1
24,34,-10,0,1,1
-26,-31,5,1,1,0
-31,-37,6,1,1,0
20,9,11,1,1,0
-22,-12,-10,0,1,1
44,33,11,1,1,0
-38,-23,-15,0,1,1
-25,-32,7,1,1,0
12,8,4,1,1,0
2,11,-9,0,0,0
-35,-28,-7,0,0,0
-22,-18,-4,0,0,0
-28,-19,-9,0,0,0
22,35,-13,0,0,0
31,14,17,1,0,1
-4,-3,-1,0,0,0
-16,-27,11,1,0,1
50,41,9,1,0,1
-52,-40,-12,0,0,0
-13,-2,-11,0,1,1
-15,-8,-7,0,1,1
-25,-16,-9,0,1,1
-7,-10,3,1,1,0
-27,-17,-10,0,1,1
-23,-32,9,1,1,0
19,20,-1,0,1,1
-3,13,-16,0,1,1
22,19,3,1,1,0
-24,-35,11,1,1,0
-16,-24,8,1,1,0
50,32,18,1,1,0
13,-1,14,1,1,0
-29,-45,16,1,1,0
0,12,-12,0,1,1
2,14,-12,0,1,1
-6,11,-17,0,1,1
-40,-45,5,1,1,0
-17,-35,18,1,1,0
8,4,4,1,1,0
-36,-20,-16,0,1,1
-9,-2,-7,0,0,0
-42,-29,-13,0,0,0
16,18,-2,0,0,0
19,30,-11,0,0,0
-32,-14,-18,0,0,0
13,28,-15,0,0,0
-20,-13,-7,0,0,0
-27,-21,-6,0,0,0
41,43,-2,0,0,0
-21,-13,-8,0,0,0
37,44,-7,0,0,0
-37,-43,6,1,0,1
22,20,2,1,0,1
13,13,0,0,0,0
-44,-26,-18,0,0,0
11,-9,20,1,0,1
34,17,17,1,0,1
5,-10,15,1,0,1
13,22,-9,0,0,0
-27,-35,8,1,0,1
-57,-39,-18,0,0,0
-39,-45,6,1,1,0
-31,-13,-18,0,1,1
40,24,16,1,1,0
-35,-40,5,1,1,0
-23,-3,-20,0,1,1
16,20,-4,0,1,1
42,26,16,1,1,0
33,38,-5,0,1,1
25,44,-19,0,1,1
28,41,-13,0,0,0
33,27,6,1,0,1
12,15,-3,0,0,0
-46,-36,-10,0,0,0
-25,-9,-16,0,0,0
-3,1,-4,0,0,0
-41,-40,-1,0,0,0
-39,-34,-5,0,0,0
10,17,-7,0,0,0
-53,-41,-12,0,0,0
-7,-25,18,1,0,1
-3,-22,19,1,0,1
11,21,-10,0,0,0
-9,-11,2,1,0,1
39,34,5,1,0,1
28,14,14,1,1,0
27,20,7,1,1,0
48,30,18,1,1,0
17,4,13,1,1,0
-26,-33,7,1,1,0
28,32,-4,0,1,1
41,40,1,1,1,0
-29,-17,-12,0,1,1
-37,-32,-5,0,1,1
28,22,6,1,1,0
10,16,-6,0,1,1
-10,2,-12,0,1,1
-10,-15,5,1,1,0
39,21,18,1,1,0
-42,-31,-11,0,1,1
33,29,4,1,1,0
-3,8,-11,0,1,1
-5,-3,-2,0,0,0
-23,-39,16,1,0,1
-33,-33,0,0,0,0
17,36,-19,0,0,0
-40,-26,-14,0,0,0
34,22,12,1,0,1
0,-18,18,1,0,1
46,34,12,1,0,1
0,-12,12,1,0,1
16,-1,17,1,0,1
0,-5,5,1,0,1
23,21,2,1,0,1
-11,-29,18,1,0,1
-43,-45,2,1,0,1
14,7,7,1,0,1
18,22,-4,0,1,1
-8,-22,14,1,1,0
-14,3,-17,0,1,1
-14,-32,18,1,1,0
13,-5,18,1,1,0
3,3,0,0,1,1
-5,-13,8,1,1,0
9,19,-10,0,1,1
49,32,17,1,1,0
-11,-30,19,1,1,0
43,24,19,1,1,0
0,-17,17,1,0,1
-41,-45,4,1,0,1
-14,-28,14,1,0,1
-14,-8,-6,0,0,0
-11,-26,15,1,0,1
-30,-45,15,1,0,1
41,41,0,0,0,0
25,10,15,1,0,1
-39,-35,-4,0,0,0
42,35,7,1,0,1
-40,-21,-19,0,0,0
-21,-35,14,1,0,1
34,33,1,1,0,1
11,27,-16,0,0,0
15,-5,20,1,0,1
-28,-8,-20,0,1,1
-16,-4,-12,0,1,1
-33,-22,-11,0,1,1
19,7,12,1,1,0
-11,-16,5,1,1,0
26,21,5,1,1,0
6,0,6,1,1,0
2,19,-17,0,1,1
44,27,17,1,1,0
-48,-29,-19,0,1,1
-19,-36,17,1,1,0
-32,-43,11,1,1,0
44,44,0,0,1,1
-29,-27,-2,0,1,1
-20,-5,-15,0,1,1
9,2,7,1,1,0
31,14,17,1,0,1
-13,-3,-10,0,0,0
-16,-2,-14,0,0,0
3,1,2,1,0,1
26,12,14,1,0,1
42,38,4,1,0,1
-36,-17,-19,0,0,0
28,33,-5,0,0,0
15,16,-1,0,0,0
-44,-42,-2,0,0,0
-40,-39,-1,0,0,0
24,39,-15,0,0,0
-55,-45,-10,0,0,0
45,43,2,1,0,1
38,35,3,1,0,1
51,44,7,1,0,1
-27,-24,-3,0,0,0
-45,-37,-8,0,0,0
-9,-14,5,1,0,1
60,40,20,1,0,1
-45,-31,-14,0,0,0
-40,-20,-20,0,1,1
36,35,1,1,1,0
-36,-39,3,1,1,0
-48,-36,-12,0,1,1
36,27,9,1,1,0
25,8,17,1,1,0
-16,2,-18,0,1,1
13,-7,20,1,1,0
-16,-2,-14,0,1,1
58,44,14,1,0,1
-31,-38,7,1,0,1
-27,-45,18,1,0,1
45,28,17,1,0,1
8,-11,19,1,0,1
-6,-25,19,1,0,1
40,21,19,1,0,1
-63,-43,-20,0,0,0
9,0,9,1,0,1
5,12,-7,0,1,1
30,17,13,1,1,0
5,13,-8,0,1,1
4,13,-9,0,1,1
28,44,-16,0,1,1
-23,-17,-6,0,1,1
-19,0,-19,0,1,1
-21,-35,14,1,1,0
-22,-9,-13,0,1,1
-10,-4,-6,0,1,1
-27,-10,-17,0,1,1
42,43,-1,0,1,1
10,3,7,1,1,0
-21,-25,4,1,0,1
-14,-34,20,1,0,1
-33,-20,-13,0,0,0
-30,-37,7,1,0,1
-18,-37,19,1,0,1
3,4,-1,0,0,0
36,43,-7,0,0,0
28,21,7,1,0,1
15,-2,17,1,0,1
16,12,4,1,1,0
30,42,-12,0,1,1
-31,-20,-11,0,1,1
6,15,-9,0,1,1
6,4,2,1,1,0
-46,-37,-9,0,1,1
-17,-12,-5,0,1,1
6,14,-8,0,1,1
23,24,-1,0,1,1
-16,-22,6,1,1,0
13,7,6,1,0,1
-33,-20,-13,0,0,0
-5,-16,11,1,0,1
16,25,-9,0,0,0
-8,-14,6,1,0,1
34,32,2,1,0,1
2,19,-17,0,0,0
31,35,-4,0,0,0
-25,-40,15,1,0,1
29,19,10,1,0,1
-2,-15,13,1,0,1
-16,-28,12,1,0,1
15,3,12,1,0,1
6,5,1,1,0,1
28,9,19,1,0,1
14,26,-12,0,0,0
14,19,-5,0,0,0
15,24,-9,0,1,1
-13,-15,2,1,1,0
25,23,2,1,1,0
34,17,17,1,1,0
24,31,-7,0,1,1
51,39,12,1,1,0
-3,12,-15,0,1,1
-44,-35,-9,0,1,1
-3,-23,20,1,1,0
16,21,-5,0,1,1
52,35,17,1,0,1
-41,-45,4,1,0,1
-49,-43,-6,0,0,0
-29,-20,-9,0,0,0
-58,-43,-15,0,0,0
-63,-43,-20,0,0,0
39,42,-3,0,0,0
22,12,10,1,0,1
-28,-29,1,1,0,1
-10,9,-19,0,0,0
-32,-38,6,1,0,1
-37,-19,-18,0,0,0
26,20,6,1,0,1
35,19,16,1,0,1
-25,-36,11,1,0,1
-37,-35,-2,0,0,0
24,31,-7,0,0,0
-3,11,-14,0,1,1
-5,-10,5,1,1,0
25,44,-19,0,1,1
33,35,-2,0,1,1
58,38,20,1,1,0
45,27,18,1,1,0
41,33,8,1,1,0
12,28,-16,0,1,1
4,20,-16,0,1,1
-9,2,-11,0,1,1
-4,-18,14,1,1,0
-22,-22,0,0,1,1
-31,-32,1,1,1,0
-18,-26,8,1,1,0
-20,-6,-14,0,1,1
-10,6,-16,0,1,1
-21,-29,8,1,1,0
20,10,10,1,1,0
-23,-14,-9,0,1,1
-44,-40,-4,0,1,1
27,20,7,1,1,0
-39,-34,-5,0,0,0
0,-2,2,1,0,1
22,38,-16,0,0,0
-14,4,-18,0,0,0
3,-2,5,1,0,1
-37,-24,-13,0,0,0
-1,-17,16,1,0,1
6,12,-6,0,0,0
0,-5,5,1,0,1
47,41,6,1,0,1
-2,5,-7,0,0,0
-39,-42,3,1,0,1
10,21,-11,0,0,0
-1,1,-2,0,0,0
-11,-21,10,1,0,1
45,27,18,1,0,1
6,-12,18,1,0,1
20,35,-15,0,0,0
-41,-42,1,1,0,1
28,43,-15,0,0,0
20,6,14,1,0,1
-57,-42,-15,0,1,1
16,6,10,1,1,0
-15,-31,16,1,1,0
-33,-22,-11,0,1,1
7,-3,10,1,1,0
51,39,12,1,1,0
-17,-7,-10,0,1,1
11,8,3,1,1,0
22,3,19,1,1,0
-3,12,-15,0,1,1
-12,-24,12,1,1,0
54,39,15,1,1,0
29,27,2,1,0,1
1,-14,15,1,0,1
-25,-13,-12,0,0,0
31,41,-10,0,0,0
-24,-39,15,1,0,1
46,43,3,1,0,1
38,19,19,1,0,1
-43,-38,-5,0,0,0
23,24,-1,0,0,0
50,30,20,1,0,1
36,36,0,0,0,0
12,19,-7,0,0,0
11,27,-16,0,0,0
-27,-40,13,1,0,1
-9,-21,12,1,0,1
-13,-10,-3,0,0,0
-27,-41,14,1,0,1
18,13,5,1,1,0
32,13,19,1,1,0
-7,5,-12,0,1,1
-2,8,-10,0,1,1
-12,-31,19,1,1,0
20,7,13,1,1,0
-20,-35,15,1,1,0
56,38,18,1,1,0
25,14,11,1,1,0
45,36,9,1,1,0
-32,-39,7,1,0,1
40,44,-4,0,0,0
-8,-9,1,1,0,1
-12,-8,-4,0,0,0
10,-9,19,1,0,1
-23,-40,17,1,0,1
-42,-31,-11,0,0,0
3,2,1,1,0,1
13,26,-13,0,0,0
-16,-8,-8,0,0,0
-2,4,-6,0,0,0
-40,-31,-9,0,0,0
-30,-38,8,1,0,1
-34,-45,11,1,0,1
3,3,0,0,0,0
2,20,-18,0,0,0
-49,-42,-7,0,0,0
13,23,-10,0,0,0
-16,-5,-11,0,0,0
-9,-19,10,1,0,1
37,24,13,1,1,0
-31,-38,7,1,1,0
0,15,-15,0,1,1
-24,-37,13,1,1,0
-4,-23,19,1,1,0
-30,-13,-17,0,1,1
-15,-5,-10,0,1,1
13,3,10,1,1,0
26,44,-18,0,1,1
-38,-34,-4,0,0,0
-22,-32,10,1,0,1
38,37,1,1,0,1
-26,-19,-7,0,0,0
50,30,20,1,0,1
28,34,-6,0,0,0
36,19,17,1,0,1
31,27,4,1,0,1
22,3,19,1,0,1
37,28,9,1,0,1
53,42,11,1,0,1
0,-7,7,1,0,1
23,37,-14,0,0,0
6,26,-20,0,0,0
19,16,3,1,0,1
34,40,-6,0,0,0
-35,-26,-9,0,0,0
25,6,19,1,0,1
-2,13,-15,0,0,0
26,16,10,1,0,1
12,28,-16,0,0,0
2,-9,11,1,1,0
8,4,4,1,1,0
-38,-22,-16,0,1,1
0,-14,14,1,1,0
25,30,-5,0,1,1
-6,-21,15,1,1,0
6,9,-3,0,1,1
-5,-13,8,1,1,0
4,-1,5,1,1,0
-18,-4,-14,0,1,1
46,43,3,1,1,0
-17,-5,-12,0,1,1
-18,-10,-8,0,0,0
34,43,-9,0,0,0
-24,-12,-12,0,0,0
1,4,-3,0,0,0
-14,-2,-12,0,0,0
33,38,-5,0,0,0
-35,-34,-1,0,0,0
-9,-4,-5,0,0,0
20,37,-17,0,0,0
9,-10,19,1,0,1
-26,-38,12,1,0,1
-7,7,-14,0,0,0
33,19,14,1,0,1
-29,-40,11,1,0,1
-28,-16,-12,0,0,0
33,21,12,1,1,0
-30,-13,-17,0,1,1
31,28,3,1,1,0
-19,-29,10,1,1,0
-54,-44,-10,0,1,1
-49,-29,-20,0,1,1
-36,-29,-7,0,1,1
10,0,10,1,1,0
-39,-24,-15,0,1,1
24,15,9,1,1,0
28,39,-11,0,1,1
22,12,10,1,1,0
-34,-20,-14,0,1,1
0,7,-7,0,1,1
-3,8,-11,0,1,1
16,22,-6,0,1,1
27,33,-6,0,1,1
-55,-45,-10,0,1,1
26,6,20,1,1,0
-8,-12,4,1,1,0
34,15,19,1,1,0
40,31,9,1,0,1
-15,-27,12,1,0,1
-54,-44,-10,0,0,0
49,38,11,1,0,1
19,18,1,1,0,1
-28,-45,17,1,0,1
42,26,16,1,0,1
0,-12,12,1,0,1
6,12,-6,0,0,0
20,17,3,1,0,1
12,15,-3,0,0,0
-54,-44,-10,0,0,0
20,39,-19,0,0,0
-21,-25,4,1,0,1
17,1,16,1,0,1
26,9,17,1,1,0
-3,-4,1,1,1,0
7,12,-5,0,1,1
41,40,1,1,1,0
19,24,-5,0,1,1
13,5,8,1,1,0
-39,-39,0,0,1,1
19,14,5,1,1,0
-55,-42,-13,0,1,1
44,25,19,1,1,0
-17,-15,-2,0,1,1
7,-5,12,1,1,0
1,-8,9,1,1,0
60,41,19,1,1,0
-38,-44,6,1,1,0
-51,-38,-13,0,1,1
-55,-44,-11,0,0,0
40,20,20,1,0,1
35,30,5,1,0,1
-23,-38,15,1,0,1
-48,-42,-6,0,0,0
-9,-24,15,1,0,1
-36,-25,-11,0,0,0
15,4,11,1,0,1
-51,-31,-20,0,0,0
-33,-28,-5,0,0,0
22,40,-18,0,0,0
-32,-40,8,1,0,1
7,3,4,1,0,1
-20,-6,-14,0,0,0
41,32,9,1,0,1
-8,-6,-2,0,0,0
-25,-43,18,1,0,1
-23,-10,-13,0,0,0
-8,-25,17,1,0,1
-6,-5,-1,0,0,0
22,35,-13,0,1,1
-10,-3,-7,0,1,1
23,16,7,1,1,0
5,-14,19,1,1,0
19,29,-10,0,1,1
35,27,8,1,1,0
-5,11,-16,0,1,1
-24,-29,5,1,1,0
13,30,-17,0,1,1
-28,-14,-14,0,1,1
-19,-13,-6,0,1,1
32,29,3,1,1,0
45,32,13,1,1,0
7,21,-14,0,1,1
15,-1,16,1,0,1
-2,-3,1,1,0,1
31,14,17,1,0,1
-7,4,-11,0,0,0
-22,-29,7,1,0,1
56,44,12,1,0,1
59,42,17,1,0,1
-21,-7,-14,0,0,0
-30,-38,8,1,0,1
-45,-41,-4,0,0,0
-53,-43,-10,0,0,0
25,17,8,1,0,1
-1,2,-3,0,0,0
17,27,-10,0,0,0
36,29,7,1,0,1
-27,-16,-11,0,0,0
-37,-37,0,0,0,0
29,14,15,1,0,1
-29,-30,1,1,1,0
-44,-42,-2,0,1,1
-29,-33,4,1,1,0
13,14,-1,0,1,1
-13,-33,20,1,1,0
-2,-4,2,1,1,0
-21,-4,-17,0,1,1
-7,-4,-3,0,1,1
45,42,3,1,1,0
-20,-36,16,1,1,0
-46,-45,-1,0,1,1
6,18,-12,0,0,0
-57,-40,-17,0,0,0
-20,-34,14,1,0,1
-42,-31,-11,0,0,0
16,-2,18,1,0,1
-33,-18,-15,0,0,0
-5,-14,9,1,0,1
-12,3,-15,0,0,0
10,19,-9,0,0,0
-6,2,-8,0,0,0
16,14,2,1,1,0
4,-4,8,1,1,0
-41,-26,-15,0,1,1
-25,-17,-8,0,1,1
-58,-41,-17,0,1,1
-47,-45,-2,0,1,1
-39,-32,-7,0,1,1
7,25,-18,0,1,1
-62,-42,-20,0,1,1
-9,11,-20,0,1,1
24,20,4,1,1,0
-28,-14,-14,0,1,1
33,17,16,1,1,0
-6,-14,8,1,1,0
-5,-9,4,1,1,0
-33,-24,-9,0,0,0
-15,-17,2,1,0,1
40,26,14,1,0,1
49,30,19,1,0,1
0,-14,14,1,0,1
36,29,7,1,0,1
7,27,-20,0,0,0
19,38,-19,0,0,0
-22,-21,-1,0,0,0
-20,-19,-1,0,1,1
14,23,-9,0,1,1
-14,-25,11,1,1,0
-55,-37,-18,0,1,1
-30,-13,-17,0,1,1
-24,-44,20,1,1,0
6,10,-4,0,1,1
11,28,-17,0,1,1
54,38,16,1,1,0
-17,-7,-10,0,1,1
-43,-29,-14,0,1,1
15,21,-6,0,1,1
-16,-30,14,1,1,0
15,10,5,1,1,0
42,34,8,1,1,0
-14,-16,2,1,1,0
60,44,16,1,1,0
-35,-43,8,1,1,0
31,31,0,0,1,1
19,25,-6,0,1,1
63,43,20,1,1,0
29,29,0,0,0,0
-14,3,-17,0,0,0
-42,-41,-1,0,0,0
7,-3,10,1,0,1
50,44,6,1,0,1
25,33,-8,0,0,0
31,26,5,1,0,1
12,-5,17,1,0,1
-27,-7,-20,0,0,0
9,18,-9,0,0,0
60,41,19,1,0,1
45,35,10,1,0,1
10,-10,20,1,0,1
-8,-17,9,1,0,1
8,5,3,1,0,1
-1,14,-15,0,0,0
-15,-5,-10,0,0,0
-31,-17,-14,0,1,1
13,-1,14,1,1,0
-11,0,-11,0,1,1
-44,-31,-13,0,1,1
-23,-7,-16,0,1,1
-15,-12,-3,0,1,1
2,1,1,1,1,0
49,44,5,1,1,0
44,25,19,1,1,0
-15,-8,-7,0,1,1
21,20,1,1,1,0
-30,-23,-7,0,1,1
18,4,14,1,1,0
17,-3,20,1,1,0
-26,-22,-4,0,1,1
-8,12,-20,0,1,1
-21,-35,14,1,1,0
-22,-17,-5,0,1,1
-34,-24,-10,0,1,1
30,32,-2,0,1,1
9,8,1,1,0,1
21,31,-10,0,0,0
56,42,14,1,0,1
-3,-19,16,1,0,1
-17,-27,10,1,0,1
42,38,4,1,0,1
-13,-10,-3,0,0,0
-4,-9,5,1,0,1
-64,-44,-20,0,1,1
-10,-7,-3,0,1,1
50,39,11,1,1,0
-17,-29,12,1,1,0
-40,-30,-10,0,1,1
18,17,1,1,1,0
-14,-6,-8,0,1,1
-2,5,-7,0,1,1
-36,-42,6,1,1,0
-48,-31,-17,0,1,1
18,11,7,1,1,0
-19,-8,-11,0,0,0
-1,7,-8,0,0,0
42,44,-2,0,0,0
41,44,-3,0,0,0
-48,-40,-8,0,0,0
-9,-15,6,1,0,1
-16,-29,13,1,0,1
32,34,-2,0,0,0
0,17,-17,0,0,0
-26,-7,-19,0,0,0
-25,-40,15,1,0,1
-46,-28,-18,0,0,0
25,25,0,0,0,0
6,12,-6,0,0,0
-15,-12,-3,0,1,1
-16,-36,20,1,1,0
36,25,11,1,1,0
-4,12,-16,0,1,1
15,-2,17,1,1,0
-1,10,-11,0,1,1
28,20,8,1,1,0
1,21,-20,0,1,1
-37,-43,6,1,1,0
31,20,11,1,1,0
2,-11,13,1,1,0
21,35,-14,0,1,1
0,10,-10,0,1,1
-33,-33,0,0,1,1
-17,-24,7,1,1,0
48,43,5,1,1,0
-51,-33,-18,0,1,1
-32,-12,-20,0,0,0
4,12,-8,0,0,0
-35,-42,7,1,0,1
-1,-14,13,1,0,1
33,43,-10,0,0,0
-48,-43,-5,0,0,0
-26,-15,-11,0,0,0
-22,-17,-5,0,0,0
-7,-22,15,1,0,1
1,-16,17,1,0,1
8,7,1,1,0,1
-31,-24,-7,0,0,0
44,40,4,1,0,1
7,6,1,1,0,1
-5,0,-5,0,0,0
15,19,-4,0,0,0
-1,-10,9,1,1,0
33,40,-7,0,1,1
-24,-12,-12,0,1,1
-34,-45,11,1,1,0
28,10,18,1,1,0
26,22,4,1,1,0
41,23,18,1,1,0
-3,-11,8,1,1,0
8,22,-14,0,1,1
39,35,4,1,1,0
1,5,-4,0,1,1
-42,-24,-18,0,1,1
18,-1,19,1,1,0
4,-1,5,1,1,0
27,33,-6,0,1,1
41,37,4,1,1,0
14,24,-10,0,1,1
-22,-30,8,1,1,0
-25,-40,15,1,1,0
0,-10,10,1,1,0
35,40,-5,0,1,1
-30,-12,-18,0,0,0
15,13,2,1,0,1
8,19,-11,0,0,0
25,42,-17,0,0,0
52,41,11,1,0,1
-4,-11,7,1,0,1
-10,-5,-5,0,0,0
-7,-13,6,1,0,1
39,29,10,1,0,1
-58,-42,-16,0,1,1
-29,-21,-8,0,1,1
-23,-22,-1,0,1,1
-52,-38,-14,0,1,1
-31,-36,5,1,1,0
23,27,-4,0,1,1
-18,-2,-16,0,1,1
-22,-21,-1,0,1,1
21,37,-16,0,1,1
3,8,-5,0,1,1
-41,-29,-12,0,1,1
-39,-32,-7,0,1,1
7,20,-13,0,1,1
-46,-45,-1,0,1,1
10,14,-4,0,1,1
47,31,16,1,1,0
32,18,14,1,0,1
19,35,-16,0,0,0
19,29,-10,0,0,0
31,18,13,1,0,1
-1,-3,2,1,0,1
-6,-7,1,1,0,1
37,33,4,1,0,1
-16,-22,6,1,0,1
-26,-45,19,1,0,1
-23,-17,-6,0,0,0
11,7,4,1,0,1
-18,-34,16,1,0,1
-10,-28,18,1,0,1
12,27,-15,0,0,0
-57,-42,-15,0,0,0
-26,-39,13,1,0,1
24,16,8,1,0,1
-39,-38,-1,0,1,1
45,31,14,1,1,0
-36,-37,1,1,1,0
-41,-22,-19,0,1,1
-37,-41,4,1,1,0
22,2,20,1,1,0
13,3,10,1,1,0
-19,-2,-17,0,1,1
30,44,-14,0,0,0
21,7,14,1,0,1
-8,9,-17,0,0,0
12,3,9,1,0,1
21,27,-6,0,0,0
-50,-30,-20,0,0,0
-32,-34,2,1,0,1
-12,-15,3,1,0,1
26,41,-15,0,0,0
9,14,-5,0,0,0
-11,5,-16,0,0,0
-45,-29,-16,0,0,0
-17,-12,-5,0,0,0
15,21,-6,0,0,0
27,16,11,1,0,1
-14,-20,6,1,0,1
31,16,15,1,0,1
-10,-3,-7,0,0,0
5,20,-15,0,0,0
-33,-44,11,1,0,1
-15,-24,9,1,1,0
-10,3,-13,0,1,1
-58,-41,-17,0,1,1
-18,-19,1,1,1,0
11,-3,14,1,1,0
-12,-16,4,1,1,0
-21,-13,-8,0,1,1
-6,6,-12,0,1,1
-23,-36,13,1,1,0
-4,-13,9,1,1,0
-47,-45,-2,0,1,1
19,0,19,1,1,0
-23,-4,-19,0,1,1
-42,-31,-11,0,1,1
-4,15,-19,0,1,1
39,27,12,1,1,0
27,27,0,0,0,0
41,33,8,1,0,1
7,-2,9,1,0,1
12,12,0,0,0,0
36,31,5,1,0,1
47,39,8,1,0,1
-12,0,-12,0,0,0
12,3,9,1,0,1
-8,6,-14,0,0,0
47,42,5,1,0,1
-9,3,-12,0,0,0
-4,-7,3,1,0,1
-43,-29,-14,0,0,0
55,36,19,1,0,1
44,26,18,1,0,1
-17,-37,20,1,0,1
-2,-17,15,1,1,0
-5,1,-6,0,1,1
-14,-33,19,1,1,0
-25,-6,-19,0,1,1
2,13,-11,0,1,1
14,18,-4,0,1,1
31,38,-7,0,1,1
-32,-17,-15,0,1,1
-3,-19,16,1,1,0
-51,-39,-12,0,1,1
-27,-12,-15,0,1,1
45,44,1,1,1,0
40,21,19,1,1,0
18,3,15,1,1,0
25,8,17,1,0,1
44,44,0,0,0,0
24,14,10,1,0,1
6,-11,17,1,0,1
-40,-35,-5,0,0,0
-17,-17,0,0,0,0
-32,-40,8,1,0,1
-30,-18,-12,0,0,0
-12,-14,2,1,0,1
3,18,-15,0,1,1
23,19,4,1,1,0
-8,-4,-4,0,1,1
0,-5,5,1,1,0
-52,-42,-10,0,1,1
-19,-29,10,1,1,0
-33,-44,11,1,1,0
2,-15,17,1,1,0
-52,-32,-20,0,1,1
59,41,18,1,1,0
-22,-15,-7,0,1,1
6,25,-19,0,0,0
-29,-45,16,1,0,1
-34,-43,9,1,0,1
-15,-14,-1,0,0,0
-22,-15,-7,0,0,0
1,-3,4,1,0,1
-38,-35,-3,0,0,0
15,6,9,1,0,1
-15,-7,-8,0,0,0
8,16,-8,0,0,0
5,18,-13,0,0,0
-8,-14,6,1,0,1
1,-8,9,1,0,1
9,3,6,1,0,1
30,24,6,1,0,1
26,7,19,1,0,1
-40,-39,-1,0,0,0
7,24,-17,0,1,1
16,18,-2,0,1,1
26,28,-2,0,1,1
25,22,3,1,1,0
-16,-31,15,1,1,0
-35,-17,-18,0,1,1
-13,-17,4,1,1,0
-39,-34,-5,0,1,1
-9,-6,-3,0,1,1
38,37,1,1,1,0
-56,-37,-19,0,1,1
2,-13,15,1,1,0
-4,-20,16,1,1,0
0,20,-20,0,0,0
58,39,19,1,0,1
8,21,-13,0,0,0
-31,-32,1,1,0,1
-19,-35,16,1,0,1
58,40,18,1,0,1
-14,-27,13,1,0,1
45,28,17,1,0,1
-1,4,-5,0,1,1
5,22,-17,0,1,1
35,40,-5,0,1,1
-4,6,-10,0,1,1
50,34,16,1,1,0
-11,-22,11,1,1,0
-43,-28,-15,0,1,1
13,28,-15,0,1,1
-26,-34,8,1,1,0
11,3,8,1,1,0
-8,-2,-6,0,1,1
14,4,10,1,1,0
32,20,12,1,1,0
29,19,10,1,1,0
21,12,9,1,1,0
38,21,17,1,1,0
-26,-45,19,1,1,0
46,27,19,1,1,0
45,35,10,1,1,0
-2,2,-4,0,1,1
-39,-35,-4,0,0,0
47,44,3,1,0,1
19,39,-20,0,0,0
25,13,12,1,0,1
25,31,-6,0,0,0
-47,-40,-7,0,0,0
30,41,-11,0,0,0
26,9,17,1,0,1
27,25,2,1,0,1
9,23,-14,0,1,1
36,22,14,1,1,0
-12,-19,7,1,1,0
49,40,9,1,1,0
-35,-29,-6,0,1,1
24,10,14,1,1,0
7,-11,18,1,1,0
-31,-44,13,1,1,0
30,31,-1,0,1,1
-5,-17,12,1,1,0
-50,-44,-6,0,1,1
2,20,-18,0,1,1
27,8,19,1,1,0
9,9,0,0,1,1
-34,-42,8,1,0,1
4,5,-1,0,0,0
-23,-19,-4,0,0,0
2,3,-1,0,0,0
-15,-24,9,1,0,1
14,2,12,1,0,1
10,24,-14,0,0,0
29,21,8,1,0,1
5,-6,11,1,0,1
-46,-35,-11,0,1,1
-2,-3,1,1,1,0
15,28,-13,0,1,1
33,36,-3,0,1,1
-6,-3,-3,0,1,1
-25,-17,-8,0,1,1
-35,-36,1,1,1,0
-34,-29,-5,0,1,1
18,15,3,1,1,0
-4,-19,15,1,1,0
-53,-44,-9,0,1,1
27,13,14,1,1,0
30,42,-12,0,1,1
-27,-7,-20,0,1,1
-23,-15,-8,0,0,0
37,44,-7,0,0,0
26,7,19,1,0,1
-1,-19,18,1,0,1
42,35,7,1,0,1
16,17,-1,0,0,0
-5,-14,9,1,0,1
-27,-33,6,1,0,1
20,32,-12,0,0,0
46,43,3,1,0,1
7,7,0,0,0,0
-14,-12,-2,0,1,1
11,16,-5,0,1,1
13,17,-4,0,1,1
-28,-8,-20,0,1,1
-11,-8,-3,0,1,1
-9,-26,17,1,1,0
-35,-17,-18,0,1,1
19,3,16,1,1,0
14,24,-10,0,1,1
24,31,-7,0,1,1
27,20,7,1,1,0
45,35,10,1,1,0
27,42,-15,0,1,1
19,30,-11,0,1,1
14,8,6,1,1,0
-12,-28,16,1,1,0
-32,-33,1,1,1,0
44,42,2,1,1,0
-51,-41,-10,0,1,1
49,42,7,1,1,0
28,23,5,1,1,0
14,26,-12,0,0,0
23,25,-2,0,0,0
25,41,-16,0,0,0
-25,-39,14,1,0,1
11,4,7,1,0,1
18,6,12,1,0,1
-7,-12,5,1,0,1
19,19,0,0,0,0
-45,-41,-4,0,0,0
26,12,14,1,0,1
8,8,0,0,0,0
-38,-19,-19,0,0,0
14,14,0,0,0,0
-19,-28,9,1,0,1
-34,-41,7,1,0,1
-8,-26,18,1,0,1
-46,-41,-5,0,0,0
14,34,-20,0,0,0
-46,-43,-3,0,0,0
15,3,12,1,0,1
13,9,4,1,0,1
-31,-34,3,1,1,0
-36,-41,5,1,1,0
38,18,20,1,1,0
-43,-34,-9,0,1,1
29,41,-12,0,1,1
45,37,8,1,1,0
32,25,7,1,1,0
-33,-24,-9,0,1,1
-46,-36,-10,0,1,1
-1,16,-17,0,1,1
33,40,-7,0,1,1
-25,-28,3,1,1,0
-48,-36,-12,0,0,0
38,25,13,1,0,1
-43,-26,-17,0,0,0
27,34,-7,0,0,0
-2,-22,20,1,0,1
13,-7,20,1,0,1
-36,-45,9,1,0,1
24,14,10,1,0,1
34,42,-8,0,0,0
9,7,2,1,1,0
-29,-40,11,1,1,0
4,-16,20,1,1,0
0,-12,12,1,1,0
-27,-24,-3,0,1,1
-22,-6,-16,0,1,1
-9,-5,-4,0,1,1
47,40,7,1,1,0
20,14,6,1,1,0
-13,-32,19,1,1,0
22,39,-17,0,0,0
-18,-26,8,1,0,1
-16,-36,20,1,0,1
-47,-41,-6,0,0,0
34,30,4,1,0,1
-33,-34,1,1,0,1
7,21,-14,0,0,0
-42,-33,-9,0,0,0
28,42,-14,0,0,0
-4,-12,8,1,0,1
-35,-26,-9,0,0,0
56,44,12,1,0,1
2,-17,19,1,1,0
2,19,-17,0,1,1
17,24,-7,0,1,1
-39,-39,0,0,1,1
13,7,6,1,1,0
5,3,2,1,1,0
5,15,-10,0,1,1
-12,2,-14,0,1,1
18,14,4,1,1,0
-32,-16,-16,0,1,1
-32,-39,7,1,1,0
17,30,-13,0,1,1
26,22,4,1,1,0
-33,-20,-13,0,1,1
18,24,-6,0,1,1
-44,-24,-20,0,1,1
35,32,3,1,1,0
54,43,11,1,1,0
-25,-38,13,1,1,0
-9,-25,16,1,1,0
-8,-15,7,1,1,0
-19,-3,-16,0,0,0
-14,6,-20,0,0,0
40,21,19,1,0,1
-32,-45,13,1,0,1
-46,-30,-16,0,0,0
-6,5,-11,0,0,0
-28,-39,11,1,0,1
2,6,-4,0,0,0
29,41,-12,0,0,0
12,23,-11,0,1,1
-24,-27,3,1,1,0
-9,-8,-1,0,1,1
-12,-32,20,1,1,0
32,31,1,1,1,0
-25,-44,19,1,1,0
-22,-5,-17,0,1,1
45,44,1,1,1,0
17,24,-7,0,1,1
-12,-32,20,1,1,0
2,-7,9,1,1,0
45,35,10,1,1,0
32,40,-8,0,1,1
-1,0,-1,0,1,1
32,42,-10,0,1,1
-20,-26,6,1,1,0
12,14,-2,0,1,1
35,25,10,1,0,1
-35,-42,7,1,0,1
-36,-39,3,1,0,1
-11,4,-15,0,0,0
-41,-43,2,1,0,1
-26,-30,4,1,0,1
-1,-8,7,1,0,1
26,44,-18,0,0,0
8,-4,12,1,0,1
47,41,6,1,1,0
19,38,-19,0,1,1
25,38,-13,0,1,1
37,31,6,1,1,0
28,16,12,1,1,0
41,30,11,1,1,0
16,-3,19,1,1,0
-2,-10,8,1,1,0
-20,-6,-14,0,1,1
18,17,1,1,1,0
-8,-23,15,1,1,0
-18,-14,-4,0,0,0
-18,-37,19,1,0,1
37,22,15,1,0,1
21,9,12,1,0,1
-50,-35,-15,0,0,0
-14,-19,5,1,0,1
-22,-26,4,1,0,1
48,30,18,1,0,1
31,21,10,1,0,1
11,-9,20,1,0,1
21,34,-13,0,0,0
-6,-9,3,1,0,1
9,22,-13,0,1,1
14,25,-11,0,1,1
-47,-38,-9,0,1,1
-20,-36,16,1,1,0
51,40,11,1,1,0
-30,-29,-1,0,1,1
0,12,-12,0,1,1
-52,-32,-20,0,1,1
-23,-26,3,1,0,1
49,38,11,1,0,1
-31,-35,4,1,0,1
-23,-33,10,1,0,1
-11,-30,19,1,0,1
-5,8,-13,0,0,0
57,43,14,1,0,1
35,42,-7,0,0,0
16,10,6,1,0,1
38,23,15,1,0,1
-26,-18,-8,0,0,0
-7,-19,12,1,0,1
-27,-18,-9,0,0,0
-11,2,-13,0,0,0
28,10,18,1,0,1
-29,-28,-1,0,0,0
3,12,-9,0,0,0
26,13,13,1,0,1
-54,-45,-9,0,0,0
-14,-20,6,1,1,0
12,15,-3,0,1,1
18,6,12,1,1,0
-26,-41,15,1,1,0
25,21,4,1,1,0
24,13,11,1,1,0
-19,-10,-9,0,1,1
-7,-9,2,1,1,0
1,15,-14,0,1,1
13,-7,20,1,0,1
-48,-40,-8,0,0,0
-33,-44,11,1,0,1
-35,-44,9,1,0,1
-33,-20,-13,0,0,0
4,-1,5,1,0,1
31,44,-13,0,0,0
-26,-23,-3,0,0,0
61,41,20,1,0,1
-21,-39,18,1,1,0
43,29,14,1,1,0
39,23,16,1,1,0
29,21,8,1,1,0
-32,-43,11,1,1,0
-42,-44,2,1,1,0
-17,-7,-10,0,1,1
-5,14,-19,0,1,1
-2,2,-4,0,1,1
15,31,-16,0,1,1
-32,-33,1,1,1,0
-8,-16,8,1,1,0
-26,-41,15,1,1,0
11,29,-18,0,1,1
-63,-44,-19,0,1,1
-4,4,-8,0,1,1
26,7,19,1,1,0
6,-12,18,1,1,0
-50,-45,-5,0,1,1
-16,-9,-7,0,1,1
7,10,-3,0,1,1
-4,-22,18,1,0,1
-28,-42,14,1,0,1
28,14,14,1,0,1
38,42,-4,0,0,0
-33,-19,-14,0,0,0
50,44,6,1,0,1
-33,-19,-14,0,0,0
-37,-38,1,1,0,1
-24,-33,9,1,0,1
47,27,20,1,0,1
29,26,3,1,0,1
-43,-25,-18,0,0,0
-60,-42,-18,0,0,0
-18,1,-19,0,0,0
-14,-34,20,1,0,1
-41,-42,1,1,0,1
-59,-44,-15,0,1,1
59,41,18,1,1,0
29,33,-4,0,1,1
-46,-40,-6,0,1,1
-11,-4,-7,0,1,1
25,9,16,1,1,0
38,31,7,1,1,0
-24,-36,12,1,1,0
-33,-33,0,0,1,1
52,33,19,1,1,0
-29,-17,-12,0,1,1
4,22,-18,0,1,1
38,20,18,1,1,0
-10,-5,-5,0,1,1
-3,-15,12,1,1,0
-21,-20,-1,0,1,1
54,44,10,1,1,0
-12,5,-17,0,1,1
30,44,-14,0,1,1
39,31,8,1,1,0
-42,-33,-9,0,1,1
1,5,-4,0,0,0
-50,-42,-8,0,0,0
-45,-37,-8,0,0,0
-46,-29,-17,0,0,0
11,2,9,1,0,1
-39,-30,-9,0,0,0
21,16,5,1,0,1
-38,-44,6,1,0,1
31,14,17,1,0,1
46,34,12,1,0,1
-13,-19,6,1,0,1
44,37,7,1,0,1
-18,2,-20,0,0,0
39,29,10,1,0,1
-12,-5,-7,0,1,1
0,-11,11,1,1,0
-35,-43,8,1,1,0
1,5,-4,0,1,1
29,28,1,1,1,0
-33,-27,-6,0,1,1
23,34,-11,0,1,1
27,24,3,1,1,0
-2,-9,7,1,1,0
-2,8,-10,0,1,1
-12,-27,15,1,1,0
5,-2,7,1,1,0
19,34,-15,0,1,1
-35,-17,-18,0,1,1
-54,-45,-9,0,1,1
-28,-8,-20,0,1,1
18,26,-8,0,1,1
4,15,-11,0,1,1
-6,-2,-4,0,1,1
21,19,2,1,1,0
-5,1,-6,0,1,1
-45,-25,-20,0,0,0
-1,11,-12,0,0,0
7,0,7,1,0,1
21,30,-9,0,0,0
37,39,-2,0,0,0
31,13,18,1,0,1
-16,-3,-13,0,0,0
18,10,8,1,0,1
64,44,20,1,0,1
13,8,5,1,0,1
-25,-15,-10,0,0,0
-16,-4,-12,0,0,0
25,8,17,1,0,1
38,38,0,0,0,0
23,35,-12,0,0,0
-44,-43,-1,0,0,0
18,11,7,1,1,0
8,20,-12,0,1,1
9,0,9,1,1,0
-40,-41,1,1,1,0
-22,-34,12,1,1,0
-8,11,-19,0,1,1
-12,6,-18,0,1,1
-27,-17,-10,0,1,1
20,8,12,1,1,0
-37,-29,-8,0,1,1
33,31,2,1,1,0
-39,-45,6,1,1,0
0,-1,1,1,1,0
3,14,-11,0,1,1
8,25,-17,0,1,1
20,14,6,1,1,0
-16,-12,-4,0,1,1
-18,-33,15,1,1,0
41,24,17,1,1,0
7,4,3,1,1,0
23,24,-1,0,1,1
-2,-7,5,1,0,1
42,28,14,1,0,1
-11,2,-13,0,0,0
1,-13,14,1,0,1
24,39,-15,0,0,0
-37,-40,3,1,0,1
31,42,-11,0,0,0
-4,-1,-3,0,0,0
19,13,6,1,0,1
-10,9,-19,0,0,0
1,-19,20,1,0,1
43,24,19,1,0,1
17,21,-4,0,0,0
-14,-4,-10,0,0,0
-1,8,-9,0,0,0
-8,10,-18,0,0,0
-30,-36,6,1,0,1
31,20,11,1,0,1
48,29,19,1,0,1
20,6,14,1,0,1
-55,-36,-19,0,0,0
-2,8,-10,0,1,1
-60,-42,-18,0,1,1
-49,-45,-4,0,1,1
-25,-19,-6,0,1,1
8,23,-15,0,1,1
-11,-22,11,1,1,0
-62,-45,-17,0,1,1
-30,-15,-15,0,1,1
37,21,16,1,1,0
-22,-14,-8,0,1,1
-12,-6,-6,0,1,1
-15,1,-16,0,1,1
19,7,12,1,1,0
-22,-24,2,1,1,0
-6,-18,12,1,0,1
13,20,-7,0,0,0
7,-1,8,1,0,1
30,30,0,0,0,0
-23,-38,15,1,0,1
2,-16,18,1,0,1
28,26,2,1,0,1
-15,-22,7,1,0,1
20,21,-1,0,0,0
-38,-44,6,1,0,1
-9,-9,0,0,0,0
-10,-25,15,1,0,1
12,24,-12,0,0,0
27,21,6,1,0,1
18,1,17,1,0,1
20,33,-13,0,0,0
-43,-37,-6,0,0,0
-7,-1,-6,0,0,0
-19,-26,7,1,0,1
-10,8,-18,0,0,0
-33,-45,12,1,0,1
16,32,-16,0,1,1
55,37,18,1,1,0
-44,-44,0,0,1,1
5,3,2,1,1,0
9,2,7,1,1,0
-2,-19,17,1,1,0
5,8,-3,0,1,1
-19,-9,-10,0,1,1
8,-1,9,1,1,0
15,18,-3,0,1,1
3,-3,6,1,1,0
-43,-40,-3,0,1,1
-48,-35,-13,0,1,1
-21,-40,19,1,0,1
25,26,-1,0,0,0
-6,-23,17,1,0,1
10,24,-14,0,0,0
53,35,18,1,0,1
22,33,-11,0,0,0
1,7,-6,0,0,0
-8,12,-20,0,0,0
30,20,10,1,0,1
42,37,5,1,0,1
-28,-32,4,1,0,1
4,-11,15,1,0,1
-27,-13,-14,0,0,0
52,34,18,1,0,1
20,16,4,1,0,1
-11,-7,-4,0,0,0
-31,-36,5,1,0,1
-25,-25,0,0,0,0
22,11,11,1,0,1
7,-9,16,1,0,1
-27,-12,-15,0,0,0
-5,-15,10,1,1,0
28,26,2,1,1,0
16,9,7,1,1,0
-40,-38,-2,0,1,1
26,6,20,1,1,0
-36,-21,-15,0,1,1
-34,-30,-4,0,1,1
28,13,15,1,1,0
-37,-27,-10,0,1,1
19,14,5,1,1,0
-2,-20,18,1,1,0
7,24,-17,0,1,1
-14,-27,13,1,1,0
19,18,1,1,0,1
-40,-27,-13,0,0,0
32,23,9,1,0,1
53,35,18,1,0,1
13,29,-16,0,0,0
-4,16,-20,0,0,0
-6,-16,10,1,0,1
-35,-43,8,1,0,1
7,-7,14,1,1,0
-17,-31,14,1,1,0
-24,-41,17,1,1,0
19,0,19,1,1,0
21,19,2,1,1,0
35,19,16,1,1,0
38,32,6,1,1,0
20,25,-5,0,1,1
3,6,-3,0,1,1
5,11,-6,0,1,1
48,33,15,1,1,0
26,34,-8,0,1,1
-30,-35,5,1,1,0
39,37,2,1,0,1
34,30,4,1,0,1
-5,-1,-4,0,0,0
-22,-28,6,1,0,1
20,34,-14,0,0,0
9,7,2,1,0,1
33,32,1,1,0,1
-23,-35,12,1,0,1
12,-7,19,1,0,1
-21,-41,20,1,0,1
-17,-17,0,0,0,0
39,37,2,1,0,1
-1,-7,6,1,0,1
3,-10,13,1,0,1
17,2,15,1,0,1
-21,-10,-11,0,0,0
37,27,10,1,0,1
16,32,-16,0,0,0
4,1,3,1,0,1
-19,-13,-6,0,1,1
20,9,11,1,1,0
11,10,1,1,1,0
24,20,4,1,1,0
-47,-27,-20,0,1,1
22,37,-15,0,1,1
11,22,-11,0,1,1
-31,-44,13,1,1,0
-6,-1,-5,0,1,1
-9,-3,-6,0,1,1
-35,-41,6,1,1,0
-32,-23,-9,0,0,0
-16,-33,17,1,0,1
-22,-24,2,1,0,1
-18,-38,20,1,0,1
-27,-12,-15,0,0,0
44,43,1,1,0,1
26,40,-14,0,0,0
-5,-10,5,1,0,1
48,44,4,1,0,1
-23,-35,12,1,0,1
-36,-24,-12,0,0,0
22,21,1,1,0,1
-5,-24,19,1,1,0
-27,-29,2,1,1,0
-45,-34,-11,0,1,1
44,40,4,1,1,0
-19,-22,3,1,1,0
-12,-10,-2,0,1,1
22,34,-12,0,1,1
25,7,18,1,1,0
47,42,5,1,1,0
-45,-35,-10,0,1,1
-34,-23,-11,0,1,1
60,43,17,1,1,0
-3,-7,4,1,1,0
-2,3,-5,0,1,1
31,33,-2,0,1,1
-32,-39,7,1,1,0
-23,-29,6,1,1,0
36,25,11,1,1,0
-59,-45,-14,0,1,1
-7,-1,-6,0,1,1
-28,-33,5,1,1,0
54,39,15,1,0,1
-54,-41,-13,0,0,0
-6,-13,7,1,0,1
-19,-20,1,1,0,1
-55,-44,-11,0,0,0
-41,-31,-10,0,0,0
9,7,2,1,0,1
43,35,8,1,0,1
14,18,-4,0,0,0
42,31,11,1,0,1
7,-9,16,1,0,1
-26,-30,4,1,0,1
-14,-13,-1,0,0,0
-13,1,-14,0,0,0
-38,-24,-14,0,0,0
20,9,11,1,0,1
-37,-32,-5,0,0,0
-26,-40,14,1,0,1
27,42,-15,0,0,0
-4,-21,17,1,0,1
-31,-40,9,1,0,1
-31,-26,-5,0,1,1
-15,-15,0,0,1,1
26,17,9,1,1,0
9,5,4,1,1,0
42,27,15,1,1,0
-8,-17,9,1,1,0
-8,-24,16,1,1,0
21,25,-4,0,1,1
-9,-5,-4,0,1,1
45,31,14,1,1,0
23,20,3,1,1,0
27,44,-17,0,0,0
-25,-8,-17,0,0,0
-19,-1,-18,0,0,0
-11,6,-17,0,0,0
-38,-25,-13,0,0,0
2,21,-19,0,0,0
20,15,5,1,0,1
-54,-35,-19,0,0,0
-23,-37,14,1,0,1
8,25,-17,0,0,0
-26,-17,-9,0,0,0
-32,-12,-20,0,1,1
34,40,-6,0,1,1
3,-4,7,1,1,0
-53,-33,-20,0,1,1
22,9,13,1,1,0
25,24,1,1,1,0
-47,-30,-17,0,1,1
-1,-7,6,1,1,0
-48,-39,-9,0,1,1
8,13,-5,0,1,1
-21,-5,-16,0,1,1
-33,-18,-15,0,0,0
59,44,15,1,0,1
-10,4,-14,0,0,0
37,43,-6,0,0,0
-15,-8,-7,0,0,0
-57,-41,-16,0,0,0
-5,1,-6,0,0,0
-43,-42,-1,0,0,0
-51,-31,-20,0,0,0
17,7,10,1,0,1
-15,-16,1,1,0,1
3,-3,6,1,0,1
-20,-29,9,1,0,1
-31,-25,-6,0,0,0
-28,-37,9,1,0,1
-8,-6,-2,0,0,0
18,20,-2,0,0,0
9,1,8,1,1,0
-33,-28,-5,0,1,1
27,39,-12,0,1,1
26,17,9,1,1,0
4,-11,15,1,1,0
-44,-33,-11,0,1,1
4,18,-14,0,1,1
-9,-22,13,1,1,0
-4,4,-8,0,1,1
10,29,-19,0,0,0
31,22,9,1,0,1
24,26,-2,0,0,0
-7,-26,19,1,0,1
38,40,-2,0,0,0
3,0,3,1,0,1
30,31,-1,0,0,0
-2,-16,14,1,0,1
48,28,20,1,1,0
31,43,-12,0,1,1
-55,-43,-12,0,1,1
-10,3,-13,0,1,1
2,-18,20,1,1,0
-35,-31,-4,0,1,1
-38,-36,-2,0,1,1
2,10,-8,0,1,1
-32,-43,11,1,1,0
-43,-39,-4,0,1,1
-53,-42,-11,0,1,1
40,40,0,0,1,1
33,27,6,1,1,0
56,42,14,1,1,0
-14,-26,12,1,1,0
-26,-29,3,1,1,0
-6,9,-15,0,0,0
15,7,8,1,0,1
-22,-4,-18,0,0,0
-13,4,-17,0,0,0
17,22,-5,0,0,0
24,14,10,1,0,1
-29,-16,-13,0,0,0
20,13,7,1,0,1
-13,2,-15,0,0,0
46,35,11,1,0,1
-2,17,-19,0,0,0
-28,-17,-11,0,1,1
-40,-36,-4,0,1,1
-11,0,-11,0,1,1
34,44,-10,0,1,1
-22,-35,13,1,1,0
15,-1,16,1,1,0
-41,-39,-2,0,1,1
-56,-38,-18,0,1,1
-25,-9,-16,0,1,1
11,3,8,1,1,0
57,38,19,1,0,1
-16,-29,13,1,0,1
2,14,-12,0,0,0
-23,-23,0,0,0,0
-22,-21,-1,0,0,0
57,40,17,1,0,1
-12,5,-17,0,0,0
21,30,-9,0,0,0
20,8,12,1,0,1
23,26,-3,0,0,0
47,39,8,1,0,1
-3,-7,4,1,0,1
22,40,-18,0,0,0
20,8,12,1,1,0
24,40,-16,0,1,1
-20,-3,-17,0,1,1
6,-4,10,1,1,0
-28,-25,-3,0,1,1
-15,-3,-12,0,1,1
-10,-10,0,0,1,1
-7,-15,8,1,1,0
-14,-12,-2,0,1,1
53,44,9,1,1,0
44,38,6,1,1,0
-10,6,-16,0,1,1
-57,-38,-19,0,1,1
-1,-20,19,1,1,0
12,7,5,1,0,1
7,-7,14,1,0,1
15,13,2,1,0,1
31,30,1,1,0,1
-4,14,-18,0,0,0
12,0,12,1,0,1
-16,-16,0,0,0,0
1,9,-8,0,0,0
-16,-1,-15,0,0,0
-13,-2,-11,0,0,0
-5,-9,4,1,0,1
-13,-24,11,1,0,1
-23,-4,-19,0,0,0
31,26,5,1,0,1
53,40,13,1,0,1
-31,-14,-17,0,0,0
-31,-29,-2,0,0,0
-29,-43,14,1,1,0
-20,-3,-17,0,1,1
51,39,12,1,1,0
4,1,3,1,1,0
-31,-26,-5,0,1,1
29,28,1,1,1,0
-12,-25,13,1,1,0
30,12,18,1,1,0
2,-15,17,1,1,0
-37,-18,-19,0,1,1
-2,7,-9,0,1,1
-39,-42,3,1,1,0
-1,4,-5,0,1,1
9,24,-15,0,1,1
16,21,-5,0,1,1
-32,-23,-9,0,0,0
3,2,1,1,0,1
25,17,8,1,0,1
7,23,-16,0,0,0
5,-15,20,1,0,1
-16,0,-16,0,0,0
-6,10,-16,0,0,0
-9,-26,17,1,0,1
-6,-2,-4,0,0,0
-37,-36,-1,0,0,0
25,6,19,1,0,1
54,43,11,1,0,1
-18,-19,1,1,0,1
-31,-44,13,1,0,1
4,22,-18,0,0,0
-20,-24,4,1,0,1
9,23,-14,0,0,0
-10,2,-12,0,0,0
16,7,9,1,1,0
46,35,11,1,1,0
-4,-1,-3,0,1,1
-29,-18,-11,0,1,1
15,33,-18,0,1,1
43,43,0,0,1,1
-5,-1,-4,0,1,1
54,34,20,1,1,0
34,19,15,1,1,0
41,41,0,0,1,1
24,24,0,0,1,1
-1,-2,1,1,1,0
26,8,18,1,1,0
21,13,8,1,1,0
37,20,17,1,1,0
-53,-33,-20,0,1,1
-20,-13,-7,0,1,1
-39,-38,-1,0,0,0
-33,-26,-7,0,0,0
34,32,2,1,0,1
8,23,-15,0,0,0
18,17,1,1,0,1
-4,-7,3,1,0,1
-1,-7,6,1,0,1
-16,3,-19,0,0,0
17,-2,19,1,0,1
51,31,20,1,0,1
-11,-27,16,1,1,0
35,38,-3,0,1,1
13,13,0,0,1,1
-3,13,-16,0,1,1
-5,6,-11,0,1,1
-11,7,-18,0,1,1
47,39,8,1,1,0
42,37,5,1,1,0
-35,-31,-4,0,1,1
38,32,6,1,0,1
26,37,-11,0,0,0
2,15,-13,0,0,0
-13,-30,17,1,0,1
-26,-13,-13,0,0,0
55,39,16,1,0,1
-40,-22,-18,0,0,0
23,27,-4,0,0,0
28,29,-1,0,0,0
-13,6,-19,0,0,0
10,8,2,1,0,1
1,-15,16,1,1,0
-22,-18,-4,0,1,1
-2,14,-16,0,1,1
-52,-45,-7,0,1,1
-63,-45,-18,0,1,1
27,32,-5,0,1,1
31,30,1,1,1,0
-36,-18,-18,0,1,1
26,12,14,1,1,0
-24,-31,7,1,1,0
34,24,10,1,1,0
43,38,5,1,1,0
37,43,-6,0,1,1
10,9,1,1,1,0
-27,-35,8,1,1,0
9,28,-19,0,1,1
39,22,17,1,1,0
-63,-43,-20,0,1,1
-4,-9,5,1,1,0
41,35,6,1,1,0
25,18,7,1,0,1
22,28,-6,0,0,0
29,33,-4,0,0,0
23,8,15,1,0,1
23,19,4,1,0,1
-3,-23,20,1,0,1
19,9,10,1,0,1
12,21,-9,0,0,0
-36,-32,-4,0,0,0
55,44,11,1,0,1
45,41,4,1,0,1
9,-10,19,1,0,1
48,42,6,1,0,1
25,20,5,1,0,1
-24,-31,7,1,0,1
14,2,12,1,0,1
-5,7,-12,0,0,0
50,42,8,1,0,1
-27,-19,-8,0,0,0
-47,-30,-17,0,0,0
-21,-26,5,1,1,0
-27,-35,8,1,1,0
31,19,12,1,1,0
-48,-39,-9,0,1,1
23,5,18,1,1,0
54,40,14,1,1,0
-27,-43,16,1,1,0
49,36,13,1,1,0
-8,-21,13,1,1,0
24,14,10,1,1,0
24,18,6,1,1,0
40,27,13,1,1,0
-21,-25,4,1,1,0
0,-5,5,1,1,0
29,18,11,1,1,0
-47,-43,-4,0,1,1
-19,-19,0,0,0,0
-35,-31,-4,0,0,0
10,27,-17,0,0,0
3,-14,17,1,0,1
9,-2,11,1,0,1
-33,-19,-14,0,0,0
-52,-38,-14,0,0,0
56,37,19,1,0,1
21,3,18,1,0,1
-11,-14,3,1,0,1
24,22,2,1,0,1
-27,-26,-1,0,0,0
9,-11,20,1,0,1
-20,-27,7,1,0,1
28,11,17,1,0,1
9,17,-8,0,0,0
-4,-19,15,1,0,1
19,8,11,1,0,1
34,23,11,1,0,1
-12,3,-15,0,0,0
52,43,9,1,0,1
9,22,-13,0,1,1
46,27,19,1,1,0
-16,-16,0,0,1,1
22,37,-15,0,1,1
7,21,-14,0,1,1
-3,1,-4,0,1,1
42,25,17,1,1,0
4,1,3,1,1,0
-41,-37,-4,0,1,1
34,36,-2,0,1,1
60,41,19,1,0,1
28,10,18,1,0,1
-13,-6,-7,0,0,0
25,24,1,1,0,1
6,-14,20,1,0,1
-41,-44,3,1,0,1
1,0,1,1,0,1
-58,-41,-17,0,0,0
-25,-42,17,1,0,1
40,23,17,1,0,1
50,33,17,1,0,1
22,27,-5,0,0,0
-34,-21,-13,0,0,0
-35,-36,1,1,0,1
32,24,8,1,0,1
-26,-43,17,1,0,1
-11,8,-19,0,1,1
37,27,10,1,1,0
19,32,-13,0,1,1
5,20,-15,0,1,1
24,10,14,1,1,0
7,-9,16,1,1,0
-4,-10,6,1,1,0
45,38,7,1,1,0
8,20,-12,0,1,1
-17,-33,16,1,1,0
-32,-12,-20,0,0,0
-51,-43,-8,0,0,0
14,20,-6,0,0,0
25,32,-7,0,0,0
-63,-44,-19,0,0,0
-22,-10,-12,0,0,0
-22,-33,11,1,0,1
-33,-42,9,1,0,1
37,34,3,1,0,1
27,19,8,1,0,1
20,37,-17,0,0,0
-13,-12,-1,0,0,0
-3,6,-9,0,0,0
7,-10,17,1,1,0
-53,-37,-16,0,1,1
-38,-31,-7,0,1,1
5,-13,18,1,1,0
40,27,13,1,1,0
36,43,-7,0,1,1
-33,-24,-9,0,1,1
-27,-21,-6,0,1,1
21,20,1,1,1,0
-15,-5,-10,0,0,0
46,27,19,1,0,1
-25,-40,15,1,0,1
41,33,8,1,0,1
-2,16,-18,0,0,0
10,14,-4,0,0,0
35,32,3,1,0,1
56,43,13,1,0,1
18,13,5,1,1,0
-24,-40,16,1,1,0
-14,-9,-5,0,1,1
-27,-27,0,0,1,1
-19,-38,19,1,1,0
-11,-17,6,1,1,0
-36,-44,8,1,1,0
16,11,5,1,1,0
30,33,-3,0,1,1
-26,-7,-19,0,1,1
-19,0,-19,0,0,0
-24,-41,17,1,0,1
30,34,-4,0,0,0
7,12,-5,0,0,0
-25,-23,-2,0,0,0
25,42,-17,0,0,0
-23,-9,-14,0,0,0
-37,-19,-18,0,0,0
-22,-15,-7,0,0,0
-7,-13,6,1,0,1
-44,-36,-8,0,0,0
22,9,13,1,0,1
7,27,-20,0,0,0
55,44,11,1,0,1
17,37,-20,0,0,0
-15,-5,-10,0,0,0
32,22,10,1,0,1
-43,-29,-14,0,0,0
-17,-8,-9,0,0,0
5,4,1,1,0,1
-34,-32,-2,0,1,1
35,15,20,1,1,0
18,9,9,1,1,0
-50,-33,-17,0,1,1
-36,-42,6,1,1,0
-15,-34,19,1,1,0
45,27,18,1,1,0
9,6,3,1,1,0
25,29,-4,0,0,0
41,28,13,1,0,1
5,9,-4,0,0,0
10,26,-16,0,0,0
-36,-43,7,1,0,1
33,37,-4,0,0,0
47,44,3,1,0,1
46,43,3,1,0,1
-54,-37,-17,0,0,0
-7,8,-15,0,0,0
-3,-17,14,1,0,1
16,0,16,1,0,1
-3,-20,17,1,0,1
-13,-6,-7,0,0,0
-25,-31,6,1,0,1
39,21,18,1,0,1
-33,-43,10,1,0,1
-15,-15,0,0,0,0
-9,0,-9,0,1,1
41,37,4,1,1,0
-15,4,-19,0,1,1
9,1,8,1,1,0
-16,-7,-9,0,1,1
26,35,-9,0,1,1
-7,-25,18,1,1,0
29,44,-15,0,1,1
13,25,-12,0,1,1
39,38,1,1,1,0
10,9,1,1,1,0
-36,-36,0,0,1,1
-21,-12,-9,0,1,1
21,7,14,1,1,0
-22,-24,2,1,1,0
17,27,-10,0,1,1
-15,1,-16,0,1,1
9,-6,15,1,1,0
15,32,-17,0,1,1
-12,-18,6,1,1,0
10,28,-18,0,0,0
11,4,7,1,0,1
19,10,9,1,0,1
33,41,-8,0,0,0
-22,-3,-19,0,0,0
-10,10,-20,0,0,0
-15,-32,17,1,0,1
29,19,10,1,0,1
-7,-24,17,1,0,1
-13,-23,10,1,0,1
-26,-15,-11,0,0,0
23,16,7,1,0,1
26,13,13,1,1,0
-7,-24,17,1,1,0
8,-1,9,1,1,0
12,16,-4,0,1,1
26,21,5,1,1,0
-41,-41,0,0,1,1
-44,-26,-18,0,1,1
9,23,-14,0,1,1
5,13,-8,0,1,1
43,33,10,1,1,0
-24,-7,-17,0,1,1
-23,-36,13,1,1,0
-14,-32,18,1,1,0
3,-6,9,1,1,0
-13,-13,0,0,1,1
-37,-21,-16,0,1,1
-40,-30,-10,0,1,1
-17,-10,-7,0,1,1
-19,-19,0,0,1,1
-29,-32,3,1,1,0
-20,-40,20,1,1,0
59,39,20,1,0,1
43,44,-1,0,0,0
-15,-22,7,1,0,1
-48,-28,-20,0,0,0
-41,-36,-5,0,0,0
-40,-28,-12,0,0,0
-23,-18,-5,0,0,0
-13,-22,9,1,0,1
-17,-10,-7,0,0,0
-33,-18,-15,0,1,1
-9,6,-15,0,1,1
-6,-20,14,1,1,0
10,-3,13,1,1,0
26,11,15,1,1,0
31,33,-2,0,1,1
9,24,-15,0,1,1
-38,-45,7,1,1,0
1,16,-15,0,1,1
-49,-32,-17,0,0,0
-35,-37,2,1,0,1
-13,0,-13,0,0,0
-59,-41,-18,0,0,0
-24,-34,10,1,0,1
10,27,-17,0,0,0
25,23,2,1,0,1
-33,-44,11,1,0,1
6,4,2,1,0,1
1,-19,20,1,0,1
25,27,-2,0,0,0
-16,4,-20,0,0,0
32,28,4,1,0,1
15,31,-16,0,0,0
-27,-30,3,1,0,1
39,31,8,1,0,1
24,26,-2,0,0,0
24,33,-9,0,0,0
-8,-15,7,1,0,1
-43,-34,-9,0,0,0
22,7,15,1,0,1
-9,-6,-3,0,1,1
48,37,11,1,1,0
47,28,19,1,1,0
-9,6,-15,0,1,1
6,-11,17,1,1,0
-33,-31,-2,0,1,1
-33,-21,-12,0,1,1
-36,-34,-2,0,1,1
38,19,19,1,1,0
9,-10,19,1,1,0
-50,-32,-18,0,1,1
3,-3,6,1,1,0
-26,-22,-4,0,1,1
-24,-29,5,1,1,0
-53,-33,-20,0,1,1
-1,6,-7,0,1,1
-22,-18,-4,0,1,1
-18,-12,-6,0,1,1
52,44,8,1,1,0
35,17,18,1,1,0
10,20,-10,0,1,1
22,8,14,1,0,1
21,30,-9,0,0,0
26,26,0,0,0,0
-27,-12,-15,0,0,0
1,6,-5,0,0,0
45,36,9,1,0,1
17,35,-18,0,0,0
-27,-8,-19,0,0,0
-55,-41,-14,0,0,0
10,16,-6,0,0,0
-1,-4,3,1,0,1
-15,-12,-3,0,0,0
61,41,20,1,0,1
0,16,-16,0,0,0
-8,-14,6,1,0,1
-21,-23,2,1,0,1
-49,-43,-6,0,0,0
11,8,3,1,0,1
-4,-24,20,1,0,1
-14,-34,20,1,0,1
-7,-24,17,1,0,1
-14,-25,11,1,1,0
12,3,9,1,1,0
-50,-31,-19,0,1,1
6,5,1,1,1,0
24,13,11,1,1,0
47,43,4,1,1,0
-37,-36,-1,0,1,1
-46,-40,-6,0,1,1
27,14,13,1,0,1
11,7,4,1,0,1
27,13,14,1,0,1
-5,-23,18,1,0,1
5,23,-18,0,0,0
38,21,17,1,0,1
15,29,-14,0,0,0
-22,-37,15,1,0,1
16,27,-11,0,0,0
9,17,-8,0,0,0
-23,-33,10,1,0,1
16,29,-13,0,0,0
-28,-40,12,1,0,1
49,41,8,1,0,1
26,29,-3,0,1,1
-59,-42,-17,0,1,1
4,11,-7,0,1,1
58,38,20,1,1,0
48,34,14,1,1,0
-4,0,-4,0,1,1
4,2,2,1,1,0
48,33,15,1,1,0
-36,-37,1,1,1,0
-2,12,-14,0,1,1
26,39,-13,0,1,1
-35,-31,-4,0,1,1
6,0,6,1,1,0
39,32,7,1,1,0
-38,-19,-19,0,1,1
46,33,13,1,1,0
13,30,-17,0,1,1
-2,-11,9,1,0,1
-16,-6,-10,0,0,0
28,29,-1,0,0,0
9,7,2,1,0,1
38,30,8,1,0,1
2,20,-18,0,0,0
30,37,-7,0,0,0
5,7,-2,0,0,0
-42,-23,-19,0,0,0
-27,-7,-20,0,0,0
4,2,2,1,0,1
-12,7,-19,0,0,0
-57,-42,-15,0,0,0
6,12,-6,0,0,0
-46,-40,-6,0,0,0
-41,-32,-9,0,0,0
-33,-32,-1,0,1,1
45,29,16,1,1,0
31,11,20,1,1,0
-35,-23,-12,0,1,1
22,23,-1,0,1,1
-13,-26,13,1,1,0
34,30,4,1,1,0
-15,-29,14,1,1,0
4,11,-7,0,1,1
0,-4,4,1,1,0
34,32,2,1,1,0
-5,-11,6,1,1,0
42,27,15,1,1,0
2,-7,9,1,1,0
-31,-41,10,1,1,0
-48,-45,-3,0,1,1
16,33,-17,0,1,1
-23,-9,-14,0,1,1
-22,-10,-12,0,1,1
-31,-36,5,1,1,0
-50,-39,-11,0,1,1
9,18,-9,0,0,0
-35,-15,-20,0,0,0
23,32,-9,0,0,0
-31,-17,-14,0,0,0
-13,-10,-3,0,0,0
-6,2,-8,0,0,0
-29,-32,3,1,0,1
18,20,-2,0,0,0
-46,-30,-16,0,0,0
-8,-9,1,1,0,1
36,44,-8,0,0,0
16,22,-6,0,0,0
-6,-4,-2,0,1,1
4,23,-19,0,1,1
-1,15,-16,0,1,1
6,26,-20,0,1,1
-20,-8,-12,0,1,1
1,20,-19,0,1,1
-46,-30,-16,0,1,1
-55,-40,-15,0,1,1
-24,-10,-14,0,0,0
-5,-2,-3,0,0,0
24,13,11,1,0,1
28,24,4,1,0,1
-33,-13,-20,0,0,0
-44,-43,-1,0,0,0
-17,-8,-9,0,0,0
-21,-8,-13,0,0,0
-46,-36,-10,0,0,0
28,13,15,1,0,1
-15,-3,-12,0,0,0
-4,-13,9,1,0,1
19,1,18,1,0,1
35,43,-8,0,0,0
37,29,8,1,0,1
12,16,-4,0,0,0
-1,13,-14,0,0,0
-29,-35,6,1,0,1
-29,-12,-17,0,0,0
13,10,3,1,0,1
6,-11,17,1,0,1
-6,-2,-4,0,1,1
35,36,-1,0,1,1
-11,3,-14,0,1,1
5,22,-17,0,1,1
-7,-1,-6,0,1,1
-28,-23,-5,0,1,1
7,-9,16,1,1,0
-37,-44,7,1,1,0
8,24,-16,0,1,1
46,43,3,1,1,0
-38,-41,3,1,1,0
32,41,-9,0,1,1
-22,-39,17,1,1,0
31,43,-12,0,1,1
-2,-21,19,1,1,0
32,35,-3,0,1,1
6,10,-4,0,1,1
-43,-38,-5,0,1,1
-26,-41,15,1,1,0
34,30,4,1,1,0
-43,-33,-10,0,1,1
-24,-28,4,1,0,1
19,0,19,1,0,1
28,17,11,1,0,1
5,1,4,1,0,1
11,13,-2,0,0,0
46,34,12,1,0,1
-15,-2,-13,0,0,0
-3,-1,-2,0,0,0
-32,-44,12,1,0,1
-23,-12,-11,0,0,0
1,19,-18,0,1,1
1,13,-12,0,1,1
-13,-8,-5,0,1,1
18,26,-8,0,1,1
37,39,-2,0,1,1
32,29,3,1,1,0
24,22,2,1,1,0
18,33,-15,0,1,1
16,8,8,1,1,0
15,35,-20,0,1,1
-47,-45,-2,0,0,0
18,21,-3,0,0,0
15,14,1,1,0,1
-51,-42,-9,0,0,0
51,32,19,1,0,1
11,24,-13,0,0,0
-12,-1,-11,0,0,0
32,43,-11,0,0,0
42,32,10,1,0,1
-21,-16,-5,0,0,0
36,42,-6,0,0,0
37,17,20,1,0,1
-54,-38,-16,0,0,0
20,9,11,1,0,1
17,19,-2,0,0,0
19,25,-6,0,0,0
10,3,7,1,0,1
-16,-5,-11,0,0,0
-16,-1,-15,0,0,0
33,42,-9,0,0,0
-18,-38,20,1,0,1
-12,-7,-5,0,1,1
-16,-8,-8,0,1,1
-24,-12,-12,0,1,1
-13,-10,-3,0,1,1
20,3,17,1,1,0
10,-8,18,1,1,0
-15,1,-16,0,1,1
-7,-17,10,1,1,0
-1,-10,9,1,1,0
-22,-3,-19,0,0,0
4,3,1,1,0,1
43,34,9,1,0,1
17,26,-9,0,0,0
-55,-42,-13,0,0,0
-22,-25,3,1,0,1
22,26,-4,0,0,0
-2,13,-15,0,0,0
-46,-40,-6,0,0,0
-38,-18,-20,0,0,0
10,7,3,1,0,1
48,30,18,1,0,1
4,10,-6,0,0,0
30,43,-13,0,0,0
-43,-34,-9,0,0,0
12,25,-13,0,0,0
-7,-19,12,1,1,0
-9,-17,8,1,1,0
-48,-37,-11,0,1,1
-43,-26,-17,0,1,1
-25,-42,17,1,1,0
25,6,19,1,1,0
2,-12,14,1,1,0
37,38,-1,0,1,1
-27,-9,-18,0,1,1
4,-12,16,1,1,0
39,43,-4,0,1,1
1,-14,15,1,1,0
-35,-39,4,1,1,0
16,34,-18,0,1,1
-2,18,-20,0,1,1
20,19,1,1,1,0
20,1,19,1,1,0
11,21,-10,0,1,1
-32,-32,0,0,1,1
-1,-10,9,1,1,0
46,44,2,1,0,1
-13,-13,0,0,0,0
45,35,10,1,0,1
18,15,3,1,0,1
-19,-4,-15,0,0,0
-34,-28,-6,0,0,0
-10,-29,19,1,0,1
-23,-32,9,1,0,1
44,27,17,1,0,1
47,43,4,1,0,1
-12,2,-14,0,0,0
-55,-40,-15,0,0,0
14,19,-5,0,0,0
14,26,-12,0,0,0
-9,-17,8,1,0,1
45,35,10,1,0,1
4,-6,10,1,0,1
-22,-29,7,1,0,1
17,1,16,1,1,0
2,2,0,0,1,1
18,32,-14,0,1,1
32,21,11,1,1,0
-3,-16,13,1,1,0
33,21,12,1,1,0
0,19,-19,0,1,1
24,31,-7,0,1,1
-46,-34,-12,0,1,1
-37,-21,-16,0,1,1
-19,-23,4,1,1,0
-3,-17,14,1,1,0
27,17,10,1,1,0
-14,-25,11,1,1,0
28,16,12,1,1,0
-8,0,-8,0,1,1
-46,-33,-13,0,1,1
-26,-24,-2,0,1,1
28,33,-5,0,1,1
-19,-34,15,1,1,0
17,5,12,1,1,0
34,17,17,1,0,1
31,43,-12,0,0,0
15,35,-20,0,0,0
-17,-22,5,1,0,1
1,20,-19,0,0,0
48,39,9,1,0,1
-24,-33,9,1,0,1
18,-1,19,1,0,1
47,37,10,1,1,0
5,3,2,1,1,0
-28,-39,11,1,1,0
-29,-21,-8,0,1,1
46,35,11,1,1,0
-27,-28,1,1,1,0
41,36,5,1,1,0
-18,-11,-7,0,1,1
22,3,19,1,1,0
-40,-42,2,1,1,0
24,42,-18,0,1,1
-9,-21,12,1,0,1
12,13,-1,0,0,0
7,-3,10,1,0,1
12,-3,15,1,0,1
5,-6,11,1,0,1
47,35,12,1,0,1
-29,-21,-8,0,0,0
-9,3,-12,0,0,0
-1,3,-4,0,0,0
-61,-41,-20,0,0,0
38,32,6,1,0,1
-28,-16,-12,0,0,0
-3,10,-13,0,1,1
50,38,12,1,1,0
0,9,-9,0,1,1
-11,-27,16,1,1,0
-15,-25,10,1,1,0
-10,5,-15,0,1,1
28,31,-3,0,1,1
-13,-1,-12,0,1,1
-28,-33,5,1,1,0
6,3,3,1,1,0
28,9,19,1,1,0
-4,2,-6,0,1,1
-27,-29,2,1,1,0
-17,-1,-16,0,1,1
46,31,15,1,1,0
-29,-38,9,1,0,1
-4,-19,15,1,0,1
24,22,2,1,0,1
-22,-7,-15,0,0,0
-26,-41,15,1,0,1
49,31,18,1,0,1
-24,-37,13,1,0,1
-17,-13,-4,0,0,0
18,25,-7,0,0,0
18,28,-10,0,0,0
-41,-40,-1,0,0,0
-14,-2,-12,0,0,0
49,31,18,1,0,1
-8,6,-14,0,0,0
7,-9,16,1,1,0
27,31,-4,0,1,1
-1,9,-10,0,1,1
47,34,13,1,1,0
-32,-13,-19,0,1,1
12,18,-6,0,1,1
25,16,9,1,1,0
34,19,15,1,1,0
-17,-8,-9,0,1,1
-30,-13,-17,0,1,1
-41,-38,-3,0,1,1
60,40,20,1,1,0
-27,-11,-16,0,1,1
41,38,3,1,1,0
-4,-24,20,1,1,0
46,39,7,1,0,1
9,0,9,1,0,1
18,33,-15,0,0,0
7,22,-15,0,0,0
-33,-38,5,1,0,1
-16,-10,-6,0,0,0
-21,-39,18,1,0,1
19,13,6,1,0,1
-27,-7,-20,0,0,0
-8,-26,18,1,0,1
-19,-9,-10,0,0,0
-13,-10,-3,0,0,0
-6,-26,20,1,1,0
-1,-21,20,1,1,0
-5,-16,11,1,1,0
-6,-19,13,1,1,0
10,-3,13,1,1,0
-45,-36,-9,0,1,1
53,35,18,1,1,0
-20,-1,-19,0,1,1
26,38,-12,0,1,1
43,25,18,1,1,0
0,-17,17,1,1,0
-29,-13,-16,0,1,1
18,-1,19,1,1,0
-4,-4,0,0,1,1
25,44,-19,0,1,1
-23,-42,19,1,1,0
-4,-18,14,1,1,0
-36,-24,-12,0,1,1
39,33,6,1,1,0
14,34,-20,0,1,1
22,9,13,1,1,0
-37,-45,8,1,0,1
-38,-22,-16,0,0,0
-9,-15,6,1,0,1
13,21,-8,0,0,0
-34,-27,-7,0,0,0
-5,-11,6,1,0,1
5,1,4,1,0,1
-15,-35,20,1,0,1
35,33,2,1,0,1
15,2,13,1,0,1
-55,-45,-10,0,0,0
-43,-31,-12,0,0,0
-27,-41,14,1,0,1
13,12,1,1,0,1
8,-4,12,1,0,1
32,37,-5,0,0,0
-18,-25,7,1,0,1
58,41,17,1,0,1
22,42,-20,0,0,0
-5,12,-17,0,0,0
62,43,19,1,0,1
25,17,8,1,1,0
-11,-6,-5,0,1,1
54,41,13,1,1,0
-8,-19,11,1,1,0
-10,9,-19,0,1,1
32,16,16,1,1,0
-34,-43,9,1,1,0
-1,-15,14,1,1,0
36,18,18,1,1,0
-33,-28,-5,0,1,1
-20,-2,-18,0,1,1
19,7,12,1,1,0
43,34,9,1,1,0
40,43,-3,0,1,1
17,24,-7,0,1,1
37,42,-5,0,1,1
64,44,20,1,1,0
-14,-25,11,1,1,0
-56,-43,-13,0,1,1
5,-7,12,1,1,0
-37,-35,-2,0,1,1
7,6,1,1,0,1
51,44,7,1,0,1
-15,-13,-2,0,0,0
-20,-6,-14,0,0,0
-24,-39,15,1,0,1
26,43,-17,0,0,0
14,-5,19,1,0,1
4,-15,19,1,0,1
-35,-21,-14,0,0,0
21,41,-20,0,0,0
27,16,11,1,0,1
22,38,-16,0,0,0
7,-4,11,1,0,1
29,15,14,1,0,1
-18,1,-19,0,0,0
14,-6,20,1,0,1
-9,-13,4,1,0,1
-18,-15,-3,0,0,0
5,-7,12,1,0,1
-28,-23,-5,0,0,0
9,12,-3,0,0,0
33,37,-4,0,1,1
-16,-4,-12,0,1,1
-24,-17,-7,0,1,1
-43,-42,-1,0,1,1
-41,-37,-4,0,1,1
-4,16,-20,0,1,1
37,35,2,1,1,0
9,27,-18,0,1,1
30,43,-13,0,1,1
-43,-35,-8,0,1,1
0,-16,16,1,1,0
15,10,5,1,1,0
15,3,12,1,1,0
-24,-32,8,1,1,0
-11,-8,-3,0,1,1
-24,-42,18,1,1,0
36,38,-2,0,1,1
-23,-7,-16,0,1,1
-11,0,-11,0,1,1
14,7,7,1,1,0
36,42,-6,0,1,1
15,4,11,1,0,1
20,39,-19,0,0,0
-14,-14,0,0,0,0
-22,-36,14,1,0,1
-39,-24,-15,0,0,0
-4,-19,15,1,0,1
56,42,14,1,0,1
4,-6,10,1,0,1
-34,-26,-8,0,0,0
35,44,-9,0,0,0
18,26,-8,0,0,0
0,5,-5,0,0,0
62,43,19,1,0,1
-26,-31,5,1,0,1
33,33,0,0,0,0
22,36,-14,0,0,0
-31,-26,-5,0,0,0
11,23,-12,0,0,0
7,-5,12,1,0,1
-58,-40,-18,0,0,0
19,35,-16,0,0,0
36,33,3,1,1,0
-35,-28,-7,0,1,1
-16,-2,-14,0,1,1
-6,-26,20,1,1,0
-14,-29,15,1,1,0
0,8,-8,0,1,1
-13,7,-20,0,1,1
-22,-10,-12,0,1,1
21,26,-5,0,1,1
-22,-7,-15,0,1,1
-48,-40,-8,0,1,1
-44,-36,-8,0,1,1
6,-10,16,1,1,0
-19,-12,-7,0,1,1
9,25,-16,0,1,1
1,-19,20,1,0,1
32,14,18,1,0,1
47,29,18,1,0,1
51,33,18,1,0,1
10,4,6,1,0,1
13,4,9,1,0,1
14,6,8,1,0,1
40,41,-1,0,0,0
-24,-21,-3,0,0,0
7,-12,19,1,0,1
7,1,6,1,0,1
26,14,12,1,0,1
15,25,-10,0,0,0
-44,-29,-15,0,0,0
29,17,12,1,0,1
36,41,-5,0,0,0
57,37,20,1,0,1
-56,-45,-11,0,0,0
3,23,-20,0,0,0
31,17,14,1,0,1
35,41,-6,0,0,0
-21,-5,-16,0,1,1
-53,-40,-13,0,1,1
30,17,13,1,1,0
42,41,1,1,1,0
52,37,15,1,1,0
33,25,8,1,1,0
1,3,-2,0,1,1
45,35,10,1,1,0
-25,-28,3,1,1,0
31,27,4,1,1,0
9,19,-10,0,1,1
-36,-34,-2,0,1,1
-36,-28,-8,0,1,1
0,12,-12,0,1,1
-19,-32,13,1,0,1
-6,-12,6,1,0,1
6,-10,16,1,0,1
1,9,-8,0,0,0
55,38,17,1,0,1
-15,-35,20,1,0,1
-18,-36,18,1,0,1
26,33,-7,0,0,0
-27,-17,-10,0,0,0
8,11,-3,0,0,0
7,-8,15,1,0,1
-47,-34,-13,0,0,0
14,26,-12,0,0,0
-45,-36,-9,0,0,0
19,2,17,1,0,1
-4,-8,4,1,0,1
-53,-34,-19,0,0,0
-33,-41,8,1,0,1
43,38,5,1,0,1
-44,-40,-4,0,0,0
19,18,1,1,0,1
-21,-16,-5,0,1,1
52,42,10,1,1,0
-52,-36,-16,0,1,1
-28,-17,-11,0,1,1
-24,-15,-9,0,1,1
45,41,4,1,1,0
-11,7,-18,0,1,1
-15,-14,-1,0,1,1
36,21,15,1,1,0
29,36,-7,0,1,1
15,6,9,1,1,0
-37,-37,0,0,1,1
-17,-6,-11,0,1,1
14,8,6,1,0,1
17,20,-3,0,0,0
-8,6,-14,0,0,0
10,11,-1,0,0,0
-22,-39,17,1,0,1
-10,-10,0,0,0,0
31,28,3,1,0,1
30,18,12,1,0,1
-10,-14,4,1,0,1
-48,-38,-10,0,1,1
-32,-41,9,1,1,0
-25,-8,-17,0,1,1
36,37,-1,0,1,1
-2,13,-15,0,1,1
-12,-11,-1,0,1,1
24,41,-17,0,1,1
21,32,-11,0,1,1
-12,-27,15,1,1,0
54,36,18,1,1,0
-31,-30,-1,0,0,0
-47,-41,-6,0,0,0
44,25,19,1,0,1
-10,-23,13,1,0,1
1,14,-13,0,0,0
6,25,-19,0,0,0
-3,-11,8,1,0,1
3,-15,18,1,0,1
-7,-16,9,1,0,1
43,44,-1,0,0,0
-17,-7,-10,0,0,0
4,-6,10,1,0,1
21,29,-8,0,0,0
-18,-15,-3,0,0,0
39,33,6,1,0,1
29,44,-15,0,0,0
15,11,4,1,0,1
31,11,20,1,0,1
48,35,13,1,0,1
-9,-29,20,1,0,1
37,22,15,1,0,1
-33,-39,6,1,1,0
0,-15,15,1,1,0
-26,-8,-18,0,1,1
-56,-36,-20,0,1,1
-7,-7,0,0,1,1
8,-3,11,1,1,0
11,16,-5,0,1,1
0,-19,19,1,1,0
7,8,-1,0,0,0
-15,-8,-7,0,0,0
17,5,12,1,0,1
34,34,0,0,0,0
-26,-31,5,1,0,1
-24,-9,-15,0,0,0
-25,-12,-13,0,0,0
-3,-8,5,1,0,1
7,23,-16,0,1,1
18,9,9,1,1,0
42,44,-2,0,1,1
-28,-24,-4,0,1,1
20,23,-3,0,1,1
-21,-6,-15,0,1,1
-42,-28,-14,0,1,1
-42,-31,-11,0,1,1
-3,2,-5,0,1,1
28,26,2,1,1,0
30,38,-8,0,0,0
-41,-26,-15,0,0,0
-19,-9,-10,0,0,0
-50,-35,-15,0,0,0
27,28,-1,0,0,0
-19,-29,10,1,0,1
52,44,8,1,0,1
13,3,10,1,0,1
39,22,17,1,0,1
-34,-37,3,1,0,1
64,44,20,1,0,1
9,10,-1,0,0,0
52,39,13,1,1,0
2,-15,17,1,1,0
-34,-30,-4,0,1,1
-18,-24,6,1,1,0
-16,-34,18,1,1,0
21,15,6,1,1,0
-11,-2,-9,0,1,1
48,40,8,1,1,0
-52,-38,-14,0,1,1
-45,-27,-18,0,1,1
-36,-33,-3,0,1,1
13,27,-14,0,1,1
24,32,-8,0,1,1
5,2,3,1,0,1
-13,-33,20,1,0,1
-46,-44,-2,0,0,0
47,37,10,1,0,1
-56,-40,-16,0,0,0
-17,-16,-1,0,0,0
-2,5,-7,0,0,0
-11,-8,-3,0,0,0
-34,-22,-12,0,0,0
39,28,11,1,0,1
-10,-26,16,1,0,1
31,20,11,1,0,1
34,16,18,1,0,1
12,-6,18,1,0,1
8,22,-14,0,0,0
-4,14,-18,0,0,0
1,-8,9,1,0,1
32,36,-4,0,1,1
33,30,3,1,1,0
26,39,-13,0,1,1
-12,-1,-11,0,1,1
20,10,10,1,1,0
-34,-43,9,1,1,0
12,2,10,1,1,0
-57,-37,-20,0,1,1
26,43,-17,0,1,1
-7,-9,2,1,1,0
-4,0,-4,0,1,1
23,23,0,0,1,1
6,-4,10,1,1,0
42,28,14,1,0,1
39,43,-4,0,0,0
36,22,14,1,0,1
32,39,-7,0,0,0
60,41,19,1,0,1
37,30,7,1,0,1
27,30,-3,0,0,0
1,4,-3,0,0,0
30,22,8,1,0,1
-29,-33,4,1,0,1
-26,-37,11,1,0,1
9,21,-12,0,0,0
-15,-6,-9,0,0,0
13,20,-7,0,0,0
37,28,9,1,0,1
12,-7,19,1,0,1
12,32,-20,0,0,0
-38,-34,-4,0,0,0
-25,-41,16,1,0,1
32,43,-11,0,0,0
13,28,-15,0,1,1
28,29,-1,0,1,1
31,34,-3,0,1,1
37,42,-5,0,1,1
-36,-41,5,1,1,0
57,43,14,1,1,0
47,44,3,1,1,0
53,39,14,1,1,0
38,27,11,1,1,0
2,-15,17,1,1,0
35,20,15,1,1,0
-23,-9,-14,0,1,1
15,15,0,0,1,1
-14,0,-14,0,1,1
-28,-14,-14,0,1,1
44,32,12,1,0,1
23,36,-13,0,0,0
8,17,-9,0,0,0
-41,-34,-7,0,0,0
55,43,12,1,0,1
39,40,-1,0,0,0
-16,-24,8,1,0,1
24,41,-17,0,0,0
-9,5,-14,0,0,0
-37,-44,7,1,0,1
21,27,-6,0,0,0
-16,-25,9,1,0,1
54,43,11,1,0,1
9,11,-2,0,0,0
-33,-24,-9,0,0,0
-1,17,-18,0,0,0
1,11,-10,0,0,0
-54,-37,-17,0,1,1
-2,18,-20,0,1,1
-39,-40,1,1,1,0
16,0,16,1,1,0
42,36,6,1,1,0
8,6,2,1,1,0
-27,-21,-6,0,1,1
4,-14,18,1,1,0
-55,-45,-10,0,1,1
45,40,5,1,1,0
-26,-42,16,1,1,0
-38,-21,-17,0,1,1
-62,-43,-19,0,1,1
-1,19,-20,0,0,0
-18,0,-18,0,0,0
62,42,20,1,0,1
38,34,4,1,0,1
-13,-29,16,1,0,1
20,1,19,1,0,1
-41,-40,-1,0,0,0
-31,-45,14,1,0,1
-18,-21,3,1,0,1
10,-8,18,1,0,1
30,43,-13,0,0,0
-43,-26,-17,0,1,1
29,18,11,1,1,0
9,20,-11,0,1,1
-25,-7,-18,0,1,1
7,5,2,1,1,0
45,32,13,1,1,0
21,3,18,1,1,0
-23,-7,-16,0,1,1
1,-15,16,1,1,0
44,43,1,1,1,0
-43,-29,-14,0,1,1
1,-1,2,1,1,0
57,42,15,1,1,0
-23,-22,-1,0,1,1
-15,1,-16,0,1,1
57,39,18,1,1,0
35,37,-2,0,1,1
-15,-34,19,1,1,0
-16,-12,-4,0,1,1
-34,-15,-19,0,0,0
30,25,5,1,0,1
-1,-16,15,1,0,1
16,20,-4,0,0,0
11,8,3,1,0,1
22,7,15,1,0,1
-4,-2,-2,0,0,0
8,18,-10,0,0,0
42,24,18,1,0,1
27,30,-3,0,0,0
36,29,7,1,0,1
-15,-12,-3,0,0,0
-33,-23,-10,0,1,1
-20,-1,-19,0,1,1
52,33,19,1,1,0
-29,-24,-5,0,1,1
29,44,-15,0,1,1
-8,-22,14,1,1,0
59,39,20,1,1,0
-21,-8,-13,0,1,1
-37,-27,-10,0,1,1
-24,-12,-12,0,1,1
-17,-32,15,1,1,0
-21,-39,18,1,1,0
-16,-1,-15,0,1,1
39,44,-5,0,1,1
27,42,-15,0,0,0
-28,-32,4,1,0,1
44,37,7,1,0,1
-26,-45,19,1,0,1
-7,3,-10,0,0,0
-43,-39,-4,0,0,0
-29,-36,7,1,0,1
-19,-20,1,1,0,1
-15,-16,1,1,0,1
54,42,12,1,0,1
-8,6,-14,0,1,1
24,28,-4,0,1,1
35,36,-1,0,1,1
11,0,11,1,1,0
-31,-21,-10,0,1,1
5,6,-1,0,1,1
10,27,-17,0,1,1
-1,-2,1,1,1,0
-17,-20,3,1,0,1
24,41,-17,0,0,0
20,17,3,1,0,1
2,5,-3,0,0,0
47,38,9,1,0,1
38,18,20,1,0,1
40,26,14,1,0,1
-10,-12,2,1,0,1
-3,-17,14,1,0,1
-20,-1,-19,0,0,0
-35,-19,-16,0,0,0
13,-3,16,1,0,1
-16,-31,15,1,0,1
16,26,-10,0,1,1
28,17,11,1,1,0
-34,-22,-12,0,1,1
-25,-30,5,1,1,0
-14,-21,7,1,1,0
-26,-27,1,1,1,0
5,-8,13,1,1,0
8,-3,11,1,1,0
34,44,-10,0,1,1
31,30,1,1,1,0
14,22,-8,0,1,1
-55,-40,-15,0,1,1
7,-10,17,1,1,0
-45,-26,-19,0,1,1
-32,-39,7,1,1,0
40,44,-4,0,1,1
40,33,7,1,1,0
23,26,-3,0,1,1
48,39,9,1,1,0
23,23,0,0,1,1
28,17,11,1,1,0
-49,-30,-19,0,0,0
28,40,-12,0,0,0
-32,-25,-7,0,0,0
9,15,-6,0,0,0
56,39,17,1,0,1
-33,-13,-20,0,0,0
-31,-22,-9,0,0,0
-10,-15,5,1,0,1
11,13,-2,0,0,0
1,-11,12,1,0,1
-52,-42,-10,0,0,0
-34,-38,4,1,0,1
6,-2,8,1,0,1
-27,-43,16,1,0,1
14,5,9,1,0,1
-36,-22,-14,0,0,0
-3,12,-15,0,0,0
-45,-30,-15,0,0,0
17,12,5,1,0,1
-41,-21,-20,0,0,0
17,12,5,1,0,1
7,4,3,1,1,0
28,34,-6,0,1,1
-51,-44,-7,0,1,1
-27,-26,-1,0,1,1
41,44,-3,0,1,1
-36,-20,-16,0,1,1
-34,-27,-7,0,1,1
25,24,1,1,1,0
-21,-1,-20,0,1,1
-1,-18,17,1,1,0
35,35,0,0,1,1
-60,-45,-15,0,1,1
-27,-26,-1,0,1,1
-15,-11,-4,0,1,1
-25,-11,-14,0,1,1
-26,-45,19,1,1,0
4,19,-15,0,1,1
-30,-23,-7,0,1,1
17,35,-18,0,1,1
23,34,-11,0,1,1
34,25,9,1,1,0
42,36,6,1,0,1
48,28,20,1,0,1
-40,-31,-9,0,0,0
-28,-9,-19,0,0,0
22,28,-6,0,0,0
-12,-8,-4,0,0,0
8,-8,16,1,0,1
3,17,-14,0,0,0
20,26,-6,0,0,0
-42,-30,-12,0,0,0
48,34,14,1,0,1
-1,18,-19,0,0,0
-4,-19,15,1,1,0
-14,-19,5,1,1,0
24,40,-16,0,1,1
34,18,16,1,1,0
-4,12,-16,0,1,1
-63,-43,-20,0,1,1
-36,-22,-14,0,1,1
22,37,-15,0,1,1
-14,-20,6,1,1,0
-59,-41,-18,0,1,1
23,8,15,1,1,0
24,30,-6,0,1,1
10,-7,17,1,1,0
2,-10,12,1,0,1
9,-11,20,1,0,1
-43,-34,-9,0,0,0
53,37,16,1,0,1
2,10,-8,0,0,0
41,32,9,1,0,1
24,19,5,1,0,1
11,8,3,1,0,1
-2,10,-12,0,0,0
6,-4,10,1,1,0
-7,4,-11,0,1,1
-27,-9,-18,0,1,1
34,41,-7,0,1,1
19,31,-12,0,1,1
5,15,-10,0,1,1
-37,-43,6,1,1,0
49,36,13,1,1,0
-43,-36,-7,0,1,1
37,36,1,1,0,1
-35,-18,-17,0,0,0
-2,-3,1,1,0,1
18,28,-10,0,0,0
-48,-41,-7,0,0,0
28,15,13,1,0,1
-13,-23,10,1,0,1
16,21,-5,0,0,0
-48,-36,-12,0,0,0
55,37,18,1,0,1
-42,-35,-7,0,0,0
-4,8,-12,0,0,0
36,34,2,1,0,1
-27,-29,2,1,0,1
-43,-24,-19,0,0,0
12,22,-10,0,0,0
-30,-37,7,1,0,1
-33,-29,-4,0,0,0
-36,-35,-1,0,1,1
-33,-21,-12,0,1,1
34,39,-5,0,1,1
-18,-1,-17,0,1,1
-48,-28,-20,0,1,1
-2,-3,1,1,1,0
-8,-10,2,1,1,0
24,37,-13,0,1,1
1,13,-12,0,1,1
-14,-32,18,1,1,0
-20,-18,-2,0,1,1
-11,-26,15,1,1,0
26,36,-10,0,0,0
5,-15,20,1,0,1
12,14,-2,0,0,0
-30,-19,-11,0,0,0
6,-1,7,1,0,1
-62,-42,-20,0,0,0
-23,-42,19,1,0,1
-22,-17,-5,0,0,0
19,12,7,1,0,1
-34,-32,-2,0,0,0
-9,-17,8,1,0,1
-33,-36,3,1,0,1
9,17,-8,0,0,0
27,29,-2,0,0,0
13,16,-3,0,0,0
-45,-35,-10,0,0,0
-32,-21,-11,0,0,0
-38,-38,0,0,0,0
-4,12,-16,0,0,0
-7,-10,3,1,1,0
41,28,13,1,1,0
-6,-6,0,0,1,1
12,7,5,1,1,0
-32,-22,-10,0,1,1
46,35,11,1,1,0
-35,-36,1,1,1,0
28,44,-16,0,1,1
-5,-8,3,1,1,0
27,40,-13,0,1,1
-28,-9,-19,0,0,0
-15,-18,3,1,0,1
29,35,-6,0,0,0
-5,13,-18,0,0,0
1,-9,10,1,0,1
-30,-35,5,1,0,1
-30,-36,6,1,0,1
-59,-41,-18,0,0,0
16,15,1,1,0,1
-31,-26,-5,0,0,0
-22,-10,-12,0,0,0
-18,-18,0,0,0,0
19,2,17,1,0,1
4,10,-6,0,0,0
-14,-24,10,1,0,1
15,23,-8,0,0,0
-21,-28,7,1,0,1
8,21,-13,0,0,0
18,30,-12,0,0,0
-4,15,-19,0,1,1
21,36,-15,0,1,1
43,29,14,1,1,0
13,28,-15,0,1,1
-22,-25,3,1,1,0
-12,-27,15,1,1,0
5,12,-7,0,1,1
-28,-31,3,1,1,0
28,9,19,1,1,0
-11,-14,3,1,1,0
-39,-45,6,1,1,0
30,11,19,1,1,0
21,36,-15,0,1,1
-56,-37,-19,0,1,1
-22,-13,-9,0,1,1
-17,-24,7,1,1,0
30,43,-13,0,1,1
-37,-38,1,1,1,0
44,39,5,1,1,0
23,13,10,1,1,0
23,41,-18,0,1,1
-26,-17,-9,0,0,0
32,34,-2,0,0,0
-9,-17,8,1,0,1
-38,-31,-7,0,0,0
-29,-15,-14,0,0,0
23,31,-8,0,0,0
6,-2,8,1,0,1
-7,-9,2,1,0,1
-16,-24,8,1,0,1
5,-12,17,1,0,1
-1,-18,17,1,0,1
-23,-33,10,1,0,1
-14,-12,-2,0,0,0
10,15,-5,0,0,0
-4,-13,9,1,0,1
-30,-40,10,1,0,1
2,20,-18,0,1,1
-21,-26,5,1,1,0
-8,-18,10,1,1,0
54,40,14,1,1,0
25,19,6,1,1,0
6,4,2,1,1,0
-49,-43,-6,0,1,1
1,6,-5,0,1,1
32,33,-1,0,1,1
22,20,2,1,1,0
35,15,20,1,1,0
36,34,2,1,1,0
22,37,-15,0,1,1
8,-1,9,1,1,0
14,8,6,1,1,0
54,36,18,1,1,0
35,16,19,1,1,0
-22,-27,5,1,1,0
-49,-33,-16,0,1,1
18,5,13,1,1,0
14,-1,15,1,1,0
16,31,-15,0,0,0
-7,-11,4,1,0,1
-63,-44,-19,0,0,0
-4,4,-8,0,0,0
7,0,7,1,0,1
31,39,-8,0,0,0
21,15,6,1,0,1
46,42,4,1,0,1
-5,-19,14,1,0,1
34,25,9,1,0,1
25,12,13,1,0,1
11,-8,19,1,0,1
35,34,1,1,1,0
9,-11,20,1,1,0
-9,-10,1,1,1,0
25,16,9,1,1,0
-21,-33,12,1,1,0
36,42,-6,0,1,1
21,36,-15,0,1,1
9,-8,17,1,1,0
-26,-12,-14,0,1,1
28,44,-16,0,1,1
0,2,-2,0,1,1
32,37,-5,0,0,0
1,-17,18,1,0,1
23,23,0,0,0,0
-20,-22,2,1,0,1
-22,-9,-13,0,0,0
10,14,-4,0,0,0
-48,-42,-6,0,0,0
9,23,-14,0,0,0
-20,-6,-14,0,0,0
-24,-27,3,1,0,1
52,43,9,1,0,1
-29,-20,-9,0,0,0
45,39,6,1,1,0
-9,-7,-2,0,1,1
12,-4,16,1,1,0
-44,-32,-12,0,1,1
18,29,-11,0,1,1
13,4,9,1,1,0
48,42,6,1,1,0
9,-8,17,1,1,0
-6,-16,10,1,0,1
-7,4,-11,0,0,0
11,21,-10,0,0,0
11,11,0,0,0,0
-35,-17,-18,0,0,0
9,0,9,1,0,1
-59,-41,-18,0,0,0
13,8,5,1,0,1
25,29,-4,0,0,0
18,17,1,1,1,0
5,10,-5,0,1,1
-6,-1,-5,0,1,1
-29,-18,-11,0,1,1
6,19,-13,0,1,1
-22,-35,13,1,1,0
-43,-27,-16,0,1,1
-9,-17,8,1,1,0
14,17,-3,0,1,1
-41,-34,-7,0,1,1
-31,-34,3,1,1,0
61,43,18,1,1,0
16,0,16,1,1,0
-28,-22,-6,0,1,1
58,44,14,1,1,0
-2,14,-16,0,1,1
41,41,0,0,1,1
2,-18,20,1,1,0
59,44,15,1,1,0
-12,4,-16,0,0,0
-43,-44,1,1,0,1
15,27,-12,0,0,0
23,10,13,1,0,1
15,3,12,1,0,1
-10,3,-13,0,0,0
18,30,-12,0,0,0
-26,-14,-12,0,0,0
8,16,-8,0,0,0
15,-3,18,1,0,1
7,-6,13,1,0,1
-55,-39,-16,0,0,0
41,26,15,1,0,1
-32,-42,10,1,0,1
9,25,-16,0,0,0
-39,-44,5,1,0,1
-8,-13,5,1,0,1
36,35,1,1,0,1
25,33,-8,0,0,0
28,30,-2,0,0,0
-1,-10,9,1,0,1
-1,12,-13,0,1,1
-22,-16,-6,0,1,1
0,-18,18,1,1,0
-33,-41,8,1,1,0
-13,-5,-8,0,1,1
29,36,-7,0,1,1
-12,4,-16,0,1,1
10,14,-4,0,1,1
-28,-35,7,1,1,0
23,14,9,1,1,0
19,6,13,1,1,0
40,21,19,1,1,0
3,-6,9,1,1,0
26,41,-15,0,1,1
38,23,15,1,1,0
19,27,-8,0,1,1
-14,-8,-6,0,1,1
5,-6,11,1,1,0
-27,-7,-20,0,1,1
25,38,-13,0,1,1
-53,-35,-18,0,1,1
-23,-31,8,1,0,1
-11,-23,12,1,0,1
11,-4,15,1,0,1
3,21,-18,0,0,0
-8,-22,14,1,0,1
4,-7,11,1,0,1
-2,-10,8,1,0,1
-6,-2,-4,0,0,0
49,34,15,1,0,1
-4,9,-13,0,0,0
33,43,-10,0,0,0
52,35,17,1,0,1
22,16,6,1,0,1
41,44,-3,0,0,0
-27,-43,16,1,0,1
-51,-36,-15,0,0,0
-8,-13,5,1,1,0
27,42,-15,0,1,1
-7,-22,15,1,1,0
-19,-19,0,0,1,1
-7,-23,16,1,1,0
27,11,16,1,1,0
21,26,-5,0,1,1
-17,-14,-3,0,1,1
2,21,-19,0,1,1
-13,4,-17,0,1,1
10,14,-4,0,1,1
-15,-27,12,1,1,0
-1,3,-4,0,1,1
29,28,1,1,1,0
-32,-30,-2,0,1,1
52,35,17,1,0,1
23,40,-17,0,0,0
-8,3,-11,0,0,0
5,-15,20,1,0,1
-30,-44,14,1,0,1
15,17,-2,0,0,0
9,18,-9,0,0,0
38,21,17,1,0,1
-26,-8,-18,0,0,0
2,-5,7,1,0,1
5,19,-14,0,0,0
-1,-8,7,1,0,1
13,30,-17,0,0,0
29,17,12,1,0,1
-20,-11,-9,0,0,0
22,24,-2,0,0,0
-26,-42,16,1,0,1
41,32,9,1,0,1
-36,-32,-4,0,0,0
-15,-24,9,1,1,0
46,35,11,1,1,0
-29,-25,-4,0,1,1
-58,-40,-18,0,1,1
-34,-35,1,1,1,0
31,35,-4,0,1,1
8,15,-7,0,1,1
19,1,18,1,1,0
26,7,19,1,0,1
-1,1,-2,0,0,0
-11,7,-18,0,0,0
-13,-1,-12,0,0,0
15,3,12,1,0,1
37,39,-2,0,0,0
38,37,1,1,0,1
47,39,8,1,0,1
-38,-31,-7,0,0,0
21,9,12,1,0,1
12,25,-13,0,0,0
10,3,7,1,0,1
-21,-41,20,1,0,1
39,29,10,1,0,1
5,-1,6,1,0,1
-28,-39,11,1,0,1
22,14,8,1,0,1
41,21,20,1,0,1
-16,-36,20,1,0,1
-9,-13,4,1,0,1
37,25,12,1,0,1
-17,3,-20,0,1,1
-2,7,-9,0,1,1
-28,-18,-10,0,1,1
40,24,16,1,1,0
-17,-2,-15,0,1,1
6,2,4,1,1,0
-12,-2,-10,0,1,1
17,18,-1,0,1,1
-11,-21,10,1,1,0
-39,-24,-15,0,1,1
-42,-45,3,1,1,0
-33,-16,-17,0,1,1
31,41,-10,0,1,1
-48,-37,-11,0,1,1
-40,-44,4,1,1,0
-40,-38,-2,0,0,0
-19,-1,-18,0,0,0
-19,-1,-18,0,0,0
6,18,-12,0,0,0
-32,-36,4,1,0,1
28,35,-7,0,0,0
32,17,15,1,0,1
-35,-23,-12,0,0,0
-40,-24,-16,0,0,0
30,24,6,1,1,0
-44,-44,0,0,1,1
-36,-26,-10,0,1,1
30,35,-5,0,1,1
-52,-39,-13,0,1,1
6,18,-12,0,1,1
-16,-12,-4,0,1,1
-34,-38,4,1,1,0
-1,7,-8,0,1,1
25,8,17,1,0,1
-49,-40,-9,0,0,0
18,5,13,1,0,1
2,21,-19,0,0,0
-7,-24,17,1,0,1
-11,3,-14,0,0,0
-23,-19,-4,0,0,0
-41,-33,-8,0,0,0
6,4,2,1,0,1
5,16,-11,0,0,0
-45,-32,-13,0,0,0
-50,-36,-14,0,1,1
-29,-38,9,1,1,0
23,13,10,1,1,0
48,35,13,1,1,0
-25,-37,12,1,1,0
29,44,-15,0,1,1
10,24,-14,0,1,1
59,39,20,1,1,0
30,10,20,1,1,0
-1,-8,7,1,0,1
46,40,6,1,0,1
-32,-36,4,1,0,1
6,-3,9,1,0,1
3,-1,4,1,0,1
45,38,7,1,0,1
-21,-37,16,1,0,1
32,43,-11,0,0,0
16,15,1,1,0,1
29,41,-12,0,0,0
-33,-42,9,1,0,1
-28,-43,15,1,0,1
-25,-18,-7,0,0,0
-7,12,-19,0,0,0
-25,-8,-17,0,1,1
-59,-41,-18,0,1,1
5,-12,17,1,1,0
-38,-31,-7,0,1,1
-31,-26,-5,0,1,1
32,34,-2,0,1,1
-48,-37,-11,0,1,1
-29,-43,14,1,1,0
33,35,-2,0,1,1
-40,-41,1,1,1,0
3,4,-1,0,1,1
19,22,-3,0,1,1
-17,-23,6,1,1,0
19,2,17,1,1,0
-36,-27,-9,0,1,1
36,22,14,1,1,0
-25,-23,-2,0,1,1
29,12,17,1,1,0
12,31,-19,0,1,1
16,29,-13,0,1,1
-45,-37,-8,0,1,1
-26,-30,4,1,0,1
11,13,-2,0,0,0
1,-13,14,1,0,1
-28,-27,-1,0,0,0
6,-6,12,1,0,1
11,19,-8,0,0,0
-16,-11,-5,0,0,0
-33,-37,4,1,0,1
-43,-26,-17,0,0,0
6,12,-6,0,0,0
31,34,-3,0,0,0
6,-10,16,1,0,1
3,8,-5,0,0,0
44,39,5,1,0,1
30,25,5,1,0,1
11,30,-19,0,0,0
-23,-6,-17,0,0,0
-2,-13,11,1,0,1
22,21,1,1,0,1
-21,-14,-7,0,0,0
26,43,-17,0,0,0
-27,-28,1,1,1,0
-21,-38,17,1,1,0
6,7,-1,0,1,1
-29,-30,1,1,1,0
33,22,11,1,1,0
19,11,8,1,1,0
54,38,16,1,1,0
14,32,-18,0,1,1
17,1,16,1,1,0
-6,3,-9,0,1,1
-17,-33,16,1,0,1
-29,-20,-9,0,0,0
-36,-32,-4,0,0,0
-26,-35,9,1,0,1
-4,5,-9,0,0,0
-4,9,-13,0,0,0
-9,-7,-2,0,0,0
46,42,4,1,0,1
49,31,18,1,0,1
18,5,13,1,0,1
-39,-33,-6,0,1,1
1,-9,10,1,1,0
51,32,19,1,1,0
19,19,0,0,1,1
-47,-31,-16,0,1,1
23,20,3,1,1,0
-28,-42,14,1,1,0
-23,-36,13,1,1,0
43,26,17,1,1,0
15,19,-4,0,1,1
34,18,16,1,1,0
-56,-42,-14,0,1,1
29,12,17,1,1,0
3,-12,15,1,1,0
-24,-26,2,1,1,0
-33,-33,0,0,1,1
20,22,-2,0,1,1
-22,-9,-13,0,0,0
55,42,13,1,0,1
45,43,2,1,0,1
16,7,9,1,0,1
-53,-43,-10,0,0,0
-15,-21,6,1,0,1
-43,-35,-8,0,0,0
15,21,-6,0,0,0
19,20,-1,0,0,0
-40,-31,-9,0,0,0
-8,-8,0,0,0,0
36,27,9,1,0,1
-24,-10,-14,0,1,1
37,34,3,1,1,0
-27,-16,-11,0,1,1
12,6,6,1,1,0
-15,-9,-6,0,1,1
5,-2,7,1,1,0
-29,-41,12,1,1,0
-17,-36,19,1,1,0
-5,-3,-2,0,1,1
47,35,12,1,1,0
-18,-22,4,1,1,0
0,-11,11,1,1,0
-20,-35,15,1,1,0
-29,-23,-6,0,0,0
18,22,-4,0,0,0
2,19,-17,0,0,0
-22,-19,-3,0,0,0
-40,-29,-11,0,0,0
-13,-5,-8,0,0,0
55,35,20,1,0,1
-3,8,-11,0,0,0
4,-1,5,1,0,1
1,-13,14,1,0,1
6,-5,11,1,0,1
-3,10,-13,0,0,0
21,24,-3,0,0,0
-28,-30,2,1,0,1
-22,-3,-19,0,0,0
-55,-44,-11,0,0,0
-29,-13,-16,0,0,0
-19,-26,7,1,0,1
-50,-31,-19,0,0,0
11,24,-13,0,0,0
-3,16,-19,0,0,0
51,37,14,1,1,0
-8,-2,-6,0,1,1
9,15,-6,0,1,1
-10,-25,15,1,1,0
-44,-33,-11,0,1,1
27,26,1,1,1,0
17,25,-8,0,1,1
-44,-33,-11,0,1,1
44,33,11,1,1,0
2,14,-12,0,1,1
27,11,16,1,1,0
40,32,8,1,1,0
8,-1,9,1,1,0
-30,-24,-6,0,1,1
55,43,12,1,1,0
49,32,17,1,1,0
-32,-44,12,1,1,0
-35,-44,9,1,1,0
20,38,-18,0,1,1
43,30,13,1,1,0
18,31,-13,0,1,1
-50,-32,-18,0,0,0
7,-2,9,1,0,1
-4,8,-12,0,0,0
29,33,-4,0,0,0
0,-6,6,1,0,1
30,31,-1,0,0,0
55,41,14,1,0,1
-11,-24,13,1,0,1
42,22,20,1,0,1
49,43,6,1,0,1
-28,-21,-7,0,0,0
-34,-38,4,1,0,1
-13,-3,-10,0,0,0
-12,-27,15,1,0,1
-58,-42,-16,0,1,1
-32,-38,6,1,1,0
-2,13,-15,0,1,1
-6,0,-6,0,1,1
-15,-31,16,1,1,0
46,31,15,1,1,0
-5,-18,13,1,1,0
-14,-22,8,1,1,0
11,1,10,1,1,0
-18,-1,-17,0,1,1
22,38,-16,0,1,1
4,12,-8,0,1,1
27,15,12,1,1,0
15,-4,19,1,1,0
0,19,-19,0,1,1
15,35,-20,0,1,1
47,42,5,1,1,0
-27,-28,1,1,1,0
54,39,15,1,1,0
27,8,19,1,1,0
46,43,3,1,1,0
-10,5,-15,0,0,0
-1,18,-19,0,0,0
19,12,7,1,0,1
-13,0,-13,0,0,0
-28,-18,-10,0,0,0
-2,-4,2,1,0,1
26,42,-16,0,0,0
8,19,-11,0,0,0
-19,-37,18,1,0,1
-2,-4,2,1,0,1
0,-17,17,1,0,1
-19,-6,-13,0,0,0
24,42,-18,0,0,0
-13,-25,12,1,0,1
-19,-20,1,1,0,1
21,40,-19,0,0,0
9,20,-11,0,0,0
24,22,2,1,0,1
-7,3,-10,0,0,0
-44,-39,-5,0,0,0
11,14,-3,0,0,0
-34,-36,2,1,1,0
12,8,4,1,1,0
24,7,17,1,1,0
-23,-7,-16,0,1,1
-24,-23,-1,0,1,1
2,-1,3,1,1,0
-16,-16,0,0,1,1
21,26,-5,0,1,1
-36,-43,7,1,1,0
8,22,-14,0,1,1
-4,13,-17,0,1,1
25,25,0,0,1,1
-8,-27,19,1,1,0
-25,-13,-12,0,0,0
51,37,14,1,0,1
-26,-42,16,1,0,1
-9,8,-17,0,0,0
27,24,3,1,0,1
14,26,-12,0,0,0
58,40,18,1,0,1
38,29,9,1,0,1
-44,-26,-18,0,0,0
-26,-11,-15,0,1,1
17,29,-12,0,1,1
-43,-39,-4,0,1,1
5,11,-6,0,1,1
16,27,-11,0,1,1
15,13,2,1,1,0
31,23,8,1,1,0
33,30,3,1,1,0
-4,-2,-2,0,1,1
-24,-6,-18,0,1,1
35,29,6,1,1,0
-7,-24,17,1,1,0
-23,-22,-1,0,1,1
-58,-38,-20,0,0,0
-42,-38,-4,0,0,0
3,-17,20,1,0,1
39,25,14,1,0,1
20,34,-14,0,0,0
9,-10,19,1,0,1
-33,-23,-10,0,0,0
4,6,-2,0,0,0
34,25,9,1,0,1
2,22,-20,0,1,1
-8,-16,8,1,1,0
-49,-34,-15,0,1,1
18,-1,19,1,1,0
-3,-1,-2,0,1,1
28,29,-1,0,1,1
33,16,17,1,1,0
23,30,-7,0,1,1
-9,-3,-6,0,1,1
-55,-40,-15,0,1,1
52,34,18,1,1,0
-12,-3,-9,0,1,1
-48,-31,-17,0,1,1
16,1,15,1,1,0
-36,-37,1,1,1,0
15,25,-10,0,1,1
-43,-32,-11,0,1,1
47,30,17,1,1,0
11,-4,15,1,1,0
5,-5,10,1,1,0
-31,-32,1,1,1,0
30,27,3,1,0,1
41,21,20,1,0,1
-3,-16,13,1,0,1
41,33,8,1,0,1
-7,8,-15,0,0,0
-20,-28,8,1,0,1
-23,-27,4,1,0,1
-36,-20,-16,0,0,0
20,18,2,1,0,1
-9,9,-18,0,0,0
-40,-23,-17,0,0,0
1,1,0,0,0,0
-3,-10,7,1,0,1
-31,-20,-11,0,0,0
33,13,20,1,1,0
13,9,4,1,1,0
-38,-40,2,1,1,0
42,32,10,1,1,0
6,12,-6,0,1,1
-35,-40,5,1,1,0
39,20,19,1,1,0
16,13,3,1,1,0
18,37,-19,0,1,1
-12,-8,-4,0,1,1
-32,-42,10,1,1,0
37,43,-6,0,1,1
23,36,-13,0,1,1
38,26,12,1,1,0
23,36,-13,0,1,1
-11,-30,19,1,1,0
10,0,10,1,1,0
9,-1,10,1,1,0
22,38,-16,0,1,1
39,19,20,1,1,0
0,-1,1,1,1,0
-22,-23,1,1,0,1
37,42,-5,0,0,0
31,23,8,1,0,1
5,6,-1,0,0,0
31,37,-6,0,0,0
45,25,20,1,0,1
-43,-41,-2,0,0,0
18,14,4,1,0,1
4,14,-10,0,1,1
-34,-22,-12,0,1,1
39,36,3,1,1,0
6,12,-6,0,1,1
-13,-23,10,1,1,0
30,38,-8,0,1,1
-20,-5,-15,0,1,1
12,1,11,1,1,0
33,39,-6,0,1,1
-13,5,-18,0,1,1
-21,-9,-12,0,1,1
-25,-34,9,1,1,0
36,39,-3,0,1,1
14,34,-20,0,0,0
36,35,1,1,0,1
-13,-12,-1,0,0,0
-15,-8,-7,0,0,0
0,-6,6,1,0,1
26,37,-11,0,0,0
9,9,0,0,0,0
11,10,1,1,0,1
29,24,5,1,0,1
-26,-34,8,1,0,1
-33,-14,-19,0,0,0
1,1,0,0,0,0
36,32,4,1,0,1
35,18,17,1,0,1
-7,-2,-5,0,0,0
34,25,9,1,0,1
-19,-10,-9,0,0,0
29,42,-13,0,0,0
-50,-36,-14,0,0,0
0,-12,12,1,0,1
-38,-35,-3,0,0,0
23,6,17,1,1,0
45,44,1,1,1,0
35,20,15,1,1,0
13,22,-9,0,1,1
-10,-12,2,1,1,0
3,16,-13,0,1,1
39,24,15,1,1,0
-17,0,-17,0,1,1
-23,-39,16,1,1,0
18,36,-18,0,1,1
9,4,5,1,1,0
-5,0,-5,0,0,0
42,31,11,1,0,1
24,13,11,1,0,1
34,43,-9,0,0,0
45,44,1,1,0,1
30,21,9,1,0,1
42,31,11,1,0,1
35,32,3,1,0,1
15,14,1,1,0,1
-4,-11,7,1,0,1
33,30,3,1,1,0
-31,-36,5,1,1,0
40,39,1,1,1,0
-59,-39,-20,0,1,1
18,9,9,1,1,0
-3,-2,-1,0,1,1
-34,-19,-15,0,1,1
44,44,0,0,1,1
-7,-1,-6,0,1,1
33,28,5,1,1,0
-24,-35,11,1,1,0
28,13,15,1,1,0
-26,-31,5,1,0,1
-32,-35,3,1,0,1
-23,-9,-14,0,0,0
16,23,-7,0,0,0
29,18,11,1,0,1
-28,-17,-11,0,0,0
-8,-28,20,1,0,1
-16,-16,0,0,0,0
-39,-24,-15,0,0,0
42,37,5,1,0,1
40,26,14,1,0,1
0,-1,1,1,0,1
49,38,11,1,0,1
61,43,18,1,0,1
56,39,17,1,0,1
7,-11,18,1,0,1
-12,-27,15,1,0,1
-34,-40,6,1,0,1
55,42,13,1,0,1
-4,-14,10,1,0,1
3,3,0,0,0,0
24,21,3,1,1,0
10,-9,19,1,1,0
30,39,-9,0,1,1
-44,-34,-10,0,1,1
33,33,0,0,1,1
24,44,-20,0,1,1
-19,0,-19,0,1,1
-26,-23,-3,0,1,1
-11,-14,3,1,1,0
-38,-21,-17,0,1,1
-16,-8,-8,0,1,1
-4,2,-6,0,1,1
-2,3,-5,0,1,1
36,21,15,1,1,0
5,23,-18,0,1,1
46,41,5,1,1,0
-24,-33,9,1,1,0
14,15,-1,0,1,1
-32,-18,-14,0,1,1
-14,-13,-1,0,1,1
-23,-9,-14,0,1,1
-18,-34,16,1,0,1
-24,-33,9,1,0,1
25,24,1,1,0,1
-27,-17,-10,0,0,0
22,31,-9,0,0,0
11,18,-7,0,0,0
-19,-6,-13,0,0,0
27,22,5,1,0,1
33,26,7,1,0,1
4,-5,9,1,0,1
18,24,-6,0,0,0
3,-11,14,1,1,0
11,31,-20,0,1,1
-8,-2,-6,0,1,1
19,9,10,1,1,0
-41,-21,-20,0,1,1
-42,-30,-12,0,1,1
-17,-3,-14,0,1,1
20,22,-2,0,1,1
52,40,12,1,1,0
-56,-44,-12,0,1,1
22,7,15,1,1,0
-51,-40,-11,0,1,1
-43,-43,0,0,1,1
42,29,13,1,1,0
5,-15,20,1,1,0
23,14,9,1,1,0
-2,-12,10,1,1,0
-44,-40,-4,0,1,1
-6,-8,2,1,1,0
5,0,5,1,1,0
-15,-4,-11,0,1,1
-13,-7,-6,0,0,0
38,21,17,1,0,1
20,13,7,1,0,1
16,19,-3,0,0,0
-17,-26,9,1,0,1
1,-1,2,1,0,1
23,15,8,1,0,1
-22,-3,-19,0,0,0
34,27,7,1,0,1
30,24,6,1,0,1
21,19,2,1,1,0
22,26,-4,0,1,1
-34,-44,10,1,1,0
-27,-36,9,1,1,0
17,1,16,1,1,0
-11,3,-14,0,1,1
-20,-13,-7,0,1,1
8,-12,20,1,1,0
3,-1,4,1,1,0
25,23,2,1,1,0
5,-7,12,1,1,0
-6,-13,7,1,1,0
-13,-33,20,1,1,0
-22,-40,18,1,1,0
-36,-22,-14,0,0,0
19,1,18,1,0,1
-20,-3,-17,0,0,0
3,-3,6,1,0,1
-20,-16,-4,0,0,0
-7,1,-8,0,0,0
0,6,-6,0,0,0
9,29,-20,0,0,0
11,8,3,1,0,1
2,-15,17,1,0,1
23,9,14,1,0,1
5,-6,11,1,0,1
16,9,7,1,1,0
18,0,18,1,1,0
23,17,6,1,1,0
14,18,-4,0,1,1
6,24,-18,0,1,1
-33,-35,2,1,1,0
4,-1,5,1,1,0
36,40,-4,0,1,1
8,5,3,1,1,0
-11,-23,12,1,1,0
-12,-20,8,1,1,0
28,19,9,1,1,0
-48,-37,-11,0,1,1
14,7,7,1,1,0
39,38,1,1,1,0
52,36,16,1,1,0
23,20,3,1,1,0
24,28,-4,0,1,1
-1,4,-5,0,1,1
23,11,12,1,1,0
-19,-26,7,1,1,0
-31,-36,5,1,0,1
22,38,-16,0,0,0
9,-10,19,1,0,1
5,-15,20,1,0,1
13,24,-11,0,0,0
43,40,3,1,0,1
12,-6,18,1,0,1
5,10,-5,0,0,0
-39,-43,4,1,1,0
-32,-43,11,1,1,0
39,42,-3,0,1,1
27,25,2,1,1,0
-1,-20,19,1,1,0
9,-8,17,1,1,0
-37,-45,8,1,1,0
-23,-38,15,1,1,0
-26,-9,-17,0,1,1
-24,-37,13,1,1,0
-29,-18,-11,0,1,1
9,28,-19,0,1,1
5,15,-10,0,1,1
32,39,-7,0,1,1
-36,-43,7,1,1,0
-3,6,-9,0,1,1
8,12,-4,0,1,1
9,15,-6,0,1,1
29,32,-3,0,1,1
-32,-18,-14,0,1,1
-6,-9,3,1,1,0
-17,-22,5,1,0,1
17,24,-7,0,0,0
38,21,17,1,0,1
2,20,-18,0,0,0
8,4,4,1,0,1
-7,-1,-6,0,0,0
24,15,9,1,0,1
11,1,10,1,0,1
18,30,-12,0,0,0
32,40,-8,0,1,1
-32,-40,8,1,1,0
4,-2,6,1,1,0
10,-4,14,1,1,0
30,20,10,1,1,0
25,41,-16,0,1,1
-23,-4,-19,0,1,1
0,0,0,0,1,1
-31,-41,10,1,1,0
3,-2,5,1,1,0
18,23,-5,0,1,1
7,10,-3,0,1,1
-40,-31,-9,0,1,1
-35,-24,-11,0,1,1
-14,-29,15,1,1,0
21,5,16,1,1,0
21,6,15,1,1,0
-7,-2,-5,0,1,1
-22,-6,-16,0,1,1
59,39,20,1,0,1
-2,-19,17,1,0,1
-27,-32,5,1,0,1
-35,-18,-17,0,0,0
-43,-27,-16,0,0,0
51,39,12,1,0,1
17,9,8,1,0,1
32,20,12,1,0,1
-20,-13,-7,0,0,0
-4,-13,9,1,0,1
-1,-14,13,1,0,1
-17,0,-17,0,0,0
-2,-6,4,1,0,1
46,31,15,1,0,1
-7,7,-14,0,1,1
-44,-35,-9,0,1,1
-48,-29,-19,0,1,1
9,-8,17,1,1,0
-48,-31,-17,0,1,1
-30,-25,-5,0,1,1
52,42,10,1,1,0
-6,-4,-2,0,1,1
21,40,-19,0,1,1
-18,-1,-17,0,1,1
-15,1,-16,0,1,1
-14,4,-18,0,1,1
33,13,20,1,1,0
10,13,-3,0,1,1
-16,-8,-8,0,1,1
-35,-27,-8,0,1,1
-3,-14,11,1,0,1
43,39,4,1,0,1
16,24,-8,0,0,0
-19,-20,1,1,0,1
60,41,19,1,0,1
49,37,12,1,0,1
-31,-23,-8,0,0,0
4,8,-4,0,0,0
-21,-19,-2,0,0,0
17,-1,18,1,1,0
-46,-37,-9,0,1,1
-7,-18,11,1,1,0
34,36,-2,0,1,1
11,11,0,0,1,1
-4,-22,18,1,1,0
21,22,-1,0,1,1
-11,-30,19,1,1,0
16,34,-18,0,1,1
-45,-30,-15,0,1,1
-14,-3,-11,0,1,1
38,40,-2,0,1,1
-11,-12,1,1,0,1
-14,-21,7,1,0,1
-21,-35,14,1,0,1
19,6,13,1,0,1
2,-4,6,1,0,1
-6,-7,1,1,0,1
-36,-23,-13,0,0,0
26,34,-8,0,0,0
43,38,5,1,0,1
2,-6,8,1,0,1
-42,-31,-11,0,0,0
10,-9,19,1,0,1
-12,6,-18,0,0,0
-28,-25,-3,0,0,0
-54,-43,-11,0,0,0
-19,-18,-1,0,0,0
-56,-39,-17,0,0,0
45,34,11,1,0,1
-1,-4,3,1,0,1
33,43,-10,0,0,0
-30,-26,-4,0,0,0
-39,-40,1,1,1,0
-33,-24,-9,0,1,1
-15,1,-16,0,1,1
9,22,-13,0,1,1
11,10,1,1,1,0
-50,-30,-20,0,1,1
20,1,19,1,1,0
-40,-41,1,1,1,0
-18,0,-18,0,1,1
-15,-30,15,1,1,0
-33,-23,-10,0,1,1
15,12,3,1,1,0
24,18,6,1,1,0
-26,-33,7,1,1,0
23,32,-9,0,1,1
62,44,18,1,1,0
45,42,3,1,1,0
36,24,12,1,1,0
10,11,-1,0,0,0
23,20,3,1,0,1
-41,-27,-14,0,0,0
18,36,-18,0,0,0
-19,-3,-16,0,0,0
1,-16,17,1,0,1
-23,-21,-2,0,0,0
19,31,-12,0,0,0
14,-3,17,1,0,1
32,32,0,0,0,0
16,9,7,1,0,1
-21,-41,20,1,0,1
20,19,1,1,0,1
13,9,4,1,1,0
-9,-2,-7,0,1,1
15,13,2,1,1,0
-58,-38,-20,0,1,1
35,26,9,1,1,0
-11,-20,9,1,1,0
6,26,-20,0,1,1
-10,-8,-2,0,1,1
-4,-12,8,1,1,0
14,22,-8,0,1,1
-59,-41,-18,0,1,1
-49,-45,-4,0,1,1
-30,-33,3,1,1,0
-19,-18,-1,0,1,1
-6,-12,6,1,1,0
-26,-23,-3,0,1,1
-44,-39,-5,0,1,1
-19,-27,8,1,1,0
38,38,0,0,1,1
-3,14,-17,0,1,1
32,40,-8,0,1,1
-30,-41,11,1,0,1
-20,-30,10,1,0,1
-45,-26,-19,0,0,0
-24,-6,-18,0,0,0
3,13,-10,0,0,0
32,35,-3,0,0,0
0,4,-4,0,0,0
1,6,-5,0,0,0
-12,-8,-4,0,0,0
-43,-45,2,1,0,1
38,38,0,0,0,0
-12,3,-15,0,0,0
38,20,18,1,0,1
11,-1,12,1,0,1
19,20,-1,0,0,0
35,33,2,1,0,1
0,15,-15,0,0,0
-27,-18,-9,0,0,0
27,11,16,1,0,1
33,37,-4,0,0,0
-44,-33,-11,0,0,0
3,9,-6,0,1,1
17,13,4,1,1,0
-16,-34,18,1,1,0
-15,5,-20,0,1,1
-9,-15,6,1,1,0
-19,-14,-5,0,1,1
-3,4,-7,0,1,1
-35,-37,2,1,1,0
43,43,0,0,1,1
38,35,3,1,1,0
-26,-34,8,1,1,0
-9,-12,3,1,1,0
-29,-45,16,1,1,0
-2,-3,1,1,1,0
15,2,13,1,1,0
-41,-44,3,1,0,1
-23,-15,-8,0,0,0
-33,-17,-16,0,0,0
-3,-2,-1,0,0,0
21,31,-10,0,0,0
-27,-17,-10,0,0,0
-8,-28,20,1,0,1
5,19,-14,0,0,0
-30,-23,-7,0,0,0
20,40,-20,0,0,0
-6,13,-19,0,0,0
-9,-26,17,1,0,1
-20,-34,14,1,0,1
-29,-33,4,1,0,1
38,18,20,1,1,0
45,26,19,1,1,0
11,13,-2,0,1,1
43,37,6,1,1,0
-26,-34,8,1,1,0
-53,-44,-9,0,1,1
0,8,-8,0,1,1
-13,-26,13,1,1,0
-35,-25,-10,0,1,1
-8,-28,20,1,1,0
-38,-20,-18,0,1,1
35,39,-4,0,1,1
-32,-36,4,1,1,0
31,38,-7,0,1,1
-32,-19,-13,0,1,1
2,-6,8,1,1,0
-48,-35,-13,0,1,1
36,17,19,1,1,0
-41,-34,-7,0,1,1
-26,-18,-8,0,1,1
2,-4,6,1,1,0
-39,-37,-2,0,0,0
-21,-31,10,1,0,1
-31,-34,3,1,0,1
20,9,11,1,0,1
-40,-41,1,1,0,1
-27,-20,-7,0,0,0
-46,-32,-14,0,0,0
-26,-38,12,1,0,1
21,22,-1,0,0,0
-47,-37,-10,0,0,0
20,33,-13,0,0,0
-40,-41,1,1,0,1
-13,-23,10,1,0,1
-26,-45,19,1,0,1
-20,-2,-18,0,1,1
29,22,7,1,1,0
-8,-4,-4,0,1,1
9,16,-7,0,1,1
2,7,-5,0,1,1
1,15,-14,0,1,1
15,21,-6,0,1,1
-22,-37,15,1,1,0
-28,-15,-13,0,0,0
-15,-27,12,1,0,1
-3,-13,10,1,0,1
44,32,12,1,0,1
30,42,-12,0,0,0
-14,-24,10,1,0,1
-50,-39,-11,0,0,0
9,13,-4,0,0,0
36,25,11,1,1,0
-29,-24,-5,0,1,1
-54,-39,-15,0,1,1
29,12,17,1,1,0
-22,-22,0,0,1,1
-12,-16,4,1,1,0
-16,1,-17,0,1,1
13,19,-6,0,1,1
17,37,-20,0,1,1
-43,-38,-5,0,1,1
58,39,19,1,1,0
2,-13,15,1,0,1
-18,-35,17,1,0,1
-16,-21,5,1,0,1
40,32,8,1,0,1
-22,-9,-13,0,0,0
13,26,-13,0,0,0
-7,11,-18,0,0,0
-60,-41,-19,0,0,0
-38,-18,-20,0,0,0
6,7,-1,0,0,0
-20,-5,-15,0,0,0
14,0,14,1,1,0
11,25,-14,0,1,1
16,10,6,1,1,0
-2,-18,16,1,1,0
-17,-25,8,1,1,0
15,4,11,1,1,0
9,26,-17,0,1,1
6,1,5,1,1,0
-19,-20,1,1,0,1
17,20,-3,0,0,0
13,23,-10,0,0,0
-6,14,-20,0,0,0
-50,-45,-5,0,0,0
-14,3,-17,0,0,0
-11,-23,12,1,0,1
31,11,20,1,0,1
33,44,-11,0,0,0
-23,-13,-10,0,0,0
42,28,14,1,0,1
21,13,8,1,0,1
7,-4,11,1,0,1
-37,-25,-12,0,0,0
-5,9,-14,0,0,0
-27,-31,4,1,0,1
53,35,18,1,0,1
38,35,3,1,0,1
1,-9,10,1,0,1
-39,-28,-11,0,0,0
11,14,-3,0,0,0
32,40,-8,0,1,1
16,10,6,1,1,0
12,0,12,1,1,0
23,36,-13,0,1,1
-40,-45,5,1,1,0
30,34,-4,0,1,1
48,29,19,1,1,0
11,16,-5,0,1,1
-57,-45,-12,0,1,1
-14,-13,-1,0,1,1
20,21,-1,0,1,1
38,34,4,1,1,0
33,16,17,1,0,1
-25,-38,13,1,0,1
-14,-30,16,1,0,1
-34,-43,9,1,0,1
17,18,-1,0,0,0
32,29,3,1,0,1
-35,-33,-2,0,0,0
20,11,9,1,0,1
-26,-45,19,1,0,1
-30,-15,-15,0,0,0
-12,-22,10,1,0,1
44,26,18,1,0,1
-13,-28,15,1,0,1
-35,-28,-7,0,0,0
-29,-26,-3,0,1,1
-4,5,-9,0,1,1
-7,-23,16,1,1,0
38,27,11,1,1,0
-10,-19,9,1,1,0
11,16,-5,0,1,1
13,33,-20,0,1,1
-44,-27,-17,0,1,1
-33,-27,-6,0,1,1
-5,-11,6,1,0,1
43,32,11,1,0,1
-44,-33,-11,0,0,0
9,0,9,1,0,1
29,44,-15,0,0,0
-33,-29,-4,0,0,0
-2,-14,12,1,0,1
41,28,13,1,0,1
6,-8,14,1,0,1
-39,-20,-19,0,0,0
-45,-43,-2,0,0,0
-27,-42,15,1,0,1
39,19,20,1,0,1
24,16,8,1,0,1
9,-10,19,1,1,0
-8,-17,9,1,1,0
-53,-38,-15,0,1,1
26,39,-13,0,1,1
40,34,6,1,1,0
19,1,18,1,1,0
-33,-38,5,1,1,0
33,20,13,1,1,0
8,28,-20,0,0,0
24,17,7,1,0,1
-11,-28,17,1,0,1
-32,-42,10,1,0,1
-28,-15,-13,0,0,0
2,-16,18,1,0,1
63,43,20,1,0,1
-47,-37,-10,0,0,0
-36,-25,-11,0,0,0
31,17,14,1,0,1
-19,-35,16,1,0,1
-64,-45,-19,0,0,0
2,-13,15,1,0,1
55,43,12,1,0,1
23,23,0,0,0,0
-17,-31,14,1,0,1
33,44,-11,0,0,0
30,30,0,0,0,0
-19,-25,6,1,0,1
-23,-20,-3,0,0,0
46,26,20,1,0,1
20,6,14,1,1,0
-51,-43,-8,0,1,1
-29,-20,-9,0,1,1
35,17,18,1,1,0
9,13,-4,0,1,1
-11,7,-18,0,1,1
-19,-24,5,1,1,0
-50,-31,-19,0,1,1
17,36,-19,0,1,1
-17,-26,9,1,1,0
-22,-3,-19,0,1,1
37,35,2,1,1,0
-30,-11,-19,0,1,1
-42,-27,-15,0,1,1
23,33,-10,0,0,0
41,36,5,1,0,1
-34,-37,3,1,0,1
29,14,15,1,0,1
24,36,-12,0,0,0
-17,-20,3,1,0,1
38,35,3,1,0,1
-60,-42,-18,0,0,0
-8,3,-11,0,0,0
0,12,-12,0,0,0
-6,13,-19,0,0,0
-13,-12,-1,0,0,0
-62,-42,-20,0,0,0
11,-3,14,1,0,1
-20,-1,-19,0,0,0
3,-8,11,1,0,1
-4,16,-20,0,0,0
-6,-20,14,1,0,1
41,21,20,1,0,1
29,39,-10,0,0,0
42,28,14,1,0,1
14,9,5,1,1,0
36,27,9,1,1,0
20,40,-20,0,1,1
-18,-10,-8,0,1,1
8,-10,18,1,1,0
9,23,-14,0,1,1
36,39,-3,0,1,1
23,8,15,1,1,0
16,4,12,1,1,0
-19,1,-20,0,1,1
51,44,7,1,1,0
27,32,-5,0,1,1
34,18,16,1,1,0
-2,6,-8,0,1,1
29,19,10,1,1,0
48,38,10,1,1,0
47,27,20,1,1,0
49,32,17,1,1,0
-6,6,-12,0,1,1
1,17,-16,0,1,1
30,18,12,1,1,0
-17,-20,3,1,0,1
-36,-36,0,0,0,0
-51,-38,-13,0,0,0
48,28,20,1,0,1
-11,5,-16,0,0,0
-12,-14,2,1,0,1
49,34,15,1,0,1
-8,7,-15,0,0,0
28,29,-1,0,0,0
5,-13,18,1,0,1
20,32,-12,0,1,1
-46,-37,-9,0,1,1
13,29,-16,0,1,1
17,9,8,1,1,0
-31,-20,-11,0,1,1
61,41,20,1,1,0
4,10,-6,0,1,1
-37,-17,-20,0,1,1
22,41,-19,0,0,0
-19,-19,0,0,0,0
-42,-39,-3,0,0,0
-22,-38,16,1,0,1
-33,-32,-1,0,0,0
42,25,17,1,0,1
-3,-20,17,1,0,1
-34,-18,-16,0,0,0
18,5,13,1,0,1
-33,-23,-10,0,1,1
-17,-26,9,1,1,0
-1,-18,17,1,1,0
-12,-14,2,1,1,0
-53,-40,-13,0,1,1
33,37,-4,0,1,1
-14,-18,4,1,1,0
-6,1,-7,0,1,1
-42,-33,-9,0,1,1
-4,3,-7,0,1,1
-50,-34,-16,0,1,1
-7,5,-12,0,1,1
4,2,2,1,1,0
0,0,0,0,1,1
-13,4,-17,0,1,1
-18,-20,2,1,1,0
-37,-31,-6,0,1,1
-15,-19,4,1,1,0
37,26,11,1,1,0
-19,-22,3,1,1,0
-13,-17,4,1,1,0
13,29,-16,0,0,0
-38,-39,1,1,0,1
-56,-43,-13,0,0,0
3,2,1,1,0,1
-43,-44,1,1,0,1
2,9,-7,0,0,0
42,38,4,1,0,1
13,2,11,1,0,1
-18,-10,-8,0,0,0
-10,-14,4,1,0,1
-24,-30,6,1,0,1
38,34,4,1,0,1
39,27,12,1,0,1
-5,3,-8,0,0,0
45,27,18,1,0,1
6,2,4,1,0,1
34,41,-7,0,0,0
23,7,16,1,0,1
43,27,16,1,0,1
18,13,5,1,0,1
37,38,-1,0,0,0
28,25,3,1,1,0
14,3,11,1,1,0
-41,-34,-7,0,1,1
-26,-36,10,1,1,0
12,20,-8,0,1,1
0,-3,3,1,1,0
-40,-41,1,1,1,0
-4,10,-14,0,1,1
-12,-8,-4,0,1,1
-9,-25,16,1,1,0
-22,-22,0,0,1,1
20,21,-1,0,1,1
-23,-39,16,1,1,0
12,22,-10,0,1,1
42,34,8,1,1,0
-32,-30,-2,0,1,1
55,37,18,1,0,1
51,35,16,1,0,1
-2,-13,11,1,0,1
25,15,10,1,0,1
-32,-25,-7,0,0,0
29,41,-12,0,0,0
12,21,-9,0,0,0
34,42,-8,0,0,0
1,-15,16,1,0,1
27,18,9,1,0,1
-40,-40,0,0,0,0
11,14,-3,0,0,0
16,10,6,1,0,1
-32,-12,-20,0,0,0
26,28,-2,0,0,0
39,21,18,1,0,1
-18,-33,15,1,0,1
8,28,-20,0,0,0
-26,-41,15,1,1,0
-25,-28,3,1,1,0
-11,-22,11,1,1,0
-21,-32,11,1,1,0
-1,-1,0,0,1,1
27,42,-15,0,1,1
-49,-40,-9,0,1,1
-13,7,-20,0,1,1
22,34,-12,0,1,1
19,19,0,0,0,0
-10,-9,-1,0,0,0
-7,12,-19,0,0,0
33,41,-8,0,0,0
24,39,-15,0,0,0
-31,-40,9,1,0,1
-8,-7,-1,0,0,0
-31,-36,5,1,0,1
55,40,15,1,0,1
0,19,-19,0,0,0
42,27,15,1,0,1
38,28,10,1,0,1
20,31,-11,0,0,0
5,10,-5,0,0,0
-15,-29,14,1,0,1
-29,-40,11,1,0,1
15,11,4,1,0,1
4,17,-13,0,0,0
-3,-3,0,0,0,0
-3,17,-20,0,0,0
33,41,-8,0,0,0
-42,-42,0,0,1,1
8,3,5,1,1,0
32,35,-3,0,1,1
37,39,-2,0,1,1
-32,-44,12,1,1,0
-30,-29,-1,0,1,1
3,19,-16,0,1,1
-26,-28,2,1,1,0
-39,-43,4,1,1,0
23,7,16,1,1,0
-7,-24,17,1,1,0
-52,-36,-16,0,1,1
6,-8,14,1,0,1
14,-3,17,1,0,1
-13,-14,1,1,0,1
-45,-45,0,0,0,0
-38,-36,-2,0,0,0
-21,-25,4,1,0,1
-3,-22,19,1,0,1
22,25,-3,0,0,0
-10,-21,11,1,0,1
55,41,14,1,1,0
-27,-36,9,1,1,0
57,43,14,1,1,0
-25,-39,14,1,1,0
-10,-8,-2,0,1,1
-40,-34,-6,0,1,1
6,-5,11,1,1,0
-33,-23,-10,0,1,1
32,29,3,1,1,0
34,36,-2,0,1,1
-11,-26,15,1,1,0
-21,-28,7,1,0,1
-1,-4,3,1,0,1
17,17,0,0,0,0
-42,-29,-13,0,0,0
-36,-45,9,1,0,1
4,-12,16,1,0,1
16,21,-5,0,0,0
-14,-20,6,1,0,1
-14,-29,15,1,0,1
22,12,10,1,0,1
-9,-23,14,1,1,0
-16,3,-19,0,1,1
-32,-28,-4,0,1,1
-16,0,-16,0,1,1
4,14,-10,0,1,1
38,26,12,1,1,0
-12,-30,18,1,1,0
-11,2,-13,0,1,1
24,27,-3,0,1,1
10,13,-3,0,1,1
-17,-10,-7,0,1,1
-14,-26,12,1,1,0
-49,-32,-17,0,1,1
-17,-23,6,1,1,0
24,14,10,1,1,0
-9,4,-13,0,1,1
52,32,20,1,1,0
-12,0,-12,0,1,1
-4,2,-6,0,1,1
22,17,5,1,1,0
21,34,-13,0,0,0
-10,-25,15,1,0,1
9,-8,17,1,0,1
46,43,3,1,0,1
-57,-43,-14,0,0,0
31,31,0,0,0,0
-1,4,-5,0,0,0
9,-2,11,1,0,1
35,19,16,1,0,1
-12,-4,-8,0,0,0
-24,-13,-11,0,0,0
4,-2,6,1,1,0
29,20,9,1,1,0
-21,-26,5,1,1,0
29,37,-8,0,1,1
22,16,6,1,1,0
-32,-25,-7,0,1,1
-37,-19,-18,0,1,1
20,26,-6,0,1,1
20,7,13,1,0,1
-25,-26,1,1,0,1
28,16,12,1,0,1
23,11,12,1,0,1
-23,-7,-16,0,0,0
28,16,12,1,0,1
-21,-4,-17,0,0,0
-26,-8,-18,0,0,0
-43,-44,1,1,0,1
-16,-20,4,1,0,1
-13,-30,17,1,0,1
45,35,10,1,0,1
-20,-20,0,0,0,0
-20,-12,-8,0,0,0
37,32,5,1,0,1
27,30,-3,0,0,0
37,30,7,1,0,1
-19,-6,-13,0,0,0
-52,-32,-20,0,0,0
13,24,-11,0,0,0
-19,-24,5,1,0,1
15,17,-2,0,1,1
16,33,-17,0,1,1
25,14,11,1,1,0
-49,-38,-11,0,1,1
11,-8,19,1,1,0
47,43,4,1,1,0
-29,-42,13,1,1,0
27,39,-12,0,1,1
51,38,13,1,1,0
23,38,-15,0,1,1
31,11,20,1,1,0
32,32,0,0,1,1
24,11,13,1,1,0
-15,-19,4,1,0,1
-19,-4,-15,0,0,0
9,23,-14,0,0,0
-9,4,-13,0,0,0
2,-16,18,1,0,1
-42,-32,-10,0,0,0
-26,-16,-10,0,0,0
17,32,-15,0,0,0
-28,-28,0,0,0,0
-57,-40,-17,0,0,0
1,-4,5,1,0,1
-46,-26,-20,0,0,0
-47,-30,-17,0,0,0
-44,-31,-13,0,0,0
-39,-32,-7,0,0,0
-41,-40,-1,0,0,0
-15,-18,3,1,0,1
40,40,0,0,0,0
22,39,-17,0,0,0
16,11,5,1,0,1
-32,-37,5,1,0,1
26,25,1,1,1,0
-6,0,-6,0,1,1
-32,-28,-4,0,1,1
-45,-26,-19,0,1,1
-30,-24,-6,0,1,1
-25,-33,8,1,1,0
32,22,10,1,1,0
13,12,1,1,1,0
0,6,-6,0,1,1
-7,-10,3,1,1,0
17,0,17,1,1,0
-24,-18,-6,0,1,1
-50,-35,-15,0,1,1
-27,-13,-14,0,0,0
9,1,8,1,0,1
-3,-10,7,1,0,1
-55,-44,-11,0,0,0
-18,-2,-16,0,0,0
9,2,7,1,0,1
-41,-23,-18,0,0,0
3,0,3,1,0,1
2,19,-17,0,0,0
-25,-44,19,1,0,1
7,-4,11,1,0,1
25,20,5,1,0,1
8,1,7,1,1,0
9,10,-1,0,1,1
37,32,5,1,1,0
49,38,11,1,1,0
32,26,6,1,1,0
2,-4,6,1,1,0
-7,1,-8,0,1,1
-39,-38,-1,0,1,1
15,18,-3,0,0,0
38,44,-6,0,0,0
26,23,3,1,0,1
37,34,3,1,0,1
-36,-22,-14,0,0,0
-34,-40,6,1,0,1
-8,8,-16,0,0,0
9,11,-2,0,0,0
14,-6,20,1,0,1
37,43,-6,0,0,0
-14,-1,-13,0,0,0
-28,-15,-13,0,0,0
-2,-21,19,1,0,1
-2,9,-11,0,0,0
-10,6,-16,0,0,0
-9,-26,17,1,0,1
-30,-18,-12,0,0,0
-15,-14,-1,0,0,0
-6,-18,12,1,0,1
42,40,2,1,0,1
4,13,-9,0,0,0
-12,-31,19,1,1,0
13,16,-3,0,1,1
-1,18,-19,0,1,1
14,8,6,1,1,0
27,43,-16,0,1,1
2,17,-15,0,1,1
-39,-28,-11,0,1,1
23,6,17,1,1,0
-32,-31,-1,0,1,1
-20,-22,2,1,1,0
-19,1,-20,0,0,0
16,11,5,1,0,1
-25,-16,-9,0,0,0
18,7,11,1,0,1
38,44,-6,0,0,0
48,44,4,1,0,1
-33,-15,-18,0,0,0
2,-13,15,1,0,1
35,23,12,1,1,0
24,10,14,1,1,0
24,24,0,0,1,1
53,37,16,1,1,0
-8,4,-12,0,1,1
-14,-16,2,1,1,0
-40,-41,1,1,1,0
22,2,20,1,1,0
37,32,5,1,1,0
15,21,-6,0,1,1
10,-6,16,1,1,0
-41,-36,-5,0,1,1
8,20,-12,0,1,1
25,29,-4,0,1,1
12,30,-18,0,1,1
-7,-4,-3,0,1,1
-30,-43,13,1,1,0
13,12,1,1,1,0
-13,-18,5,1,1,0
-9,-29,20,1,1,0
-4,-11,7,1,1,0
-47,-28,-19,0,0,0
-18,-24,6,1,0,1
0,-20,20,1,0,1
15,12,3,1,0,1
-29,-34,5,1,0,1
-27,-39,12,1,0,1
-12,1,-13,0,0,0
-15,-9,-6,0,0,0
3,8,-5,0,0,0
20,37,-17,0,0,0
6,-6,12,1,0,1
-7,7,-14,0,0,0
7,-5,12,1,0,1
11,23,-12,0,0,0
20,29,-9,0,1,1
12,-8,20,1,1,0
-29,-11,-18,0,1,1
6,9,-3,0,1,1
46,33,13,1,1,0
1,14,-13,0,1,1
-17,-19,2,1,1,0
-37,-24,-13,0,1,1
-23,-39,16,1,1,0
32,42,-10,0,1,1
-30,-40,10,1,1,0
29,25,4,1,1,0
-22,-35,13,1,0,1
-4,3,-7,0,0,0
17,30,-13,0,0,0
-58,-41,-17,0,0,0
20,8,12,1,0,1
-35,-15,-20,0,0,0
34,28,6,1,0,1
-37,-17,-20,0,0,0
53,43,10,1,0,1
-5,-25,20,1,0,1
-13,-15,2,1,0,1
-55,-44,-11,0,0,0
5,17,-12,0,0,0
-18,-1,-17,0,0,0
14,16,-2,0,0,0
8,2,6,1,0,1
-45,-31,-14,0,0,0
-9,-5,-4,0,0,0
10,0,10,1,0,1
5,15,-10,0,0,0
5,19,-14,0,0,0
27,22,5,1,1,0
-33,-14,-19,0,1,1
-22,-11,-11,0,1,1
37,33,4,1,1,0
10,11,-1,0,1,1
39,37,2,1,1,0
12,21,-9,0,1,1
-23,-42,19,1,1,0
-19,-28,9,1,0,1
52,36,16,1,0,1
-35,-36,1,1,0,1
24,7,17,1,0,1
30,40,-10,0,0,0
33,29,4,1,0,1
33,15,18,1,0,1
18,5,13,1,0,1
14,5,9,1,0,1
-8,-24,16,1,0,1
-11,-6,-5,0,0,0
-26,-38,12,1,0,1
11,17,-6,0,0,0
33,25,8,1,0,1
33,23,10,1,0,1
-26,-17,-9,0,1,1
-4,-2,-2,0,1,1
61,41,20,1,1,0
-52,-39,-13,0,1,1
16,24,-8,0,1,1
-20,-36,16,1,1,0
14,5,9,1,1,0
-47,-44,-3,0,1,1
-6,-26,20,1,1,0
-18,-19,1,1,1,0
6,23,-17,0,1,1
-5,-16,11,1,1,0
33,24,9,1,1,0
-6,8,-14,0,1,1
-2,7,-9,0,1,1
22,18,4,1,1,0
-3,14,-17,0,1,1
12,18,-6,0,1,1
2,10,-8,0,1,1
41,35,6,1,1,0
-49,-31,-18,0,1,1
24,12,12,1,0,1
5,9,-4,0,0,0
-34,-43,9,1,0,1
-42,-31,-11,0,0,0
26,11,15,1,0,1
-34,-23,-11,0,0,0
-42,-39,-3,0,0,0
8,10,-2,0,0,0
57,42,15,1,0,1
-5,-18,13,1,0,1
24,29,-5,0,0,0
-24,-19,-5,0,0,0
-26,-15,-11,0,0,0
-28,-25,-3,0,0,0
-43,-28,-15,0,0,0
18,9,9,1,0,1
38,27,11,1,0,1
11,-2,13,1,0,1
-37,-27,-10,0,0,0
29,27,2,1,0,1
40,44,-4,0,0,0
3,-11,14,1,1,0
40,24,16,1,1,0
-41,-42,1,1,1,0
32,37,-5,0,1,1
46,35,11,1,1,0
-5,-3,-2,0,1,1
-13,-3,-10,0,1,1
49,31,18,1,1,0
-5,14,-19,0,1,1
12,30,-18,0,1,1
23,33,-10,0,1,1
9,11,-2,0,1,1
-30,-40,10,1,1,0
-22,-36,14,1,1,0
0,-2,2,1,0,1
-2,7,-9,0,0,0
-5,-25,20,1,0,1
55,35,20,1,0,1
42,24,18,1,0,1
-16,-8,-8,0,0,0
-46,-26,-20,0,0,0
-33,-13,-20,0,0,0
-11,-21,10,1,0,1
6,3,3,1,0,1
-30,-32,2,1,0,1
15,13,2,1,0,1
-2,-8,6,1,0,1
-32,-13,-19,0,0,0
53,42,11,1,1,0
-5,0,-5,0,1,1
1,-16,17,1,1,0
-17,-27,10,1,1,0
8,23,-15,0,1,1
1,12,-11,0,1,1
22,41,-19,0,1,1
-9,-8,-1,0,1,1
10,6,4,1,1,0
-7,0,-7,0,1,1
-34,-35,1,1,1,0
8,-7,15,1,1,0
33,15,18,1,1,0
48,28,20,1,0,1
-38,-37,-1,0,0,0
35,34,1,1,0,1
8,-1,9,1,0,1
15,31,-16,0,0,0
8,15,-7,0,0,0
27,9,18,1,0,1
-25,-36,11,1,0,1
-16,-18,2,1,0,1
27,40,-13,0,0,0
-26,-15,-11,0,0,0
-5,-19,14,1,0,1
-47,-32,-15,0,0,0
-28,-28,0,0,0,0
-35,-37,2,1,0,1
10,16,-6,0,0,0
-18,-11,-7,0,0,0
-14,-30,16,1,0,1
-60,-40,-20,0,0,0
33,39,-6,0,0,0
-53,-38,-15,0,0,0
8,-3,11,1,1,0
-37,-30,-7,0,1,1
2,-14,16,1,1,0
4,3,1,1,1,0
-51,-32,-19,0,1,1
-52,-36,-16,0,1,1
17,2,15,1,1,0
-20,-29,9,1,1,0
-16,-25,9,1,1,0
-15,-27,12,1,1,0
38,36,2,1,1,0
44,37,7,1,1,0
5,-13,18,1,0,1
-30,-10,-20,0,0,0
-14,-23,9,1,0,1
11,15,-4,0,0,0
-23,-15,-8,0,0,0
27,21,6,1,0,1
4,14,-10,0,0,0
-59,-44,-15,0,0,0
-37,-40,3,1,0,1
20,25,-5,0,1,1
9,25,-16,0,1,1
38,37,1,1,1,0
29,29,0,0,1,1
-29,-26,-3,0,1,1
-19,-34,15,1,1,0
12,24,-12,0,1,1
14,-5,19,1,1,0
-33,-34,1,1,1,0
-38,-31,-7,0,0,0
13,13,0,0,0,0
47,35,12,1,0,1
-53,-43,-10,0,0,0
43,33,10,1,0,1
-9,2,-11,0,0,0
8,20,-12,0,0,0
-18,-13,-5,0,0,0
-6,-4,-2,0,0,0
-23,-40,17,1,0,1
-28,-35,7,1,0,1
-29,-38,9,1,0,1
43,36,7,1,0,1
21,31,-10,0,0,0
17,18,-1,0,0,0
44,24,20,1,0,1
-52,-45,-7,0,1,1
-7,-16,9,1,1,0
-3,6,-9,0,1,1
7,7,0,0,1,1
51,42,9,1,1,0
14,5,9,1,1,0
-36,-31,-5,0,1,1
26,7,19,1,1,0
-64,-44,-20,0,1,1
-39,-41,2,1,1,0
45,40,5,1,1,0
18,10,8,1,1,0
28,44,-16,0,0,0
-43,-33,-10,0,0,0
23,15,8,1,0,1
-5,7,-12,0,0,0
-38,-30,-8,0,0,0
-17,-12,-5,0,0,0
14,-4,18,1,0,1
-20,-8,-12,0,0,0
-21,-25,4,1,1,0
-28,-38,10,1,1,0
-23,-38,15,1,1,0
-6,4,-10,0,1,1
-19,-21,2,1,1,0
21,6,15,1,1,0
-25,-37,12,1,1,0
16,8,8,1,1,0
37,38,-1,0,0,0
16,26,-10,0,0,0
63,44,19,1,0,1
-4,0,-4,0,0,0
21,13,8,1,0,1
37,33,4,1,0,1
-44,-25,-19,0,0,0
-11,-19,8,1,0,1
-47,-43,-4,0,0,0
28,42,-14,0,1,1
32,43,-11,0,1,1
-2,-11,9,1,1,0
-19,-34,15,1,1,0
-37,-44,7,1,1,0
-26,-16,-10,0,1,1
-40,-24,-16,0,1,1
8,-11,19,1,1,0
17,6,11,1,1,0
-14,-23,9,1,1,0
-5,-19,14,1,1,0
-18,-23,5,1,1,0
-46,-29,-17,0,1,1
-30,-36,6,1,1,0
5,4,1,1,1,0
15,-3,18,1,1,0
-27,-31,4,1,1,0
-3,-20,17,1,1,0
-52,-34,-18,0,1,1
50,32,18,1,1,0
24,25,-1,0,1,1
46,30,16,1,0,1
-25,-9,-16,0,0,0
-38,-41,3,1,0,1
39,30,9,1,0,1
-4,-17,13,1,0,1
-30,-12,-18,0,0,0
9,26,-17,0,0,0
-8,-3,-5,0,0,0
24,13,11,1,0,1
-2,10,-12,0,0,0
-13,0,-13,0,0,0
-40,-33,-7,0,0,0
-12,1,-13,0,0,0
31,41,-10,0,0,0
-14,0,-14,0,0,0
22,39,-17,0,0,0
19,29,-10,0,0,0
30,16,14,1,0,1
-8,-7,-1,0,0,0
55,44,11,1,0,1
4,-7,11,1,0,1
7,5,2,1,1,0
8,-4,12,1,1,0
-12,6,-18,0,1,1
37,17,20,1,1,0
36,16,20,1,1,0
17,19,-2,0,1,1
0,5,-5,0,1,1
-37,-18,-19,0,1,1
37,43,-6,0,1,1
23,31,-8,0,1,1
-32,-28,-4,0,1,1
-19,-18,-1,0,1,1
32,13,19,1,1,0
28,27,1,1,1,0
-26,-44,18,1,1,0
-17,-19,2,1,1,0
-10,-9,-1,0,1,1
10,22,-12,0,0,0
-33,-45,12,1,0,1
-10,-7,-3,0,0,0
-16,-32,16,1,0,1
33,35,-2,0,0,0
16,15,1,1,0,1
-7,-26,19,1,0,1
-4,-6,2,1,0,1
-26,-23,-3,0,0,0
-33,-44,11,1,0,1
28,21,7,1,0,1
-21,-27,6,1,0,1
7,-2,9,1,1,0
23,24,-1,0,1,1
-46,-45,-1,0,1,1
14,-2,16,1,1,0
51,43,8,1,1,0
1,4,-3,0,1,1
25,8,17,1,1,0
-28,-18,-10,0,1,1
36,25,11,1,1,0
-22,-7,-15,0,1,1
-10,-25,15,1,1,0
1,17,-16,0,1,1
-27,-30,3,1,1,0
12,24,-12,0,1,1
-43,-37,-6,0,1,1
22,25,-3,0,1,1
16,-2,18,1,1,0
-24,-28,4,1,1,0
29,30,-1,0,0,0
-12,0,-12,0,0,0
-16,-31,15,1,0,1
28,28,0,0,0,0
-53,-41,-12,0,0,0
-15,-1,-14,0,0,0
-61,-41,-20,0,0,0
26,12,14,1,0,1
-4,5,-9,0,0,0
-4,-1,-3,0,0,0
-19,-34,15,1,1,0
29,22,7,1,1,0
26,28,-2,0,1,1
-48,-32,-16,0,1,1
20,10,10,1,1,0
-24,-8,-16,0,1,1
-7,-16,9,1,1,0
-6,0,-6,0,1,1
1,4,-3,0,1,1
-26,-12,-14,0,1,1
-4,4,-8,0,1,1
43,37,6,1,1,0
8,20,-12,0,1,1
-23,-9,-14,0,1,1
44,44,0,0,1,1
-10,-6,-4,0,1,1
25,36,-11,0,1,1
-48,-40,-8,0,0,0
-38,-43,5,1,0,1
-59,-45,-14,0,0,0
-35,-25,-10,0,0,0
-39,-37,-2,0,0,0
22,11,11,1,0,1
21,36,-15,0,0,0
-23,-38,15,1,0,1
21,38,-17,0,0,0
-2,-21,19,1,0,1
13,6,7,1,0,1
-50,-40,-10,0,0,0
-43,-26,-17,0,0,0
13,25,-12,0,0,0
41,30,11,1,0,1
-38,-38,0,0,0,0
-20,-26,6,1,0,1
10,22,-12,0,0,0
26,11,15,1,0,1
-11,-4,-7,0,0,0
42,24,18,1,0,1
-15,-18,3,1,1,0
-25,-11,-14,0,1,1
-12,-6,-6,0,1,1
-16,-6,-10,0,1,1
-15,-32,17,1,1,0
3,19,-16,0,1,1
-8,-20,12,1,1,0
-11,8,-19,0,1,1
39,41,-2,0,0,0
-8,-16,8,1,0,1
-19,-15,-4,0,0,0
-52,-35,-17,0,0,0
29,30,-1,0,0,0
20,34,-14,0,0,0
14,-2,16,1,0,1
-15,-26,11,1,0,1
14,14,0,0,0,0
-28,-30,2,1,0,1
-32,-43,11,1,1,0
39,28,11,1,1,0
-16,0,-16,0,1,1
-2,-4,2,1,1,0
-57,-43,-14,0,1,1
-47,-29,-18,0,1,1
-1,-21,20,1,1,0
-57,-40,-17,0,1,1
25,11,14,1,1,0
17,14,3,1,0,1
37,38,-1,0,0,0
8,5,3,1,0,1
-10,-9,-1,0,0,0
17,1,16,1,0,1
-11,9,-20,0,0,0
-35,-26,-9,0,0,0
12,18,-6,0,0,0
32,20,12,1,0,1
9,1,8,1,0,1
-61,-44,-17,0,0,0
21,39,-18,0,0,0
-9,-22,13,1,1,0
15,26,-11,0,1,1
-27,-9,-18,0,1,1
13,19,-6,0,1,1
-23,-37,14,1,1,0
31,28,3,1,1,0
24,28,-4,0,1,1
44,40,4,1,1,0
-14,-22,8,1,1,0
-39,-35,-4,0,1,1
18,35,-17,0,1,1
-13,5,-18,0,1,1
3,13,-10,0,1,1
39,26,13,1,1,0
28,23,5,1,0,1
29,13,16,1,0,1
-29,-39,10,1,0,1
-19,-19,0,0,0,0
6,3,3,1,0,1
3,-13,16,1,0,1
4,19,-15,0,0,0
-11,-6,-5,0,0,0
27,8,19,1,0,1
10,23,-13,0,0,0
-2,-3,1,1,0,1
25,25,0,0,0,0
12,21,-9,0,0,0
-32,-24,-8,0,0,0
29,37,-8,0,0,0
34,34,0,0,0,0
-25,-29,4,1,0,1
-34,-17,-17,0,0,0
21,38,-17,0,0,0
-12,7,-19,0,0,0
31,23,8,1,0,1
9,28,-19,0,1,1
7,8,-1,0,1,1
-30,-35,5,1,1,0
-16,-36,20,1,1,0
-45,-40,-5,0,1,1
-34,-28,-6,0,1,1
35,23,12,1,1,0
-11,1,-12,0,1,1
-50,-33,-17,0,1,1
34,24,10,1,1,0
9,-10,19,1,1,0
3,12,-9,0,0,0
19,19,0,0,0,0
23,14,9,1,0,1
-37,-39,2,1,0,1
44,43,1,1,0,1
-63,-45,-18,0,0,0
-15,-26,11,1,0,1
-39,-19,-20,0,0,0
19,22,-3,0,0,0
49,42,7,1,0,1
-34,-28,-6,0,1,1
38,25,13,1,1,0
4,20,-16,0,1,1
25,32,-7,0,1,1
20,2,18,1,1,0
26,35,-9,0,1,1
-48,-30,-18,0,1,1
-2,-20,18,1,1,0
-55,-35,-20,0,1,1
-19,-12,-7,0,1,1
32,12,20,1,1,0
24,18,6,1,1,0
-43,-35,-8,0,1,1
0,-1,1,1,1,0
39,39,0,0,1,1
53,34,19,1,0,1
44,25,19,1,0,1
-39,-33,-6,0,0,0
-26,-23,-3,0,0,0
-35,-35,0,0,0,0
-26,-22,-4,0,0,0
-15,-16,1,1,0,1
41,28,13,1,0,1
47,42,5,1,0,1
24,20,4,1,1,0
30,23,7,1,1,0
-17,-23,6,1,1,0
27,9,18,1,1,0
-45,-30,-15,0,1,1
-17,-10,-7,0,1,1
5,-14,19,1,1,0
-31,-25,-6,0,1,1
-25,-17,-8,0,0,0
20,2,18,1,0,1
-38,-19,-19,0,0,0
32,36,-4,0,0,0
8,0,8,1,0,1
-1,13,-14,0,0,0
-16,-2,-14,0,0,0
-35,-45,10,1,0,1
1,10,-9,0,0,0
24,24,0,0,0,0
-50,-40,-10,0,0,0
-34,-36,2,1,0,1
-7,-4,-3,0,0,0
-35,-36,1,1,1,0
38,25,13,1,1,0
-53,-42,-11,0,1,1
27,19,8,1,1,0
-20,-34,14,1,1,0
-7,-23,16,1,1,0
36,26,10,1,1,0
-9,-15,6,1,1,0
21,5,16,1,0,1
-22,-41,19,1,0,1
40,36,4,1,0,1
-48,-36,-12,0,0,0
-29,-21,-8,0,0,0
-7,-12,5,1,0,1
17,24,-7,0,0,0
23,34,-11,0,0,0
-7,9,-16,0,0,0
22,17,5,1,0,1
-8,10,-18,0,1,1
52,39,13,1,1,0
53,37,16,1,1,0
42,31,11,1,1,0
-17,-8,-9,0,1,1
47,42,5,1,1,0
-9,-3,-6,0,1,1
10,-4,14,1,1,0
26,8,18,1,1,0
-40,-39,-1,0,1,1
38,25,13,1,0,1
-20,-3,-17,0,0,0
13,20,-7,0,0,0
8,28,-20,0,0,0
4,14,-10,0,0,0
8,-3,11,1,0,1
-2,-14,12,1,0,1
-43,-24,-19,0,0,0
39,27,12,1,0,1
-50,-42,-8,0,0,0
7,11,-4,0,0,0
40,27,13,1,0,1
5,5,0,0,0,0
9,15,-6,0,0,0
-8,-14,6,1,0,1
21,26,-5,0,0,0
3,23,-20,0,1,1
29,12,17,1,1,0
20,31,-11,0,1,1
-57,-40,-17,0,1,1
-3,9,-12,0,1,1
-10,-27,17,1,1,0
-21,-30,9,1,1,0
-26,-18,-8,0,1,1
-29,-11,-18,0,1,1
37,39,-2,0,1,1
22,20,2,1,1,0
25,21,4,1,1,0
-14,-4,-10,0,1,1
-29,-11,-18,0,0,0
-59,-41,-18,0,0,0
20,28,-8,0,0,0
52,38,14,1,0,1
30,24,6,1,0,1
0,20,-20,0,0,0
51,32,19,1,0,1
28,41,-13,0,0,0
-38,-30,-8,0,0,0
-3,-9,6,1,0,1
-19,-12,-7,0,0,0
27,22,5,1,0,1
-21,-3,-18,0,0,0
-23,-22,-1,0,0,0
22,16,6,1,0,1
2,-11,13,1,0,1
-10,10,-20,0,0,0
-33,-45,12,1,0,1
-48,-45,-3,0,0,0
20,20,0,0,0,0
-12,6,-18,0,0,0
27,19,8,1,1,0
-4,-18,14,1,1,0
8,10,-2,0,1,1
-15,-13,-2,0,1,1
35,35,0,0,1,1
-23,-14,-9,0,1,1
1,1,0,0,1,1
0,5,-5,0,1,1
31,23,8,1,1,0
32,22,10,1,1,0
16,19,-3,0,1,1
-3,14,-17,0,1,1
-22,-17,-5,0,1,1
26,11,15,1,1,0
5,16,-11,0,1,1
27,33,-6,0,0,0
34,30,4,1,0,1
7,13,-6,0,0,0
-9,3,-12,0,0,0
1,6,-5,0,0,0
-15,2,-17,0,0,0
-34,-27,-7,0,0,0
19,4,15,1,0,1
41,21,20,1,0,1
-45,-40,-5,0,1,1
-47,-28,-19,0,1,1
5,17,-12,0,1,1
-8,-15,7,1,1,0
-20,-24,4,1,1,0
9,10,-1,0,1,1
-13,-29,16,1,1,0
13,-6,19,1,1,0
-10,-26,16,1,1,0
-42,-33,-9,0,0,0
19,15,4,1,0,1
-38,-25,-13,0,0,0
25,35,-10,0,0,0
-32,-38,6,1,0,1
-19,-24,5,1,0,1
-37,-41,4,1,0,1
-6,-1,-5,0,0,0
-10,-17,7,1,0,1
53,40,13,1,0,1
-16,-21,5,1,0,1
-20,-16,-4,0,0,0
49,29,20,1,0,1
-26,-28,2,1,0,1
52,38,14,1,0,1
-35,-18,-17,0,1,1
-32,-29,-3,0,1,1
-24,-34,10,1,1,0
9,17,-8,0,1,1
-18,-20,2,1,1,0
21,31,-10,0,1,1
10,-9,19,1,1,0
12,2,10,1,1,0
4,11,-7,0,1,1
-19,-38,19,1,0,1
-34,-20,-14,0,0,0
-37,-39,2,1,0,1
3,-15,18,1,0,1
18,34,-16,0,0,0
-12,-19,7,1,0,1
-50,-44,-6,0,0,0
-14,-17,3,1,0,1
-57,-42,-15,0,1,1
13,30,-17,0,1,1
-35,-36,1,1,1,0
-53,-34,-19,0,1,1
-5,-24,19,1,1,0
4,5,-1,0,1,1
-22,-15,-7,0,1,1
-29,-32,3,1,1,0
-31,-40,9,1,1,0
-18,-10,-8,0,1,1
31,31,0,0,0,0
-10,-16,6,1,0,1
8,-3,11,1,0,1
-49,-45,-4,0,0,0
-11,7,-18,0,0,0
-13,6,-19,0,0,0
33,13,20,1,0,1
-16,-36,20,1,0,1
-25,-19,-6,0,0,0
-36,-17,-19,0,0,0
30,44,-14,0,0,0
47,31,16,1,0,1
22,22,0,0,0,0
-8,-23,15,1,0,1
-15,-26,11,1,0,1
41,44,-3,0,0,0
-48,-29,-19,0,0,0
50,35,15,1,0,1
36,42,-6,0,0,0
50,36,14,1,0,1
-12,-20,8,1,0,1
36,30,6,1,1,0
-25,-35,10,1,1,0
31,43,-12,0,1,1
18,5,13,1,1,0
-29,-16,-13,0,1,1
-6,0,-6,0,1,1
35,31,4,1,1,0
17,12,5,1,1,0
-27,-11,-16,0,1,1
25,22,3,1,0,1
58,43,15,1,0,1
2,-10,12,1,0,1
42,33,9,1,0,1
-29,-11,-18,0,0,0
-22,-20,-2,0,0,0
-10,-7,-3,0,0,0
-12,8,-20,0,0,0
-8,-6,-2,0,0,0
11,1,10,1,0,1
27,41,-14,0,0,0
26,36,-10,0,0,0
-36,-45,9,1,0,1
-14,-14,0,0,0,0
26,6,20,1,0,1
-57,-38,-19,0,0,0
7,16,-9,0,0,0
31,20,11,1,0,1
-15,-30,15,1,0,1
-34,-26,-8,0,0,0
16,1,15,1,1,0
20,19,1,1,1,0
11,20,-9,0,1,1
9,18,-9,0,1,1
-11,5,-16,0,1,1
56,38,18,1,1,0
-25,-9,-16,0,1,1
38,20,18,1,1,0
-19,-39,20,1,1,0
-1,-21,20,1,1,0
-14,-13,-1,0,0,0
-4,-24,20,1,0,1
10,25,-15,0,0,0
14,30,-16,0,0,0
-25,-13,-12,0,0,0
22,17,5,1,0,1
54,41,13,1,0,1
-3,-15,12,1,0,1
33,31,2,1,0,1
19,7,12,1,1,0
13,26,-13,0,1,1
-29,-31,2,1,1,0
-18,-8,-10,0,1,1
-24,-25,1,1,1,0
-5,-4,-1,0,1,1
43,27,16,1,1,0
45,25,20,1,1,0
56,42,14,1,1,0
10,16,-6,0,1,1
16,30,-14,0,1,1
45,26,19,1,1,0
-4,-1,-3,0,1,1
19,23,-4,0,1,1
-21,-8,-13,0,1,1
31,15,16,1,1,0
5,15,-10,0,1,1
-44,-29,-15,0,1,1
23,4,19,1,1,0
36,31,5,1,0,1
-36,-37,1,1,0,1
22,25,-3,0,0,0
-2,-14,12,1,0,1
34,43,-9,0,0,0
31,33,-2,0,0,0
-3,5,-8,0,0,0
19,30,-11,0,0,0
1,-3,4,1,0,1
-58,-38,-20,0,0,0
26,7,19,1,0,1
-22,-32,10,1,0,1
-10,-10,0,0,0,0
-55,-43,-12,0,0,0
-10,-20,10,1,0,1
-1,14,-15,0,1,1
-15,2,-17,0,1,1
48,44,4,1,1,0
14,7,7,1,1,0
35,44,-9,0,1,1
30,42,-12,0,1,1
-26,-21,-5,0,1,1
-24,-36,12,1,1,0
-36,-34,-2,0,1,1
-24,-32,8,1,1,0
-30,-22,-8,0,0,0
-35,-28,-7,0,0,0
4,19,-15,0,0,0
-23,-21,-2,0,0,0
-4,-18,14,1,0,1
44,40,4,1,0,1
-19,-27,8,1,0,1
-30,-14,-16,0,0,0
25,37,-12,0,0,0
41,39,2,1,0,1
23,11,12,1,0,1
32,16,16,1,0,1
50,32,18,1,0,1
-3,14,-17,0,0,0
14,30,-16,0,0,0
60,43,17,1,0,1
37,36,1,1,1,0
55,35,20,1,1,0
20,15,5,1,1,0
29,27,2,1,1,0
-58,-39,-19,0,1,1
-40,-29,-11,0,1,1
-3,15,-18,0,1,1
-15,-35,20,1,1,0
-30,-20,-10,0,1,1
12,10,2,1,1,0
-14,-27,13,1,1,0
12,30,-18,0,1,1
-22,-35,13,1,1,0
10,-8,18,1,1,0
50,42,8,1,1,0
-45,-30,-15,0,1,1
-52,-35,-17,0,1,1
49,38,11,1,1,0
39,33,6,1,1,0
-14,-6,-8,0,1,1
29,42,-13,0,1,1
57,37,20,1,0,1
18,33,-15,0,0,0
12,12,0,0,0,0
3,16,-13,0,0,0
28,44,-16,0,0,0
42,36,6,1,0,1
-32,-12,-20,0,0,0
20,18,2,1,0,1
37,44,-7,0,0,0
-45,-37,-8,0,0,0
29,17,12,1,0,1
42,28,14,1,0,1
5,-6,11,1,0,1
35,32,3,1,0,1
-4,-1,-3,0,0,0
-49,-33,-16,0,0,0
-2,15,-17,0,0,0
-12,-31,19,1,0,1
-1,-14,13,1,0,1
30,33,-3,0,0,0
38,21,17,1,0,1
-2,6,-8,0,1,1
56,43,13,1,1,0
38,28,10,1,1,0
-10,5,-15,0,1,1
46,44,2,1,1,0
-14,-12,-2,0,1,1
24,11,13,1,1,0
6,3,3,1,1,0
14,20,-6,0,1,1
33,18,15,1,0,1
-56,-39,-17,0,0,0
25,8,17,1,0,1
-43,-26,-17,0,0,0
28,40,-12,0,0,0
-2,11,-13,0,0,0
6,25,-19,0,0,0
-19,-29,10,1,0,1
11,6,5,1,0,1
-45,-37,-8,0,1,1
12,29,-17,0,1,1
-6,-23,17,1,1,0
-17,-7,-10,0,1,1
21,36,-15,0,1,1
-17,2,-19,0,1,1
-11,-19,8,1,1,0
-31,-17,-14,0,1,1
-27,-34,7,1,1,0
-1,2,-3,0,0,0
23,22,1,1,0,1
39,34,5,1,0,1
-30,-31,1,1,0,1
39,20,19,1,0,1
-31,-28,-3,0,0,0
-18,-26,8,1,0,1
-23,-35,12,1,0,1
22,10,12,1,0,1
-21,-17,-4,0,0,0
40,41,-1,0,1,1
9,-2,11,1,1,0
-6,-12,6,1,1,0
-5,-16,11,1,1,0
5,-8,13,1,1,0
17,10,7,1,1,0
47,27,20,1,1,0
-21,-36,15,1,1,0
-8,-9,1,1,1,0
2,-17,19,1,1,0
-42,-27,-15,0,1,1
13,9,4,1,0,1
5,5,0,0,0,0
20,26,-6,0,0,0
30,39,-9,0,0,0
11,-1,12,1,0,1
31,26,5,1,0,1
-22,-2,-20,0,0,0
30,18,12,1,0,1
-3,-20,17,1,0,1
58,38,20,1,1,0
-19,-31,12,1,1,0
14,20,-6,0,1,1
39,41,-2,0,1,1
-17,-7,-10,0,1,1
27,7,20,1,1,0
-48,-35,-13,0,1,1
-11,-18,7,1,1,0
-7,-26,19,1,1,0
-52,-41,-11,0,1,1
24,7,17,1,1,0
-47,-41,-6,0,1,1
19,13,6,1,1,0
-4,14,-18,0,0,0
-11,-16,5,1,0,1
-12,-17,5,1,0,1
12,-4,16,1,0,1
54,35,19,1,0,1
2,2,0,0,0,0
18,8,10,1,0,1
-22,-11,-11,0,0,0
12,7,5,1,0,1
26,15,11,1,0,1
24,39,-15,0,0,0
-11,1,-12,0,0,0
25,39,-14,0,0,0
-28,-26,-2,0,0,0
52,43,9,1,0,1
5,20,-15,0,0,0
36,40,-4,0,0,0
55,40,15,1,0,1
-1,-15,14,1,0,1
-11,-22,11,1,0,1
-37,-41,4,1,0,1
1,-19,20,1,1,0
31,19,12,1,1,0
13,26,-13,0,1,1
-9,-6,-3,0,1,1
-31,-25,-6,0,1,1
34,29,5,1,1,0
-53,-41,-12,0,1,1
18,22,-4,0,1,1
5,17,-12,0,1,1
-32,-42,10,1,1,0
3,6,-3,0,1,1
-46,-26,-20,0,0,0
28,23,5,1,0,1
22,32,-10,0,0,0
28,11,17,1,0,1
28,15,13,1,0,1
5,25,-20,0,0,0
-18,-27,9,1,0,1
-23,-13,-10,0,0,0
31,11,20,1,0,1
20,21,-1,0,0,0
47,34,13,1,0,1
-40,-43,3,1,0,1
-45,-30,-15,0,0,0
37,44,-7,0,0,0
-28,-19,-9,0,0,0
31,22,9,1,0,1
-44,-31,-13,0,1,1
38,23,15,1,1,0
-33,-30,-3,0,1,1
22,23,-1,0,1,1
-20,-9,-11,0,1,1
58,44,14,1,1,0
9,23,-14,0,1,1
2,-14,16,1,1,0
53,34,19,1,1,0
-36,-39,3,1,1,0
-18,-23,5,1,1,0
-27,-28,1,1,1,0
-19,-12,-7,0,1,1
1,14,-13,0,1,1
20,32,-12,0,1,1
-49,-31,-18,0,1,1
-16,-34,18,1,1,0
-1,-13,12,1,0,1
50,38,12,1,0,1
16,18,-2,0,0,0
-7,-13,6,1,0,1
30,17,13,1,0,1
18,17,1,1,0,1
-28,-11,-17,0,0,0
-29,-30,1,1,0,1
2,1,1,1,0,1
6,-10,16,1,0,1
-26,-42,16,1,0,1
23,25,-2,0,0,0
-12,7,-19,0,0,0
-26,-15,-11,0,0,0
36,19,17,1,0,1
10,27,-17,0,0,0
-30,-29,-1,0,0,0
6,4,2,1,0,1
-9,0,-9,0,0,0
22,35,-13,0,1,1
29,9,20,1,1,0
44,39,5,1,1,0
-33,-19,-14,0,1,1
26,8,18,1,1,0
36,19,17,1,1,0
4,21,-17,0,1,1
-28,-35,7,1,1,0
51,43,8,1,1,0
16,12,4,1,1,0
11,23,-12,0,1,1
-30,-39,9,1,1,0
-11,-17,6,1,1,0
41,27,14,1,1,0
-13,-19,6,1,1,0
-24,-9,-15,0,1,1
43,37,6,1,1,0
-14,-12,-2,0,1,1
-31,-41,10,1,1,0
-2,-21,19,1,1,0
20,8,12,1,1,0
1,4,-3,0,0,0
-8,-4,-4,0,0,0
-23,-30,7,1,0,1
35,16,19,1,0,1
-13,-32,19,1,0,1
37,33,4,1,0,1
44,24,20,1,0,1
-22,-14,-8,0,0,0
-1,-4,3,1,0,1
24,18,6,1,0,1
6,21,-15,0,0,0
-4,5,-9,0,0,0
17,5,12,1,0,1
-22,-37,15,1,0,1
-7,2,-9,0,0,0
28,35,-7,0,1,1
-39,-25,-14,0,1,1
-2,14,-16,0,1,1
-21,-21,0,0,1,1
-13,-19,6,1,1,0
21,15,6,1,1,0
-19,-5,-14,0,1,1
22,37,-15,0,1,1
-46,-26,-20,0,1,1
1,0,1,1,1,0
-32,-16,-16,0,1,1
-23,-25,2,1,1,0
28,21,7,1,0,1
30,20,10,1,0,1
-26,-45,19,1,0,1
-19,-1,-18,0,0,0
-33,-29,-4,0,0,0
-17,-30,13,1,0,1
-31,-31,0,0,0,0
35,42,-7,0,0,0
33,38,-5,0,1,1
-31,-24,-7,0,1,1
-34,-21,-13,0,1,1
22,29,-7,0,1,1
-20,-19,-1,0,1,1
2,-5,7,1,1,0
14,5,9,1,1,0
-9,-18,9,1,1,0
18,5,13,1,1,0
-17,-6,-11,0,1,1
-31,-22,-9,0,1,1
29,25,4,1,1,0
14,29,-15,0,1,1
14,-6,20,1,0,1
19,13,6,1,0,1
10,10,0,0,0,0
1,18,-17,0,0,0
6,-11,17,1,0,1
61,44,17,1,0,1
19,20,-1,0,0,0
49,41,8,1,0,1
39,22,17,1,0,1
0,14,-14,0,0,0
54,37,17,1,0,1
-21,-8,-13,0,0,0
-28,-34,6,1,0,1
-13,-9,-4,0,0,0
-43,-25,-18,0,0,0
-17,-32,15,1,0,1
-54,-45,-9,0,0,0
-1,-8,7,1,0,1
-7,-23,16,1,0,1
-11,-4,-7,0,0,0
32,24,8,1,1,0
-21,-13,-8,0,1,1
42,32,10,1,1,0
-38,-22,-16,0,1,1
-46,-32,-14,0,1,1
23,23,0,0,1,1
58,41,17,1,1,0
32,16,16,1,1,0
20,14,6,1,1,0
-33,-13,-20,0,1,1
-21,-4,-17,0,1,1
16,36,-20,0,1,1
5,0,5,1,1,0
-45,-27,-18,0,1,1
-48,-41,-7,0,1,1
1,15,-14,0,1,1
-25,-15,-10,0,1,1
35,16,19,1,1,0
13,8,5,1,1,0
29,22,7,1,1,0
32,15,17,1,1,0
8,-12,20,1,0,1
-25,-13,-12,0,0,0
-37,-45,8,1,0,1
2,-2,4,1,0,1
17,-3,20,1,0,1
-3,7,-10,0,0,0
-55,-44,-11,0,0,0
-21,-11,-10,0,0,0
12,20,-8,0,0,0
-8,-12,4,1,0,1
-18,-32,14,1,0,1
44,37,7,1,0,1
-23,-13,-10,0,0,0
37,43,-6,0,0,0
17,15,2,1,0,1
-24,-44,20,1,0,1
-38,-32,-6,0,0,0
8,4,4,1,0,1
-33,-38,5,1,0,1
-14,-9,-5,0,1,1
-41,-21,-20,0,1,1
1,-17,18,1,1,0
37,26,11,1,1,0
15,5,10,1,1,0
20,13,7,1,1,0
-37,-30,-7,0,1,1
-45,-28,-17,0,1,1
34,38,-4,0,1,1
-32,-43,11,1,1,0
-23,-18,-5,0,1,1
-22,-29,7,1,1,0
13,17,-4,0,1,1
53,40,13,1,0,1
-39,-43,4,1,0,1
-28,-26,-2,0,0,0
34,21,13,1,0,1
10,19,-9,0,0,0
-63,-43,-20,0,0,0
-36,-23,-13,0,0,0
-24,-17,-7,0,0,0
43,39,4,1,0,1
-34,-36,2,1,0,1
-1,-11,10,1,0,1
-31,-23,-8,0,0,0
45,36,9,1,0,1
20,31,-11,0,0,0
-43,-32,-11,0,0,0
54,44,10,1,0,1
2,-17,19,1,0,1
20,6,14,1,0,1
40,27,13,1,0,1
20,37,-17,0,0,0
-5,11,-16,0,0,0
-35,-15,-20,0,1,1
32,16,16,1,1,0
31,25,6,1,1,0
16,35,-19,0,1,1
62,44,18,1,1,0
24,20,4,1,1,0
-15,-20,5,1,1,0
22,11,11,1,1,0
1,-5,6,1,0,1
-32,-37,5,1,0,1
-2,16,-18,0,0,0
2,-17,19,1,0,1
29,43,-14,0,0,0
4,15,-11,0,0,0
32,30,2,1,0,1
35,25,10,1,0,1
-3,5,-8,0,0,0
5,-14,19,1,0,1
-17,-36,19,1,0,1
-17,-15,-2,0,0,0
13,-6,19,1,0,1
4,-8,12,1,1,0
16,17,-1,0,1,1
44,33,11,1,1,0
23,35,-12,0,1,1
3,18,-15,0,1,1
-25,-17,-8,0,1,1
-35,-35,0,0,1,1
-39,-42,3,1,1,0
-11,-31,20,1,1,0
46,31,15,1,1,0
-4,1,-5,0,1,1
-16,-9,-7,0,1,1
5,10,-5,0,0,0
-4,6,-10,0,0,0
43,26,17,1,0,1
-12,-27,15,1,0,1
-56,-38,-18,0,0,0
41,39,2,1,0,1
27,37,-10,0,0,0
27,19,8,1,0,1
-53,-37,-16,0,0,0
21,21,0,0,0,0
-8,-13,5,1,0,1
14,8,6,1,0,1
25,44,-19,0,1,1
-24,-32,8,1,1,0
16,0,16,1,1,0
30,35,-5,0,1,1
11,9,2,1,1,0
24,13,11,1,1,0
37,41,-4,0,1,1
1,16,-15,0,1,1
11,24,-13,0,1,1
18,35,-17,0,1,1
-12,0,-12,0,1,1
36,35,1,1,1,0
30,30,0,0,1,1
-5,-20,15,1,1,0
-14,-23,9,1,1,0
33,37,-4,0,1,1
-44,-40,-4,0,1,1
-49,-29,-20,0,1,1
-17,-26,9,1,0,1
0,5,-5,0,0,0
-16,-23,7,1,0,1
11,17,-6,0,0,0
38,41,-3,0,0,0
16,3,13,1,0,1
10,23,-13,0,0,0
-41,-38,-3,0,0,0
-12,-22,10,1,0,1
-28,-42,14,1,0,1
23,13,10,1,1,0
-6,5,-11,0,1,1
36,17,19,1,1,0
4,4,0,0,1,1
-30,-13,-17,0,1,1
14,-6,20,1,1,0
41,29,12,1,1,0
11,7,4,1,1,0
-2,3,-5,0,1,1
-23,-31,8,1,1,0
-9,-3,-6,0,1,1
11,3,8,1,1,0
32,44,-12,0,1,1
-34,-27,-7,0,1,1
-12,-23,11,1,1,0
17,29,-12,0,1,1
-40,-29,-11,0,1,1
39,37,2,1,0,1
-18,-4,-14,0,0,0
42,24,18,1,0,1
-35,-36,1,1,0,1
-40,-45,5,1,0,1
57,40,17,1,0,1
-6,11,-17,0,0,0
-23,-25,2,1,0,1
-36,-41,5,1,1,0
-21,-41,20,1,1,0
4,13,-9,0,1,1
15,6,9,1,1,0
-18,-5,-13,0,1,1
-5,1,-6,0,1,1
-27,-41,14,1,1,0
-44,-38,-6,0,1,1
-7,1,-8,0,1,1
29,16,13,1,1,0
-46,-37,-9,0,1,1
25,28,-3,0,1,1
5,-7,12,1,1,0
-20,-29,9,1,1,0
21,17,4,1,1,0
13,22,-9,0,1,1
-21,-22,1,1,1,0
-26,-14,-12,0,1,1
-3,-9,6,1,1,0
-40,-24,-16,0,1,1
4,9,-5,0,1,1
28,38,-10,0,0,0
-18,-15,-3,0,0,0
23,25,-2,0,0,0
-47,-35,-12,0,0,0
51,36,15,1,0,1
31,36,-5,0,0,0
-32,-30,-2,0,0,0
-13,-1,-12,0,0,0
-14,-10,-4,0,0,0
28,35,-7,0,1,1
-28,-14,-14,0,1,1
-14,-26,12,1,1,0
-25,-41,16,1,1,0
-8,-8,0,0,1,1
30,16,14,1,1,0
-15,-3,-12,0,1,1
49,31,18,1,1,0
-31,-30,-1,0,0,0
-16,-16,0,0,0,0
-3,-4,1,1,0,1
-38,-31,-7,0,0,0
-20,-11,-9,0,0,0
-53,-42,-11,0,0,0
24,43,-19,0,0,0
10,27,-17,0,0,0
18,34,-16,0,0,0
-45,-42,-3,0,0,0
28,8,20,1,0,1
-4,15,-19,0,0,0
-23,-5,-18,0,0,0
-5,-18,13,1,0,1
19,31,-12,0,0,0
-40,-42,2,1,0,1
-51,-43,-8,0,1,1
-23,-24,1,1,1,0
22,28,-6,0,1,1
-34,-36,2,1,1,0
56,41,15,1,1,0
-2,16,-18,0,1,1
49,36,13,1,1,0
3,-8,11,1,1,0
34,22,12,1,1,0
-23,-11,-12,0,1,1
25,10,15,1,1,0
7,21,-14,0,1,1
60,40,20,1,1,0
26,30,-4,0,1,1
41,26,15,1,1,0
30,38,-8,0,1,1
15,-2,17,1,1,0
34,18,16,1,1,0
7,27,-20,0,1,1
5,-5,10,1,1,0
-29,-35,6,1,1,0
23,35,-12,0,0,0
-20,-9,-11,0,0,0
-25,-41,16,1,0,1
33,23,10,1,0,1
15,35,-20,0,0,0
-47,-36,-11,0,0,0
-31,-34,3,1,0,1
-5,-23,18,1,0,1
-13,-19,6,1,1,0
7,22,-15,0,1,1
-10,-8,-2,0,1,1
-11,-21,10,1,1,0
-10,-17,7,1,1,0
43,23,20,1,1,0
-21,-18,-3,0,1,1
-35,-17,-18,0,1,1
-18,-4,-14,0,1,1
-18,-12,-6,0,1,1
-11,-8,-3,0,1,1
-24,-21,-3,0,1,1
-24,-42,18,1,0,1
-37,-20,-17,0,0,0
-2,7,-9,0,0,0
55,39,16,1,0,1
-18,-1,-17,0,0,0
-30,-36,6,1,0,1
-37,-39,2,1,0,1
9,-10,19,1,0,1
48,30,18,1,0,1
13,-4,17,1,0,1
-9,-15,6,1,0,1
-9,-29,20,1,1,0
40,21,19,1,1,0
37,37,0,0,1,1
-33,-32,-1,0,1,1
-40,-38,-2,0,1,1
19,1,18,1,1,0
3,-14,17,1,1,0
7,-13,20,1,1,0
-32,-12,-20,0,1,1
-9,10,-19,0,1,1
11,17,-6,0,0,0
31,23,8,1,0,1
36,28,8,1,0,1
-31,-25,-6,0,0,0
-25,-45,20,1,0,1
6,-2,8,1,0,1
7,15,-8,0,0,0
12,9,3,1,0,1
12,31,-19,0,0,0
-26,-6,-20,0,0,0
37,34,3,1,0,1
-30,-23,-7,0,0,0
20,22,-2,0,1,1
47,41,6,1,1,0
46,30,16,1,1,0
-21,-4,-17,0,1,1
-56,-44,-12,0,1,1
49,40,9,1,1,0
-24,-36,12,1,1,0
-2,-11,9,1,1,0
31,13,18,1,1,0
33,19,14,1,1,0
37,17,20,1,1,0
13,7,6,1,1,0
22,13,9,1,1,0
-23,-31,8,1,1,0
35,16,19,1,1,0
18,35,-17,0,1,1
21,6,15,1,1,0
8,21,-13,0,1,1
9,27,-18,0,1,1
-12,-5,-7,0,1,1
-34,-23,-11,0,1,1
-5,-2,-3,0,0,0
31,24,7,1,0,1
-17,-36,19,1,0,1
-6,-19,13,1,0,1
-35,-35,0,0,0,0
5,-3,8,1,0,1
-60,-41,-19,0,0,0
-11,-23,12,1,0,1
37,21,16,1,0,1
-6,14,-20,0,0,0
-44,-34,-10,0,0,0
1,-6,7,1,0,1
-26,-22,-4,0,0,0
-19,-1,-18,0,0,0
-26,-36,10,1,0,1
-4,-12,8,1,0,1
47,41,6,1,0,1
-62,-45,-17,0,0,0
7,10,-3,0,0,0
23,36,-13,0,0,0
13,21,-8,0,0,0
17,33,-16,0,1,1
55,37,18,1,1,0
29,37,-8,0,1,1
63,43,20,1,1,0
-17,-24,7,1,1,0
10,-4,14,1,1,0
41,30,11,1,1,0
30,12,18,1,1,0
40,43,-3,0,1,1
-1,-18,17,1,1,0
-26,-18,-8,0,1,1
-10,-5,-5,0,1,1
47,32,15,1,1,0
-13,-24,11,1,1,0
-20,-22,2,1,1,0
13,3,10,1,1,0
36,21,15,1,1,0
-40,-23,-17,0,1,1
42,43,-1,0,0,0
-36,-42,6,1,0,1
35,25,10,1,0,1
-3,9,-12,0,0,0
-13,-27,14,1,0,1
43,36,7,1,0,1
29,9,20,1,0,1
2,3,-1,0,0,0
-17,-7,-10,0,0,0
-45,-37,-8,0,0,0
-29,-10,-19,0,0,0
13,14,-1,0,0,0
-23,-16,-7,0,0,0
36,35,1,1,0,1
-17,-3,-14,0,0,0
57,44,13,1,0,1
-23,-42,19,1,0,1
-3,-23,20,1,0,1
38,38,0,0,0,0
-28,-39,11,1,0,1
-28,-42,14,1,0,1
-3,5,-8,0,1,1
-45,-42,-3,0,1,1
43,42,1,1,1,0
-42,-25,-17,0,1,1
5,14,-9,0,1,1
-40,-23,-17,0,1,1
7,12,-5,0,1,1
23,18,5,1,1,0
-41,-41,0,0,1,1
-29,-14,-15,0,1,1
-26,-42,16,1,1,0
3,-9,12,1,1,0
-63,-45,-18,0,1,1
-35,-34,-1,0,0,0
-2,-7,5,1,0,1
-7,5,-12,0,0,0
10,11,-1,0,0,0
11,21,-10,0,0,0
-7,3,-10,0,0,0
32,13,19,1,0,1
33,22,11,1,0,1
-18,-24,6,1,0,1
-15,-27,12,1,1,0
-12,-1,-11,0,1,1
44,39,5,1,1,0
41,25,16,1,1,0
-23,-24,1,1,1,0
34,37,-3,0,1,1
28,18,10,1,1,0
-62,-44,-18,0,1,1
8,-11,19,1,1,0
28,40,-12,0,1,1
25,11,14,1,1,0
-22,-32,10,1,1,0
24,42,-18,0,1,1
17,4,13,1,1,0
-8,-22,14,1,1,0
-36,-42,6,1,0,1
-11,-18,7,1,0,1
4,1,3,1,0,1
-11,5,-16,0,0,0
-3,-2,-1,0,0,0
29,44,-15,0,0,0
33,34,-1,0,0,0
9,-1,10,1,0,1
23,25,-2,0,0,0
9,-2,11,1,0,1
-55,-43,-12,0,0,0
-33,-43,10,1,0,1
45,41,4,1,0,1
6,9,-3,0,0,0
51,43,8,1,0,1
2,-17,19,1,0,1
29,29,0,0,0,0
10,-3,13,1,1,0
-43,-38,-5,0,1,1
26,44,-18,0,1,1
-50,-36,-14,0,1,1
52,36,16,1,1,0
9,14,-5,0,1,1
-27,-35,8,1,1,0
38,26,12,1,1,0
33,28,5,1,1,0
-5,-6,1,1,1,0
18,30,-12,0,0,0
26,29,-3,0,0,0
8,2,6,1,0,1
-15,-25,10,1,0,1
-16,-1,-15,0,0,0
13,3,10,1,0,1
-29,-29,0,0,0,0
23,14,9,1,0,1
16,13,3,1,0,1
-15,2,-17,0,0,0
-58,-45,-13,0,1,1
9,24,-15,0,1,1
-9,-23,14,1,1,0
25,23,2,1,1,0
-36,-18,-18,0,1,1
-25,-34,9,1,1,0
11,-4,15,1,1,0
41,27,14,1,1,0
-1,16,-17,0,1,1
-18,-34,16,1,1,0
46,37,9,1,1,0
36,33,3,1,1,0
27,18,9,1,1,0
26,32,-6,0,1,1
-55,-44,-11,0,1,1
15,20,-5,0,1,1
14,17,-3,0,0,0
64,44,20,1,0,1
-8,-8,0,0,0,0
58,41,17,1,0,1
-5,-10,5,1,0,1
-34,-19,-15,0,0,0
45,33,12,1,0,1
-56,-36,-20,0,0,0
-58,-41,-17,0,0,0
16,14,2,1,0,1
-10,-14,4,1,0,1
-12,-17,5,1,0,1
38,19,19,1,1,0
-22,-2,-20,0,1,1
-25,-29,4,1,1,0
16,30,-14,0,1,1
10,5,5,1,1,0
-25,-26,1,1,1,0
-22,-42,20,1,1,0
-19,-15,-4,0,1,1
-33,-22,-11,0,1,1
33,25,8,1,1,0
-7,9,-16,0,1,1
11,8,3,1,1,0
-9,-2,-7,0,1,1
27,23,4,1,1,0
-13,4,-17,0,1,1
20,30,-10,0,1,1
-4,14,-18,0,1,1
26,8,18,1,1,0
-64,-45,-19,0,1,1
-2,-2,0,0,1,1
-14,6,-20,0,1,1
39,38,1,1,0,1
-35,-15,-20,0,0,0
-14,0,-14,0,0,0
39,24,15,1,0,1
25,40,-15,0,0,0
-39,-39,0,0,0,0
1,-4,5,1,0,1
11,0,11,1,0,1
-34,-21,-13,0,0,0
52,40,12,1,0,1
22,17,5,1,1,0
-18,-23,5,1,1,0
36,29,7,1,1,0
-3,11,-14,0,1,1
6,12,-6,0,1,1
-3,-9,6,1,1,0
36,42,-6,0,1,1
-42,-28,-14,0,1,1
13,3,10,1,1,0
28,15,13,1,1,0
20,16,4,1,1,0
31,11,20,1,1,0
-26,-14,-12,0,1,1
-19,-18,-1,0,1,1
-14,-25,11,1,1,0
28,34,-6,0,0,0
-8,10,-18,0,0,0
6,5,1,1,0,1
42,34,8,1,0,1
9,10,-1,0,0,0
-11,8,-19,0,0,0
-13,-10,-3,0,0,0
9,-4,13,1,0,1
-30,-35,5,1,0,1
28,12,16,1,1,0
-39,-38,-1,0,1,1
-22,-41,19,1,1,0
-1,16,-17,0,1,1
-24,-43,19,1,1,0
-46,-33,-13,0,1,1
-49,-36,-13,0,1,1
11,9,2,1,1,0
-42,-43,1,1,1,0
-11,-13,2,1,1,0
-9,7,-16,0,1,1
-39,-33,-6,0,0,0
-29,-21,-8,0,0,0
-42,-31,-11,0,0,0
-22,-40,18,1,0,1
-31,-39,8,1,0,1
20,1,19,1,0,1
33,37,-4,0,0,0
-1,-9,8,1,0,1
21,8,13,1,0,1
-48,-41,-7,0,0,0
44,35,9,1,0,1
27,29,-2,0,1,1
18,24,-6,0,1,1
21,3,18,1,1,0
-17,-33,16,1,1,0
42,43,-1,0,1,1
21,28,-7,0,1,1
32,31,1,1,1,0
-19,-14,-5,0,1,1
-31,-11,-20,0,1,1
-16,-26,10,1,1,0
32,20,12,1,1,0
-4,-2,-2,0,1,1
-23,-33,10,1,1,0
-18,-27,9,1,0,1
-1,2,-3,0,0,0
17,17,0,0,0,0
-28,-22,-6,0,0,0
-8,-9,1,1,0,1
2,-8,10,1,0,1
-23,-27,4,1,0,1
37,17,20,1,0,1
51,41,10,1,0,1
-18,-17,-1,0,0,0
16,8,8,1,1,0
-17,0,-17,0,1,1
6,-3,9,1,1,0
29,26,3,1,1,0
40,33,7,1,1,0
24,8,16,1,1,0
7,4,3,1,1,0
-33,-27,-6,0,1,1
10,18,-8,0,1,1
3,-5,8,1,1,0
36,40,-4,0,1,1
-11,-1,-10,0,1,1
-45,-31,-14,0,1,1
-14,-16,2,1,1,0
-10,-7,-3,0,0,0
16,24,-8,0,0,0
39,40,-1,0,0,0
-21,-14,-7,0,0,0
-37,-23,-14,0,0,0
55,39,16,1,0,1
-42,-32,-10,0,0,0
41,25,16,1,0,1
30,28,2,1,0,1
-7,-19,12,1,0,1
-22,-41,19,1,0,1
-9,10,-19,0,1,1
-4,6,-10,0,1,1
38,39,-1,0,1,1
-9,-29,20,1,1,0
-43,-37,-6,0,1,1
-5,9,-14,0,1,1
-34,-38,4,1,1,0
-11,2,-13,0,1,1
-11,-1,-10,0,1,1
-25,-14,-11,0,1,1
-36,-18,-18,0,1,1
9,-1,10,1,1,0
-22,-36,14,1,1,0
-7,-4,-3,0,1,1
11,-8,19,1,1,0
2,1,1,1,0,1
36,40,-4,0,0,0
49,30,19,1,0,1
-55,-43,-12,0,0,0
-50,-45,-5,0,0,0
37,40,-3,0,0,0
-6,3,-9,0,0,0
46,28,18,1,0,1
53,38,15,1,0,1
20,18,2,1,0,1
0,-19,19,1,0,1
-20,-15,-5,0,0,0
0,-9,9,1,0,1
-44,-44,0,0,0,0
14,29,-15,0,0,0
38,35,3,1,0,1
8,10,-2,0,0,0
-12,-29,17,1,1,0
13,-3,16,1,1,0
34,26,8,1,1,0
-32,-34,2,1,1,0
-6,-16,10,1,1,0
-28,-23,-5,0,1,1
20,24,-4,0,1,1
14,15,-1,0,1,1
-20,-3,-17,0,1,1
-46,-38,-8,0,1,1
-2,-22,20,1,1,0
-18,-24,6,1,1,0
-10,-1,-9,0,0,0
23,24,-1,0,0,0
24,19,5,1,0,1
-21,-10,-11,0,0,0
51,43,8,1,0,1
12,-3,15,1,0,1
-8,-9,1,1,0,1
-11,-1,-10,0,0,0
29,42,-13,0,0,0
8,16,-8,0,1,1
-54,-41,-13,0,1,1
24,9,15,1,1,0
40,42,-2,0,1,1
-27,-44,17,1,1,0
-1,4,-5,0,1,1
42,28,14,1,1,0
28,25,3,1,1,0
32,38,-6,0,1,1
7,12,-5,0,1,1
-28,-42,14,1,0,1
21,39,-18,0,0,0
1,-3,4,1,0,1
0,10,-10,0,0,0
-26,-26,0,0,0,0
10,-9,19,1,0,1
14,33,-19,0,0,0
-36,-30,-6,0,0,0
-21,-29,8,1,0,1
-10,7,-17,0,0,0
30,33,-3,0,0,0
60,40,20,1,0,1
-11,-23,12,1,1,0
47,31,16,1,1,0
-32,-13,-19,0,1,1
-16,-12,-4,0,1,1
21,28,-7,0,1,1
-4,3,-7,0,1,1
-39,-42,3,1,1,0
-50,-42,-8,0,1,1
-46,-42,-4,0,1,1
8,12,-4,0,1,1
4,10,-6,0,1,1
-36,-45,9,1,1,0
21,31,-10,0,1,1
28,36,-8,0,1,1
34,37,-3,0,1,1
-38,-20,-18,0,0,0
3,-17,20,1,0,1
-9,-19,10,1,0,1
-51,-40,-11,0,0,0
-58,-39,-19,0,0,0
41,24,17,1,0,1
-16,-36,20,1,0,1
57,38,19,1,0,1
20,7,13,1,0,1
8,26,-18,0,0,0
-25,-43,18,1,1,0
-24,-27,3,1,1,0
-28,-41,13,1,1,0
-7,7,-14,0,1,1
-15,-13,-2,0,1,1
-22,-33,11,1,1,0
7,-13,20,1,1,0
-15,-6,-9,0,1,1
-16,-22,6,1,1,0
0,-10,10,1,1,0
-38,-38,0,0,1,1
-41,-36,-5,0,1,1
-47,-32,-15,0,1,1
27,36,-9,0,1,1
26,19,7,1,1,0
-22,-24,2,1,1,0
-37,-43,6,1,1,0
-33,-19,-14,0,1,1
33,28,5,1,1,0
-28,-14,-14,0,1,1
-26,-39,13,1,1,0
-20,-8,-12,0,0,0
-41,-22,-19,0,0,0
23,25,-2,0,0,0
-20,-9,-11,0,0,0
8,24,-16,0,0,0
21,10,11,1,0,1
7,10,-3,0,0,0
-24,-17,-7,0,0,0
-23,-21,-2,0,0,0
38,35,3,1,0,1
26,29,-3,0,0,0
-45,-40,-5,0,0,0
12,5,7,1,1,0
27,24,3,1,1,0
15,18,-3,0,1,1
-54,-44,-10,0,1,1
9,24,-15,0,1,1
34,42,-8,0,1,1
31,44,-13,0,1,1
7,-2,9,1,1,0
12,16,-4,0,1,1
38,28,10,1,1,0
-7,1,-8,0,1,1
-23,-27,4,1,1,0
-16,-16,0,0,1,1
-23,-24,1,1,1,0
-39,-28,-11,0,1,1
0,9,-9,0,1,1
-31,-35,4,1,1,0
28,36,-8,0,1,1
28,42,-14,0,1,1
-13,-18,5,1,1,0
-16,-4,-12,0,1,1
36,22,14,1,0,1
-10,-9,-1,0,0,0
-53,-38,-15,0,0,0
-39,-30,-9,0,0,0
7,16,-9,0,0,0
17,9,8,1,0,1
35,44,-9,0,0,0
24,25,-1,0,0,0
16,4,12,1,1,0
44,39,5,1,1,0
-19,-37,18,1,1,0
-4,3,-7,0,1,1
4,-2,6,1,1,0
28,34,-6,0,1,1
22,3,19,1,1,0
-17,-11,-6,0,1,1
32,22,10,1,1,0
-43,-40,-3,0,1,1
-12,-12,0,0,1,1
9,27,-18,0,1,1
-15,-15,0,0,1,1
-10,-28,18,1,1,0
43,37,6,1,1,0
18,17,1,1,1,0
-46,-39,-7,0,0,0
-16,-17,1,1,0,1
-39,-28,-11,0,0,0
22,36,-14,0,0,0
-20,-18,-2,0,0,0
21,12,9,1,0,1
-14,2,-16,0,0,0
-30,-18,-12,0,0,0
-16,-15,-1,0,0,0
49,33,16,1,0,1
40,26,14,1,1,0
-10,-13,3,1,1,0
4,-6,10,1,1,0
-7,5,-12,0,1,1
50,32,18,1,1,0
-38,-40,2,1,1,0
-4,-17,13,1,1,0
-18,-22,4,1,1,0
-18,-17,-1,0,1,1
29,38,-9,0,0,0
43,23,20,1,0,1
17,36,-19,0,0,0
-24,-18,-6,0,0,0
37,36,1,1,0,1
27,34,-7,0,0,0
28,17,11,1,0,1
-7,-13,6,1,0,1
30,38,-8,0,0,0
-17,-33,16,1,0,1
13,26,-13,0,0,0
13,13,0,0,0,0
-21,-6,-15,0,0,0
-10,-25,15,1,0,1
4,5,-1,0,0,0
8,26,-18,0,0,0
-6,-11,5,1,1,0
-29,-39,10,1,1,0
1,9,-8,0,1,1
32,17,15,1,1,0
50,32,18,1,1,0
22,7,15,1,1,0
19,23,-4,0,1,1
42,25,17,1,1,0
29,20,9,1,1,0
-38,-32,-6,0,1,1
10,-9,19,1,1,0
1,-11,12,1,1,0
29,14,15,1,1,0
0,12,-12,0,1,1
-23,-7,-16,0,1,1
-11,-7,-4,0,1,1
-25,-25,0,0,1,1
-1,-6,5,1,1,0
27,28,-1,0,1,1
-40,-39,-1,0,1,1
-14,-16,2,1,1,0
28,11,17,1,0,1
7,1,6,1,0,1
-32,-34,2,1,0,1
51,33,18,1,0,1
-4,-17,13,1,0,1
-23,-11,-12,0,0,0
-9,-29,20,1,0,1
-12,0,-12,0,0,0
-20,-6,-14,0,1,1
48,38,10,1,1,0
-18,-22,4,1,1,0
42,37,5,1,1,0
2,20,-18,0,1,1
-23,-40,17,1,1,0
6,8,-2,0,1,1
14,16,-2,0,1,1
22,20,2,1,1,0
-3,-6,3,1,1,0
-30,-30,0,0,1,1
-14,-11,-3,0,1,1
41,40,1,1,1,0
6,-6,12,1,1,0
-3,-9,6,1,0,1
44,41,3,1,0,1
29,11,18,1,0,1
7,-11,18,1,0,1
24,25,-1,0,0,0
-30,-22,-8,0,0,0
-29,-18,-11,0,0,0
0,-5,5,1,0,1
-31,-19,-12,0,0,0
-13,1,-14,0,0,0
-18,-13,-5,0,0,0
26,22,4,1,0,1
-36,-44,8,1,0,1
-29,-10,-19,0,0,0
37,44,-7,0,0,0
-48,-28,-20,0,0,0
-11,-31,20,1,0,1
37,40,-3,0,0,0
42,23,19,1,0,1
-5,-19,14,1,0,1
-3,-12,9,1,0,1
36,26,10,1,1,0
-30,-33,3,1,1,0
-30,-25,-5,0,1,1
27,8,19,1,1,0
-5,9,-14,0,1,1
30,31,-1,0,1,1
-6,-14,8,1,1,0
15,-1,16,1,1,0
30,44,-14,0,1,1
27,32,-5,0,1,1
-38,-21,-17,0,1,1
23,20,3,1,1,0
5,21,-16,0,1,1
-4,-3,-1,0,1,1
-2,11,-13,0,1,1
24,24,0,0,1,1
4,1,3,1,1,0
-39,-22,-17,0,0,0
-6,-10,4,1,0,1
-3,11,-14,0,0,0
-6,-14,8,1,0,1
-27,-17,-10,0,0,0
-11,-14,3,1,0,1
-18,-9,-9,0,0,0
25,42,-17,0,0,0
19,17,2,1,0,1
-49,-43,-6,0,0,0
47,39,8,1,0,1
-31,-38,7,1,0,1
34,14,20,1,1,0
1,2,-1,0,1,1
-7,-10,3,1,1,0
7,-9,16,1,1,0
25,33,-8,0,1,1
50,44,6,1,1,0
52,38,14,1,1,0
0,12,-12,0,1,1
-38,-21,-17,0,1,1
-14,-6,-8,0,1,1
20,0,20,1,1,0
-50,-30,-20,0,1,1
-16,-36,20,1,1,0
20,33,-13,0,1,1
-18,0,-18,0,1,1
30,32,-2,0,1,1
40,39,1,1,0,1
46,34,12,1,0,1
-39,-26,-13,0,0,0
-37,-20,-17,0,0,0
-53,-39,-14,0,0,0
22,10,12,1,0,1
-8,9,-17,0,0,0
42,33,9,1,0,1
-27,-25,-2,0,0,0
15,17,-2,0,0,0
15,5,10,1,0,1
14,9,5,1,0,1
-34,-36,2,1,0,1
20,38,-18,0,0,0
1,5,-4,0,0,0
17,19,-2,0,1,1
-31,-34,3,1,1,0
33,42,-9,0,1,1
14,28,-14,0,1,1
21,21,0,0,1,1
53,33,20,1,1,0
-11,4,-15,0,1,1
53,34,19,1,1,0
-12,-5,-7,0,1,1
29,24,5,1,1,0
-43,-36,-7,0,1,1
-21,-16,-5,0,1,1
-34,-20,-14,0,1,1
52,33,19,1,0,1
23,9,14,1,0,1
-49,-34,-15,0,0,0
-43,-25,-18,0,0,0
-52,-33,-19,0,0,0
-36,-29,-7,0,0,0
38,19,19,1,0,1
-27,-31,4,1,0,1
-21,-29,8,1,0,1
2,-17,19,1,0,1
-1,17,-18,0,0,0
2,19,-17,0,0,0
-27,-40,13,1,0,1
-17,-22,5,1,0,1
41,31,10,1,1,0
57,43,14,1,1,0
-14,-16,2,1,1,0
36,38,-2,0,1,1
-45,-31,-14,0,1,1
-34,-38,4,1,1,0
24,11,13,1,1,0
20,18,2,1,1,0
27,31,-4,0,1,1
23,17,6,1,1,0
27,21,6,1,1,0
-24,-28,4,1,1,0
-39,-26,-13,0,0,0
22,6,16,1,0,1
49,36,13,1,0,1
-37,-38,1,1,0,1
-11,-26,15,1,0,1
16,21,-5,0,0,0
-6,4,-10,0,0,0
4,11,-7,0,0,0
14,23,-9,0,1,1
8,-9,17,1,1,0
26,25,1,1,1,0
-39,-38,-1,0,1,1
-36,-42,6,1,1,0
-26,-23,-3,0,1,1
7,-11,18,1,1,0
-6,-16,10,1,1,0
16,24,-8,0,1,1
18,1,17,1,1,0
12,7,5,1,1,0
32,14,18,1,1,0
41,21,20,1,1,0
-25,-22,-3,0,0,0
13,3,10,1,0,1
-22,-13,-9,0,0,0
-5,8,-13,0,0,0
28,35,-7,0,0,0
-3,-13,10,1,0,1
-4,10,-14,0,0,0
-29,-14,-15,0,0,0
29,35,-6,0,0,0
2,2,0,0,0,0
-36,-19,-17,0,0,0
-20,-34,14,1,0,1
35,27,8,1,0,1
-11,-4,-7,0,0,0
-13,-8,-5,0,0,0
2,5,-3,0,0,0
12,16,-4,0,0,0
25,29,-4,0,0,0
37,37,0,0,0,0
-23,-39,16,1,0,1
21,13,8,1,0,1
21,14,7,1,1,0
17,11,6,1,1,0
27,38,-11,0,1,1
30,23,7,1,1,0
-10,-9,-1,0,1,1
-18,-10,-8,0,1,1
-26,-29,3,1,1,0
15,5,10,1,1,0
-12,-22,10,1,1,0
-44,-34,-10,0,1,1
1,-15,16,1,1,0
-27,-22,-5,0,1,1
-33,-40,7,1,0,1
3,19,-16,0,0,0
-19,-25,6,1,0,1
-35,-22,-13,0,0,0
-47,-32,-15,0,0,0
0,11,-11,0,0,0
-44,-42,-2,0,0,0
-14,-12,-2,0,0,0
28,32,-4,0,0,0
-36,-21,-15,0,0,0
-17,-35,18,1,0,1
-47,-42,-5,0,0,0
-5,3,-8,0,0,0
0,18,-18,0,1,1
13,9,4,1,1,0
-12,6,-18,0,1,1
-21,-5,-16,0,1,1
21,40,-19,0,1,1
46,28,18,1,1,0
29,23,6,1,1,0
-12,-31,19,1,1,0
-4,8,-12,0,1,1
-39,-33,-6,0,1,1
30,25,5,1,1,0
-49,-38,-11,0,1,1
-20,-15,-5,0,1,1
43,44,-1,0,1,1
47,38,9,1,1,0
4,0,4,1,1,0
1,-4,5,1,1,0
22,2,20,1,0,1
-27,-45,18,1,0,1
18,26,-8,0,0,0
-48,-45,-3,0,0,0
9,19,-10,0,0,0
-17,-19,2,1,0,1
27,18,9,1,0,1
25,41,-16,0,0,0
-4,-13,9,1,0,1
7,9,-2,0,0,0
-6,-23,17,1,0,1
11,2,9,1,0,1
25,22,3,1,0,1
20,13,7,1,1,0
-21,-19,-2,0,1,1
-17,-16,-1,0,1,1
23,40,-17,0,1,1
9,25,-16,0,1,1
2,21,-19,0,1,1
25,28,-3,0,1,1
3,-13,16,1,1,0
-8,-5,-3,0,1,1
-35,-41,6,1,1,0
-17,1,-18,0,1,1
39,35,4,1,1,0
-10,-23,13,1,1,0
23,20,3,1,1,0
60,40,20,1,1,0
-53,-39,-14,0,1,1
23,17,6,1,1,0
-28,-41,13,1,1,0
-32,-29,-3,0,1,1
25,30,-5,0,1,1
9,15,-6,0,1,1
42,40,2,1,0,1
-20,-14,-6,0,0,0
-55,-40,-15,0,0,0
9,28,-19,0,0,0
-16,-33,17,1,0,1
38,34,4,1,0,1
32,19,13,1,0,1
12,-5,17,1,0,1
-13,-30,17,1,0,1
-27,-27,0,0,0,0
31,38,-7,0,0,0
34,15,19,1,0,1
-16,4,-20,0,0,0
-49,-37,-12,0,0,0
-26,-10,-16,0,0,0
-41,-30,-11,0,0,0
6,16,-10,0,0,0
4,-8,12,1,0,1
19,11,8,1,0,1
29,37,-8,0,0,0
-18,-38,20,1,0,1
-25,-20,-5,0,1,1
-27,-21,-6,0,1,1
-58,-41,-17,0,1,1
-27,-7,-20,0,1,1
-8,3,-11,0,1,1
-11,-6,-5,0,1,1
24,12,12,1,1,0
-2,-19,17,1,1,0
-11,-24,13,1,1,0
-1,-7,6,1,0,1
-22,-41,19,1,0,1
-49,-29,-20,0,0,0
-2,1,-3,0,0,0
2,20,-18,0,0,0
31,23,8,1,0,1
-11,-3,-8,0,0,0
41,44,-3,0,0,0
17,17,0,0,0,0
2,9,-7,0,0,0
-11,-15,4,1,0,1
0,-15,15,1,1,0
8,7,1,1,1,0
11,-2,13,1,1,0
-37,-17,-20,0,1,1
-42,-40,-2,0,1,1
37,28,9,1,1,0
35,16,19,1,1,0
35,42,-7,0,1,1
24,7,17,1,1,0
22,22,0,0,1,1
-54,-38,-16,0,1,1
21,10,11,1,1,0
28,22,6,1,1,0
13,16,-3,0,1,1
-42,-42,0,0,1,1
3,14,-11,0,1,1
10,-4,14,1,0,1
49,42,7,1,0,1
22,26,-4,0,0,0
-9,-7,-2,0,0,0
-27,-42,15,1,0,1
56,36,20,1,0,1
-14,-4,-10,0,0,0
-14,5,-19,0,0,0
-26,-42,16,1,0,1
26,22,4,1,0,1
5,-12,17,1,0,1
6,-1,7,1,0,1
-16,-9,-7,0,0,0
-3,15,-18,0,0,0
-35,-37,2,1,0,1
19,14,5,1,0,1
34,38,-4,0,1,1
-21,-16,-5,0,1,1
26,32,-6,0,1,1
3,10,-7,0,1,1
3,-14,17,1,1,0
15,0,15,1,1,0
30,41,-11,0,1,1
-45,-34,-11,0,1,1
-9,-20,11,1,1,0
-3,-23,20,1,1,0
-38,-34,-4,0,1,1
-34,-23,-11,0,1,1
-10,-25,15,1,0,1
-15,4,-19,0,0,0
-46,-26,-20,0,0,0
-19,-2,-17,0,0,0
-29,-33,4,1,0,1
3,20,-17,0,0,0
-21,-16,-5,0,0,0
54,40,14,1,0,1
12,5,7,1,0,1
4,3,1,1,0,1
-28,-26,-2,0,0,0
36,29,7,1,0,1
-46,-39,-7,0,0,0
23,19,4,1,1,0
21,6,15,1,1,0
3,7,-4,0,1,1
26,7,19,1,1,0
44,26,18,1,1,0
4,17,-13,0,1,1
-19,-35,16,1,1,0
-31,-22,-9,0,1,1
23,8,15,1,1,0
-38,-42,4,1,1,0
0,7,-7,0,1,1
-28,-13,-15,0,1,1
20,11,9,1,1,0
24,9,15,1,1,0
13,27,-14,0,1,1
9,-7,16,1,0,1
-16,0,-16,0,0,0
46,39,7,1,0,1
20,37,-17,0,0,0
-2,3,-5,0,0,0
-25,-31,6,1,0,1
-25,-17,-8,0,0,0
8,-10,18,1,0,1
36,27,9,1,0,1
-22,-7,-15,0,0,0
-39,-41,2,1,0,1
44,24,20,1,0,1
-23,-10,-13,0,0,0
25,24,1,1,0,1
7,4,3,1,0,1
31,29,2,1,0,1
-42,-27,-15,0,0,0
5,-5,10,1,1,0
-13,-18,5,1,1,0
-13,-15,2,1,1,0
43,24,19,1,1,0
-12,6,-18,0,1,1
27,33,-6,0,1,1
-10,-4,-6,0,1,1
25,35,-10,0,1,1
-14,-30,16,1,1,0
24,37,-13,0,1,1
35,16,19,1,1,0
52,44,8,1,1,0
-16,-29,13,1,1,0
-58,-38,-20,0,1,1
15,2,13,1,1,0
-36,-33,-3,0,1,1
17,35,-18,0,1,1
27,11,16,1,1,0
-16,-23,7,1,1,0
3,-9,12,1,1,0
-16,-3,-13,0,1,1
-9,-17,8,1,0,1
-38,-34,-4,0,0,0
2,7,-5,0,0,0
20,32,-12,0,0,0
11,9,2,1,0,1
-13,4,-17,0,0,0
-21,-36,15,1,0,1
-13,4,-17,0,0,0
-59,-45,-14,0,0,0
25,14,11,1,0,1
-10,-25,15,1,0,1
13,6,7,1,0,1
-10,-15,5,1,0,1
-16,-35,19,1,0,1
34,25,9,1,0,1
11,19,-8,0,0,0
-18,-36,18,1,0,1
22,24,-2,0,0,0
28,40,-12,0,0,0
50,35,15,1,0,1
-17,-8,-9,0,0,0
20,20,0,0,1,1
0,-10,10,1,1,0
-30,-30,0,0,1,1
-28,-14,-14,0,1,1
9,26,-17,0,1,1
-4,-5,1,1,1,0
-43,-24,-19,0,1,1
-17,-9,-8,0,1,1
10,27,-17,0,1,1
21,8,13,1,1,0
50,37,13,1,1,0
11,7,4,1,1,0
-28,-23,-5,0,1,1
11,-3,14,1,1,0
-40,-24,-16,0,0,0
-41,-45,4,1,0,1
6,26,-20,0,0,0
-14,-30,16,1,0,1
-13,-5,-8,0,0,0
-15,5,-20,0,0,0
25,42,-17,0,0,0
8,25,-17,0,0,0
-15,4,-19,0,0,0
18,17,1,1,0,1
-44,-33,-11,0,0,0
30,43,-13,0,1,1
-27,-27,0,0,1,1
14,7,7,1,1,0
10,25,-15,0,1,1
-24,-6,-18,0,1,1
-5,0,-5,0,1,1
-28,-36,8,1,1,0
35,19,16,1,1,0
-53,-43,-10,0,1,1
32,38,-6,0,1,1
-35,-23,-12,0,1,1
8,14,-6,0,1,1
31,38,-7,0,1,1
26,14,12,1,1,0
-42,-23,-19,0,1,1
30,39,-9,0,1,1
64,44,20,1,1,0
-14,-5,-9,0,1,1
-47,-39,-8,0,1,1
-7,9,-16,0,1,1
-49,-40,-9,0,1,1
2,-4,6,1,0,1
33,36,-3,0,0,0
-18,-3,-15,0,0,0
11,16,-5,0,0,0
31,25,6,1,0,1
31,33,-2,0,0,0
9,10,-1,0,0,0
-33,-13,-20,0,0,0
24,40,-16,0,0,0
-1,17,-18,0,0,0
-10,1,-11,0,0,0
-14,-17,3,1,0,1
10,30,-20,0,0,0
27,42,-15,0,0,0
27,30,-3,0,0,0
0,-1,1,1,0,1
-34,-45,11,1,0,1
-48,-44,-4,0,0,0
32,42,-10,0,0,0
-3,7,-10,0,1,1
-21,-24,3,1,1,0
-54,-34,-20,0,1,1
7,-11,18,1,1,0
-12,-14,2,1,1,0
-58,-43,-15,0,1,1
-44,-32,-12,0,1,1
-13,-14,1,1,1,0
-13,-23,10,1,0,1
-22,-10,-12,0,0,0
-16,-29,13,1,0,1
41,43,-2,0,0,0
-13,3,-16,0,0,0
-30,-17,-13,0,0,0
40,28,12,1,0,1
-3,14,-17,0,0,0
55,37,18,1,0,1
-35,-25,-10,0,0,0
-11,-30,19,1,0,1
26,9,17,1,0,1
-35,-29,-6,0,0,0
-35,-35,0,0,0,0
-34,-21,-13,0,0,0
13,1,12,1,0,1
-29,-16,-13,0,0,0
16,-3,19,1,0,1
44,38,6,1,0,1
-21,-18,-3,0,0,0
57,39,18,1,0,1
-18,-7,-11,0,1,1
38,35,3,1,1,0
13,0,13,1,1,0
-2,14,-16,0,1,1
-25,-9,-16,0,1,1
18,2,16,1,1,0
-32,-13,-19,0,1,1
0,14,-14,0,1,1
-11,-8,-3,0,1,1
5,16,-11,0,1,1
-13,-28,15,1,1,0
20,1,19,1,1,0
14,0,14,1,1,0
-6,-10,4,1,1,0
-48,-28,-20,0,1,1
20,19,1,1,1,0
-48,-38,-10,0,1,1
30,20,10,1,1,0
19,26,-7,0,1,1
-42,-35,-7,0,1,1
23,31,-8,0,1,1
-19,-29,10,1,0,1
-47,-37,-10,0,0,0
16,5,11,1,0,1
-40,-31,-9,0,0,0
-1,-7,6,1,0,1
-58,-45,-13,0,0,0
-15,-26,11,1,0,1
-40,-33,-7,0,0,0
42,32,10,1,0,1
-4,-8,4,1,0,1
-49,-33,-16,0,0,0
-35,-21,-14,0,0,0
52,33,19,1,0,1
5,11,-6,0,0,0
-25,-32,7,1,0,1
-28,-14,-14,0,0,0
-28,-28,0,0,0,0
4,5,-1,0,0,0
23,30,-7,0,0,0
35,34,1,1,0,1
-47,-39,-8,0,0,0
3,17,-14,0,1,1
35,21,14,1,1,0
-22,-14,-8,0,1,1
-18,-32,14,1,1,0
-35,-35,0,0,1,1
-30,-21,-9,0,1,1
-3,-7,4,1,1,0
-2,16,-18,0,1,1
-20,-1,-19,0,0,0
28,26,2,1,0,1
0,-3,3,1,0,1
-28,-19,-9,0,0,0
-1,16,-17,0,0,0
-44,-44,0,0,0,0
45,43,2,1,0,1
23,24,-1,0,0,0
-33,-24,-9,0,0,0
32,22,10,1,0,1
-31,-23,-8,0,0,0
-36,-37,1,1,0,1
-42,-25,-17,0,0,0
-10,-4,-6,0,0,0
-50,-38,-12,0,0,0
0,-9,9,1,0,1
-17,-30,13,1,0,1
-21,-31,10,1,0,1
55,36,19,1,0,1
-17,-7,-10,0,0,0
14,19,-5,0,0,0
-2,-17,15,1,1,0
30,25,5,1,1,0
-50,-33,-17,0,1,1
4,0,4,1,1,0
-22,-37,15,1,1,0
-4,-4,0,0,1,1
-16,-3,-13,0,1,1
14,21,-7,0,1,1
41,29,12,1,1,0
-6,-11,5,1,1,0
59,43,16,1,0,1
-6,-7,1,1,0,1
-1,1,-2,0,0,0
13,7,6,1,0,1
-3,-2,-1,0,0,0
-18,-2,-16,0,0,0
-22,-4,-18,0,0,0
28,11,17,1,0,1
-5,-10,5,1,0,1
18,32,-14,0,0,0
44,25,19,1,0,1
7,5,2,1,0,1
54,42,12,1,1,0
-26,-10,-16,0,1,1
-12,-6,-6,0,1,1
11,1,10,1,1,0
-31,-25,-6,0,1,1
-23,-12,-11,0,1,1
31,20,11,1,1,0
-25,-36,11,1,1,0
10,-4,14,1,1,0
12,11,1,1,1,0
-28,-13,-15,0,1,1
-8,-9,1,1,1,0
10,3,7,1,1,0
-22,-10,-12,0,1,1
-1,0,-1,0,1,1
-21,-8,-13,0,1,1
3,18,-15,0,1,1
13,-5,18,1,1,0
41,41,0,0,1,1
-56,-40,-16,0,1,1
-9,-27,18,1,1,0
46,29,17,1,0,1
-44,-45,1,1,0,1
-39,-23,-16,0,0,0
-16,-26,10,1,0,1
-52,-37,-15,0,0,0
-30,-15,-15,0,0,0
-5,-20,15,1,0,1
-31,-15,-16,0,0,0
35,32,3,1,0,1
-24,-31,7,1,0,1
21,2,19,1,0,1
33,14,19,1,0,1
-45,-25,-20,0,0,0
25,14,11,1,0,1
40,31,9,1,0,1
-47,-40,-7,0,0,0
-14,-3,-11,0,0,0
44,32,12,1,0,1
-24,-9,-15,0,0,0
18,31,-13,0,0,0
39,43,-4,0,0,0
-10,-12,2,1,1,0
-41,-35,-6,0,1,1
4,18,-14,0,1,1
-24,-38,14,1,1,0
5,-1,6,1,1,0
7,-13,20,1,1,0
-54,-42,-12,0,1,1
0,-8,8,1,1,0
36,17,19,1,0,1
19,32,-13,0,0,0
31,30,1,1,0,1
32,39,-7,0,0,0
25,22,3,1,0,1
-16,-34,18,1,0,1
-44,-31,-13,0,0,0
-38,-45,7,1,0,1
3,11,-8,0,0,0
-5,-9,4,1,0,1
37,44,-7,0,0,0
2,11,-9,0,0,0
-55,-42,-13,0,1,1
-19,-16,-3,0,1,1
-32,-33,1,1,1,0
-24,-8,-16,0,1,1
-40,-39,-1,0,1,1
24,25,-1,0,1,1
-45,-25,-20,0,1,1
-9,11,-20,0,1,1
-12,0,-12,0,1,1
-4,-6,2,1,0,1
15,1,14,1,0,1
37,27,10,1,0,1
33,22,11,1,0,1
4,-14,18,1,0,1
35,35,0,0,0,0
-13,6,-19,0,0,0
-5,-19,14,1,0,1
-35,-28,-7,0,0,0
-8,-22,14,1,0,1
-32,-22,-10,0,0,0
-3,14,-17,0,0,0
-8,-8,0,0,0,0
-61,-41,-20,0,1,1
-40,-33,-7,0,1,1
-45,-42,-3,0,1,1
11,-2,13,1,1,0
-14,3,-17,0,1,1
14,21,-7,0,1,1
-17,-32,15,1,1,0
-32,-38,6,1,1,0
-16,-30,14,1,1,0
-9,-13,4,1,1,0
-9,-24,15,1,1,0
20,22,-2,0,1,1
4,23,-19,0,1,1
37,38,-1,0,1,1
23,38,-15,0,1,1
7,-3,10,1,1,0
21,34,-13,0,1,1
-39,-33,-6,0,1,1
43,43,0,0,1,1
46,26,20,1,1,0
-26,-22,-4,0,1,1
35,40,-5,0,0,0
-46,-38,-8,0,0,0
-45,-29,-16,0,0,0
42,36,6,1,0,1
-15,-21,6,1,0,1
-17,-30,13,1,0,1
9,26,-17,0,0,0
38,35,3,1,0,1
6,-14,20,1,0,1
-30,-12,-18,0,0,0
0,-15,15,1,1,0
-14,-9,-5,0,1,1
22,38,-16,0,1,1
25,17,8,1,1,0
21,41,-20,0,1,1
10,-3,13,1,1,0
44,27,17,1,1,0
-6,-22,16,1,1,0
7,20,-13,0,1,1
3,18,-15,0,0,0
59,43,16,1,0,1
37,31,6,1,0,1
-35,-29,-6,0,0,0
-41,-44,3,1,0,1
-60,-42,-18,0,0,0
-29,-26,-3,0,0,0
15,16,-1,0,0,0
16,31,-15,0,0,0
36,31,5,1,0,1
39,37,2,1,0,1
-1,11,-12,0,0,0
-12,-4,-8,0,0,0
-53,-35,-18,0,1,1
-3,-20,17,1,1,0
34,28,6,1,1,0
6,-6,12,1,1,0
36,36,0,0,1,1
39,31,8,1,1,0
24,43,-19,0,1,1
-7,-15,8,1,1,0
15,34,-19,0,1,1
-35,-43,8,1,1,0
16,18,-2,0,1,1
36,22,14,1,1,0
-30,-33,3,1,1,0
-14,-18,4,1,1,0
22,23,-1,0,1,1
-19,-5,-14,0,1,1
-4,-14,10,1,1,0
-39,-21,-18,0,1,1
-30,-43,13,1,1,0
-43,-37,-6,0,1,1
-14,-25,11,1,1,0
11,-1,12,1,0,1
-13,-23,10,1,0,1
59,41,18,1,0,1
-25,-6,-19,0,0,0
-11,-24,13,1,0,1
-20,-8,-12,0,0,0
17,0,17,1,0,1
7,-4,11,1,0,1
-14,-20,6,1,0,1
46,30,16,1,1,0
37,27,10,1,1,0
-32,-38,6,1,1,0
15,24,-9,0,1,1
30,39,-9,0,1,1
4,18,-14,0,1,1
-31,-11,-20,0,1,1
30,28,2,1,1,0
24,9,15,1,1,0
20,4,16,1,1,0
-6,-3,-3,0,1,1
-26,-26,0,0,0,0
11,-1,12,1,0,1
20,25,-5,0,0,0
8,14,-6,0,0,0
33,29,4,1,0,1
34,40,-6,0,0,0
6,-2,8,1,0,1
37,44,-7,0,0,0
21,7,14,1,0,1
-29,-38,9,1,0,1
13,-4,17,1,0,1
-19,-36,17,1,0,1
18,4,14,1,0,1
33,35,-2,0,0,0
-6,9,-15,0,1,1
-39,-29,-10,0,1,1
-43,-32,-11,0,1,1
-9,-13,4,1,1,0
-8,-9,1,1,1,0
13,33,-20,0,1,1
32,17,15,1,1,0
1,12,-11,0,1,1
-26,-15,-11,0,0,0
-33,-39,6,1,0,1
-30,-36,6,1,0,1
-45,-30,-15,0,0,0
2,-7,9,1,0,1
-41,-38,-3,0,0,0
-34,-15,-19,0,0,0
34,35,-1,0,0,0
-60,-45,-15,0,0,0
-46,-43,-3,0,0,0
-18,-11,-7,0,0,0
26,42,-16,0,0,0
38,39,-1,0,0,0
-37,-19,-18,0,0,0
24,38,-14,0,0,0
-25,-34,9,1,0,1
-40,-41,1,1,0,1
0,-3,3,1,0,1
48,40,8,1,0,1
-26,-41,15,1,1,0
-3,-13,10,1,1,0
-1,12,-13,0,1,1
-7,4,-11,0,1,1
-26,-35,9,1,1,0
21,9,12,1,1,0
-53,-36,-17,0,1,1
28,30,-2,0,1,1
-45,-29,-16,0,1,1
-52,-32,-20,0,0,0
5,5,0,0,0,0
1,-17,18,1,0,1
6,17,-11,0,0,0
-5,13,-18,0,0,0
-31,-42,11,1,0,1
-45,-39,-6,0,0,0
-33,-41,8,1,0,1
-33,-22,-11,0,0,0
17,21,-4,0,0,0
-7,-13,6,1,0,1
63,43,20,1,0,1
-23,-4,-19,0,0,0
-54,-37,-17,0,1,1
28,39,-11,0,1,1
-9,7,-16,0,1,1
-39,-28,-11,0,1,1
-5,-1,-4,0,1,1
2,1,1,1,1,0
-57,-41,-16,0,1,1
11,-6,17,1,1,0
-19,0,-19,0,1,1
14,-3,17,1,0,1
-2,-15,13,1,0,1
-21,-16,-5,0,0,0
20,10,10,1,0,1
11,12,-1,0,0,0
16,27,-11,0,0,0
-22,-31,9,1,0,1
-1,3,-4,0,0,0
-16,-6,-10,0,0,0
11,0,11,1,0,1
-4,3,-7,0,0,0
28,44,-16,0,0,0
-59,-45,-14,0,0,0
-45,-44,-1,0,1,1
-9,-3,-6,0,1,1
-32,-37,5,1,1,0
23,17,6,1,1,0
-41,-32,-9,0,1,1
43,34,9,1,1,0
-14,-32,18,1,1,0
1,-1,2,1,1,0
-19,0,-19,0,1,1
-10,-24,14,1,1,0
19,15,4,1,1,0
-9,-14,5,1,1,0
-33,-42,9,1,1,0
19,10,9,1,0,1
-40,-30,-10,0,0,0
44,25,19,1,0,1
30,10,20,1,0,1
-5,9,-14,0,0,0
-45,-25,-20,0,0,0
-6,-16,10,1,0,1
-45,-40,-5,0,0,0
8,22,-14,0,0,0
0,-2,2,1,0,1
0,-19,19,1,0,1
-27,-29,2,1,0,1
44,32,12,1,0,1
-25,-17,-8,0,0,0
4,15,-11,0,0,0
-38,-45,7,1,0,1
38,41,-3,0,0,0
32,27,5,1,0,1
-6,7,-13,0,0,0
2,9,-7,0,0,0
-19,-24,5,1,1,0
-3,-15,12,1,1,0
-47,-42,-5,0,1,1
-12,-31,19,1,1,0
30,20,10,1,1,0
22,19,3,1,1,0
25,38,-13,0,1,1
21,20,1,1,1,0
-16,-7,-9,0,1,1
-51,-35,-16,0,1,1
-15,3,-18,0,1,1
24,23,1,1,1,0
4,-1,5,1,1,0
-30,-15,-15,0,1,1
35,42,-7,0,1,1
-1,16,-17,0,1,1
-36,-40,4,1,1,0
-14,-1,-13,0,1,1
35,42,-7,0,1,1
8,0,8,1,1,0
-13,-3,-10,0,1,1
-14,-17,3,1,0,1
32,42,-10,0,0,0
32,20,12,1,0,1
-30,-40,10,1,0,1
-3,4,-7,0,0,0
17,32,-15,0,0,0
39,37,2,1,0,1
-53,-36,-17,0,0,0
-30,-34,4,1,0,1
-5,-19,14,1,0,1
-32,-28,-4,0,0,0
-2,-18,16,1,0,1
-18,-22,4,1,0,1
35,15,20,1,1,0
12,3,9,1,1,0
-27,-43,16,1,1,0
-29,-18,-11,0,1,1
-16,-13,-3,0,1,1
31,13,18,1,1,0
16,3,13,1,1,0
-46,-41,-5,0,1,1
2,20,-18,0,1,1
4,14,-10,0,1,1
27,27,0,0,1,1
50,34,16,1,1,0
-51,-37,-14,0,1,1
-30,-16,-14,0,1,1
-23,-17,-6,0,1,1
-17,-8,-9,0,1,1
18,2,16,1,1,0
-6,-15,9,1,1,0
-6,-17,11,1,1,0
39,28,11,1,1,0
-26,-27,1,1,1,0
39,39,0,0,0,0
14,-2,16,1,0,1
16,32,-16,0,0,0
17,29,-12,0,0,0
27,31,-4,0,0,0
35,42,-7,0,0,0
35,17,18,1,0,1
-21,-13,-8,0,0,0
-2,-15,13,1,0,1
29,14,15,1,0,1
-6,10,-16,0,1,1
-24,-21,-3,0,1,1
58,43,15,1,1,0
-41,-42,1,1,1,0
-6,-12,6,1,1,0
-15,-14,-1,0,1,1
-28,-41,13,1,1,0
-15,-26,11,1,1,0
-32,-19,-13,0,0,0
4,-3,7,1,0,1
-8,-17,9,1,0,1
-4,-12,8,1,0,1
44,41,3,1,0,1
14,16,-2,0,0,0
9,4,5,1,0,1
27,39,-12,0,0,0
41,32,9,1,0,1
-56,-42,-14,0,0,0
-25,-37,12,1,0,1
30,27,3,1,0,1
-51,-38,-13,0,0,0
26,44,-18,0,1,1
3,-17,20,1,1,0
0,8,-8,0,1,1
-33,-35,2,1,1,0
-20,-8,-12,0,1,1
25,34,-9,0,1,1
24,22,2,1,1,0
36,25,11,1,1,0
-37,-25,-12,0,1,1
-7,2,-9,0,1,1
53,33,20,1,1,0
29,26,3,1,1,0
-30,-25,-5,0,1,1
-14,-10,-4,0,1,1
-27,-40,13,1,1,0
-18,-33,15,1,1,0
0,-12,12,1,1,0
-7,6,-13,0,1,1
-13,-17,4,1,1,0
8,-10,18,1,1,0
-27,-21,-6,0,1,1
-42,-45,3,1,0,1
40,31,9,1,0,1
-42,-41,-1,0,0,0
-29,-38,9,1,0,1
2,-13,15,1,0,1
37,20,17,1,0,1
32,18,14,1,0,1
0,-11,11,1,0,1
4,-7,11,1,0,1
20,8,12,1,0,1
17,16,1,1,0,1
-1,-3,2,1,0,1
23,31,-8,0,0,0
-31,-27,-4,0,0,0
-49,-35,-14,0,0,0
6,3,3,1,0,1
-30,-23,-7,0,0,0
-37,-21,-16,0,0,0
-46,-31,-15,0,0,0
22,35,-13,0,0,0
2,18,-16,0,0,0
30,35,-5,0,1,1
-7,4,-11,0,1,1
24,11,13,1,1,0
-2,1,-3,0,1,1
26,29,-3,0,1,1
-2,14,-16,0,1,1
-47,-32,-15,0,1,1
-34,-30,-4,0,1,1
27,13,14,1,1,0
38,32,6,1,1,0
-11,1,-12,0,1,1
-43,-31,-12,0,1,1
31,11,20,1,1,0
-24,-9,-15,0,0,0
-24,-44,20,1,0,1
19,19,0,0,0,0
-27,-39,12,1,0,1
-10,-6,-4,0,0,0
4,-4,8,1,0,1
-3,-17,14,1,0,1
47,41,6,1,0,1
38,31,7,1,0,1
-28,-23,-5,0,0,0
17,25,-8,0,0,0
30,20,10,1,0,1
29,26,3,1,0,1
-32,-31,-1,0,0,0
13,-3,16,1,0,1
34,41,-7,0,0,0
-32,-34,2,1,0,1
-24,-31,7,1,0,1
0,15,-15,0,0,0
-24,-19,-5,0,1,1
-31,-14,-17,0,1,1
40,28,12,1,1,0
18,34,-16,0,1,1
-8,-8,0,0,1,1
-47,-44,-3,0,1,1
-18,-30,12,1,1,0
-7,2,-9,0,1,1
-37,-19,-18,0,0,0
-53,-42,-11,0,0,0
53,33,20,1,0,1
-8,-14,6,1,0,1
-10,-2,-8,0,0,0
10,11,-1,0,0,0
-38,-38,0,0,0,0
1,-18,19,1,0,1
-18,-12,-6,0,0,0
5,-13,18,1,0,1
-17,-25,8,1,0,1
-2,3,-5,0,0,0
-10,-27,17,1,0,1
-4,1,-5,0,0,0
-17,-21,4,1,0,1
34,32,2,1,0,1
-20,-21,1,1,0,1
-44,-44,0,0,0,0
24,10,14,1,0,1
4,9,-5,0,0,0
-60,-43,-17,0,0,0
-21,-14,-7,0,1,1
34,30,4,1,1,0
11,14,-3,0,1,1
-40,-32,-8,0,1,1
6,0,6,1,1,0
19,25,-6,0,1,1
15,4,11,1,1,0
-45,-32,-13,0,1,1
-29,-45,16,1,1,0
-24,-21,-3,0,1,1
-24,-9,-15,0,1,1
48,43,5,1,0,1
12,20,-8,0,0,0
52,32,20,1,0,1
47,37,10,1,0,1
-38,-29,-9,0,0,0
-37,-45,8,1,0,1
20,15,5,1,0,1
-30,-34,4,1,0,1
35,25,10,1,0,1
15,24,-9,0,0,0
-3,8,-11,0,0,0
-29,-26,-3,0,0,0
5,-15,20,1,0,1
25,28,-3,0,0,0
-10,-13,3,1,0,1
49,33,16,1,0,1
30,32,-2,0,0,0
-42,-45,3,1,0,1
18,20,-2,0,0,0
-43,-29,-14,0,0,0
18,-2,20,1,1,0
-4,-10,6,1,1,0
20,7,13,1,1,0
17,23,-6,0,1,1
27,36,-9,0,1,1
1,15,-14,0,1,1
3,16,-13,0,1,1
31,33,-2,0,1,1
13,8,5,1,1,0
12,32,-20,0,1,1
63,44,19,1,1,0
6,-2,8,1,1,0
-9,-14,5,1,1,0
9,7,2,1,1,0
43,40,3,1,1,0
33,32,1,1,1,0
-48,-39,-9,0,1,1
17,32,-15,0,1,1
13,-1,14,1,1,0
8,-7,15,1,1,0
13,-1,14,1,1,0
-4,-3,-1,0,0,0
10,-4,14,1,0,1
9,18,-9,0,0,0
-13,0,-13,0,0,0
2,17,-15,0,0,0
5,-10,15,1,0,1
-23,-30,7,1,0,1
28,39,-11,0,0,0
-16,-10,-6,0,0,0
17,12,5,1,0,1
20,40,-20,0,1,1
-8,-28,20,1,1,0
47,40,7,1,1,0
45,30,15,1,1,0
-36,-28,-8,0,1,1
18,25,-7,0,1,1
39,42,-3,0,1,1
43,39,4,1,1,0
-29,-19,-10,0,1,1
27,30,-3,0,1,1
25,14,11,1,1,0
26,34,-8,0,1,1
11,17,-6,0,1,1
58,44,14,1,1,0
11,-4,15,1,1,0
12,-4,16,1,1,0
-14,-19,5,1,1,0
12,10,2,1,1,0
40,31,9,1,1,0
-36,-31,-5,0,1,1
-26,-22,-4,0,1,1
44,28,16,1,0,1
-34,-14,-20,0,0,0
27,12,15,1,0,1
-36,-16,-20,0,0,0
26,19,7,1,0,1
-11,-17,6,1,0,1
22,27,-5,0,0,0
33,40,-7,0,0,0
15,16,-1,0,1,1
-26,-31,5,1,1,0
-55,-35,-20,0,1,1
-25,-16,-9,0,1,1
-23,-39,16,1,1,0
-47,-30,-17,0,1,1
-2,-3,1,1,1,0
1,15,-14,0,1,1
0,7,-7,0,1,1
-23,-35,12,1,1,0
27,18,9,1,1,0
-9,-27,18,1,0,1
-42,-28,-14,0,0,0
-26,-22,-4,0,0,0
29,31,-2,0,0,0
-1,-19,18,1,0,1
-41,-35,-6,0,0,0
28,42,-14,0,0,0
-15,3,-18,0,0,0
5,-14,19,1,0,1
21,31,-10,0,0,0
36,39,-3,0,0,0
8,11,-3,0,0,0
-41,-33,-8,0,1,1
45,40,5,1,1,0
12,22,-10,0,1,1
43,38,5,1,1,0
28,8,20,1,1,0
29,27,2,1,1,0
25,23,2,1,1,0
-37,-22,-15,0,1,1
36,34,2,1,1,0
30,35,-5,0,1,1
-17,-20,3,1,0,1
15,22,-7,0,0,0
-1,1,-2,0,0,0
-28,-18,-10,0,0,0
-3,7,-10,0,0,0
-31,-45,14,1,0,1
24,44,-20,0,0,0
56,38,18,1,0,1
43,39,4,1,0,1
-20,-31,11,1,0,1
-46,-36,-10,0,0,0
-32,-29,-3,0,0,0
5,2,3,1,0,1
-29,-39,10,1,0,1
-16,-16,0,0,0,0
-5,0,-5,0,0,0
-14,-28,14,1,0,1
53,43,10,1,0,1
17,27,-10,0,0,0
-6,-23,17,1,0,1
0,-7,7,1,0,1
61,43,18,1,1,0
-28,-32,4,1,1,0
31,18,13,1,1,0
26,20,6,1,1,0
-21,-24,3,1,1,0
7,4,3,1,1,0
-6,-19,13,1,1,0
-34,-27,-7,0,1,1
21,32,-11,0,1,1
-44,-33,-11,0,1,1
14,16,-2,0,0,0
-35,-21,-14,0,0,0
-3,-2,-1,0,0,0
37,28,9,1,0,1
-20,-2,-18,0,0,0
-51,-37,-14,0,0,0
11,10,1,1,0,1
24,9,15,1,0,1
9,-2,11,1,0,1
-25,-24,-1,0,0,0
46,38,8,1,0,1
-26,-11,-15,0,0,0
22,28,-6,0,0,0
-35,-39,4,1,0,1
31,22,9,1,0,1
-59,-39,-20,0,0,0
-2,4,-6,0,0,0
-9,1,-10,0,0,0
41,42,-1,0,0,0
-20,-18,-2,0,0,0
48,43,5,1,0,1
-20,-25,5,1,1,0
23,11,12,1,1,0
13,10,3,1,1,0
15,1,14,1,1,0
39,21,18,1,1,0
24,17,7,1,1,0
-23,-11,-12,0,1,1
-27,-16,-11,0,1,1
-11,-27,16,1,1,0
62,44,18,1,1,0
-18,-6,-12,0,1,1
-56,-38,-18,0,1,1
24,19,5,1,1,0
3,-13,16,1,0,1
-14,-7,-7,0,0,0
-13,3,-16,0,0,0
30,41,-11,0,0,0
-5,-16,11,1,0,1
-24,-13,-11,0,0,0
-55,-44,-11,0,0,0
28,21,7,1,0,1
-56,-45,-11,0,0,0
12,11,1,1,0,1
-32,-25,-7,0,0,0
5,18,-13,0,0,0
11,-5,16,1,0,1
6,-9,15,1,0,1
-6,13,-19,0,0,0
-29,-33,4,1,0,1
30,32,-2,0,0,0
41,33,8,1,0,1
37,18,19,1,0,1
-35,-25,-10,0,0,0
32,34,-2,0,0,0
-42,-30,-12,0,1,1
-18,1,-19,0,1,1
-44,-24,-20,0,1,1
-10,-3,-7,0,1,1
8,22,-14,0,1,1
-5,-10,5,1,1,0
20,36,-16,0,1,1
51,37,14,1,1,0
-17,-8,-9,0,1,1
31,28,3,1,1,0
37,30,7,1,1,0
-10,-1,-9,0,1,1
35,15,20,1,1,0
26,38,-12,0,1,1
50,31,19,1,1,0
11,-7,18,1,1,0
5,-10,15,1,1,0
-30,-22,-8,0,1,1
17,36,-19,0,1,1
-1,-9,8,1,1,0
-17,-35,18,1,1,0
14,11,3,1,0,1
30,11,19,1,0,1
-13,-19,6,1,0,1
45,38,7,1,0,1
26,44,-18,0,0,0
7,0,7,1,0,1
6,15,-9,0,0,0
-23,-3,-20,0,0,0
2,16,-14,0,1,1
-43,-39,-4,0,1,1
1,-10,11,1,1,0
-33,-41,8,1,1,0
-2,18,-20,0,1,1
39,37,2,1,1,0
-16,-36,20,1,1,0
-30,-27,-3,0,1,1
-15,-15,0,0,1,1
-20,-22,2,1,1,0
26,20,6,1,1,0
-9,-8,-1,0,1,1
-26,-15,-11,0,1,1
44,29,15,1,1,0
10,6,4,1,0,1
-57,-43,-14,0,0,0
0,13,-13,0,0,0
-38,-33,-5,0,0,0
32,41,-9,0,0,0
-32,-18,-14,0,0,0
-32,-19,-13,0,0,0
36,29,7,1,0,1
-19,-15,-4,0,0,0
-26,-40,14,1,0,1
45,25,20,1,0,1
34,27,7,1,0,1
-10,-9,-1,0,0,0
28,20,8,1,0,1
-38,-19,-19,0,0,0
9,-11,20,1,0,1
20,25,-5,0,0,0
3,2,1,1,0,1
-8,-23,15,1,0,1
-46,-38,-8,0,0,0
24,34,-10,0,0,0
43,32,11,1,1,0
55,37,18,1,1,0
24,38,-14,0,1,1
11,19,-8,0,1,1
-23,-8,-15,0,1,1
1,-19,20,1,1,0
19,12,7,1,1,0
0,13,-13,0,1,1
40,34,6,1,1,0
10,10,0,0,1,1
-10,-27,17,1,1,0
-33,-26,-7,0,1,1
17,36,-19,0,1,1
-37,-31,-6,0,0,0
-10,-16,6,1,0,1
-30,-17,-13,0,0,0
-18,-20,2,1,0,1
19,3,16,1,0,1
22,7,15,1,0,1
-39,-45,6,1,0,1
19,18,1,1,0,1
-16,-35,19,1,0,1
10,2,8,1,0,1
4,0,4,1,0,1
4,-11,15,1,0,1
-17,-20,3,1,0,1
-19,-27,8,1,0,1
36,22,14,1,0,1
-34,-36,2,1,0,1
-6,-26,20,1,0,1
-24,-30,6,1,0,1
-23,-5,-18,0,0,0
-37,-30,-7,0,0,0
19,-1,20,1,0,1
-12,-26,14,1,1,0
-16,-8,-8,0,1,1
7,-7,14,1,1,0
-25,-33,8,1,1,0
-15,-20,5,1,1,0
12,5,7,1,1,0
-31,-33,2,1,1,0
3,12,-9,0,1,1
-51,-31,-20,0,1,1
16,2,14,1,1,0
38,41,-3,0,1,1
-35,-35,0,0,1,1
27,30,-3,0,0,0
26,39,-13,0,0,0
-4,-23,19,1,0,1
-8,4,-12,0,0,0
38,27,11,1,0,1
35,43,-8,0,0,0
-15,-2,-13,0,0,0
-45,-39,-6,0,0,0
26,38,-12,0,0,0
-40,-44,4,1,0,1
-20,-24,4,1,0,1
-31,-23,-8,0,0,0
-32,-42,10,1,0,1
-12,-18,6,1,0,1
12,27,-15,0,0,0
3,12,-9,0,0,0
20,36,-16,0,0,0
28,12,16,1,0,1
-6,-25,19,1,0,1
38,41,-3,0,0,0
-15,-22,7,1,0,1
-22,-10,-12,0,1,1
52,39,13,1,1,0
-25,-45,20,1,1,0
-20,-40,20,1,1,0
19,4,15,1,1,0
40,29,11,1,1,0
-27,-14,-13,0,1,1
20,6,14,1,1,0
-15,-32,17,1,1,0
-9,-22,13,1,1,0
-1,-14,13,1,1,0
-3,2,-5,0,1,1
-21,-22,1,1,1,0
-2,-11,9,1,1,0
-34,-23,-11,0,1,1
-26,-33,7,1,1,0
22,12,10,1,1,0
-15,-33,18,1,1,0
10,10,0,0,0,0
53,38,15,1,0,1
28,21,7,1,0,1
52,39,13,1,0,1
-28,-18,-10,0,0,0
-29,-45,16,1,0,1
43,39,4,1,0,1
20,25,-5,0,0,0
-37,-23,-14,0,0,0
-19,-25,6,1,0,1
19,-1,20,1,0,1
10,26,-16,0,0,0
19,39,-20,0,0,0
34,21,13,1,0,1
-14,-25,11,1,0,1
13,5,8,1,0,1
1,2,-1,0,0,0
3,-6,9,1,0,1
9,0,9,1,0,1
47,30,17,1,0,1
27,9,18,1,0,1
31,42,-11,0,1,1
-46,-34,-12,0,1,1
-24,-14,-10,0,1,1
-17,-28,11,1,1,0
33,35,-2,0,1,1
3,-6,9,1,1,0
-26,-7,-19,0,1,1
1,11,-10,0,1,1
-33,-44,11,1,1,0
-43,-34,-9,0,1,1
-29,-39,10,1,1,0
8,-5,13,1,1,0
-28,-29,1,1,1,0
49,37,12,1,1,0
-27,-35,8,1,1,0
-63,-45,-18,0,1,1
-33,-20,-13,0,1,1
6,-10,16,1,1,0
-1,8,-9,0,0,0
4,2,2,1,0,1
14,2,12,1,0,1
41,22,19,1,0,1
51,38,13,1,0,1
34,23,11,1,0,1
9,20,-11,0,0,0
-51,-32,-19,0,0,0
1,2,-1,0,0,0
-11,-13,2,1,0,1
8,3,5,1,0,1
-45,-43,-2,0,0,0
46,27,19,1,0,1
-43,-29,-14,0,0,0
7,25,-18,0,0,0
42,27,15,1,0,1
5,1,4,1,0,1
45,34,11,1,0,1
27,13,14,1,0,1
25,8,17,1,0,1
15,4,11,1,0,1
-35,-37,2,1,1,0
-17,-2,-15,0,1,1
-30,-22,-8,0,1,1
54,43,11,1,1,0
-22,-18,-4,0,1,1
-47,-36,-11,0,1,1
29,14,15,1,1,0
10,25,-15,0,1,1
-34,-35,1,1,1,0
62,43,19,1,1,0
-27,-39,12,1,0,1
-3,2,-5,0,0,0
-3,-5,2,1,0,1
-30,-37,7,1,0,1
39,35,4,1,0,1
29,17,12,1,0,1
0,5,-5,0,0,0
24,12,12,1,0,1
-40,-43,3,1,0,1
30,21,9,1,0,1
-26,-38,12,1,0,1
0,18,-18,0,0,0
17,4,13,1,0,1
-23,-21,-2,0,0,0
-10,-22,12,1,0,1
12,11,1,1,0,1
-20,-16,-4,0,0,0
56,43,13,1,0,1
-2,12,-14,0,0,0
-6,-17,11,1,0,1
25,9,16,1,0,1
31,11,20,1,1,0
-55,-43,-12,0,1,1
3,-12,15,1,1,0
-30,-28,-2,0,1,1
55,41,14,1,1,0
22,37,-15,0,1,1
13,22,-9,0,1,1
5,10,-5,0,1,1
-40,-26,-14,0,1,1
-1,2,-3,0,1,1
-6,-3,-3,0,1,1
-16,3,-19,0,1,1
-26,-20,-6,0,1,1
-51,-39,-12,0,1,1
16,8,8,1,1,0
30,14,16,1,1,0
21,12,9,1,1,0
6,-1,7,1,0,1
1,9,-8,0,0,0
17,28,-11,0,0,0
-10,-6,-4,0,0,0
48,39,9,1,0,1
12,19,-7,0,0,0
31,27,4,1,0,1
-22,-10,-12,0,0,0
26,8,18,1,0,1
-17,-2,-15,0,0,0
6,-13,19,1,0,1
23,34,-11,0,0,0
-26,-12,-14,0,0,0
-1,13,-14,0,0,0
-18,-9,-9,0,0,0
7,15,-8,0,1,1
-44,-39,-5,0,1,1
9,-4,13,1,1,0
33,35,-2,0,1,1
28,29,-1,0,1,1
-22,-7,-15,0,1,1
-42,-28,-14,0,1,1
33,29,4,1,1,0
24,44,-20,0,1,1
37,18,19,1,1,0
16,27,-11,0,0,0
26,19,7,1,0,1
-35,-15,-20,0,0,0
38,31,7,1,0,1
-12,-15,3,1,0,1
-32,-24,-8,0,0,0
5,-1,6,1,0,1
25,25,0,0,0,0
-19,-11,-8,0,0,0
22,34,-12,0,0,0
-36,-17,-19,0,0,0
21,25,-4,0,0,0
14,-4,18,1,0,1
24,37,-13,0,0,0
-55,-45,-10,0,0,0
1,20,-19,0,0,0
9,-9,18,1,1,0
9,14,-5,0,1,1
-34,-33,-1,0,1,1
-21,-28,7,1,1,0
17,-1,18,1,1,0
-42,-40,-2,0,1,1
-18,1,-19,0,1,1
16,-2,18,1,1,0
-8,-22,14,1,1,0
-12,-11,-1,0,1,1
-19,-10,-9,0,1,1
-30,-44,14,1,1,0
-32,-41,9,1,1,0
6,1,5,1,1,0
22,32,-10,0,1,1
39,40,-1,0,1,1
-4,3,-7,0,0,0
43,25,18,1,0,1
-27,-43,16,1,0,1
26,34,-8,0,0,0
-30,-17,-13,0,0,0
-35,-19,-16,0,0,0
-51,-42,-9,0,0,0
6,11,-5,0,0,0
-26,-23,-3,0,0,0
57,42,15,1,0,1
9,18,-9,0,0,0
7,-10,17,1,0,1
-2,13,-15,0,1,1
51,33,18,1,1,0
-31,-39,8,1,1,0
50,34,16,1,1,0
-41,-27,-14,0,1,1
21,3,18,1,1,0
-35,-45,10,1,1,0
44,34,10,1,1,0
21,13,8,1,1,0
35,33,2,1,1,0
21,16,5,1,1,0
-22,-19,-3,0,1,1
42,28,14,1,1,0
38,18,20,1,1,0
-43,-33,-10,0,1,1
-21,-20,-1,0,1,1
25,15,10,1,1,0
2,21,-19,0,0,0
-52,-40,-12,0,0,0
-2,0,-2,0,0,0
43,29,14,1,0,1
-24,-23,-1,0,0,0
16,11,5,1,0,1
-9,-3,-6,0,0,0
-44,-42,-2,0,0,0
-26,-43,17,1,0,1
4,-6,10,1,1,0
10,-3,13,1,1,0
14,13,1,1,1,0
13,1,12,1,1,0
-28,-31,3,1,1,0
25,40,-15,0,1,1
38,43,-5,0,1,1
43,26,17,1,1,0
-25,-15,-10,0,1,1
1,-8,9,1,1,0
8,19,-11,0,1,1
41,36,5,1,1,0
-4,13,-17,0,1,1
-4,13,-17,0,0,0
-1,-16,15,1,0,1
-2,-3,1,1,0,1
-6,-6,0,0,0,0
-47,-38,-9,0,0,0
-2,-14,12,1,0,1
-28,-14,-14,0,0,0
34,17,17,1,0,1
-18,-4,-14,0,0,0
-28,-25,-3,0,0,0
-56,-36,-20,0,0,0
-16,-36,20,1,0,1
-28,-9,-19,0,0,0
-51,-42,-9,0,0,0
-45,-27,-18,0,1,1
-27,-45,18,1,1,0
8,-6,14,1,1,0
-4,-7,3,1,1,0
-29,-11,-18,0,1,1
-10,-20,10,1,1,0
46,28,18,1,1,0
-38,-40,2,1,1,0
20,16,4,1,1,0
54,40,14,1,1,0
8,19,-11,0,0,0
-39,-43,4,1,0,1
24,28,-4,0,0,0
30,10,20,1,0,1
22,27,-5,0,0,0
15,12,3,1,0,1
-6,-4,-2,0,0,0
20,8,12,1,0,1
18,12,6,1,0,1
26,14,12,1,0,1
-19,-22,3,1,0,1
31,40,-9,0,0,0
-4,-5,1,1,1,0
55,39,16,1,1,0
-25,-28,3,1,1,0
8,26,-18,0,1,1
51,32,19,1,1,0
13,31,-18,0,1,1
-13,-31,18,1,1,0
22,10,12,1,1,0
19,37,-18,0,1,1
-6,5,-11,0,1,1
26,43,-17,0,1,1
-8,-13,5,1,1,0
-14,-29,15,1,1,0
-6,-21,15,1,1,0
-31,-33,2,1,1,0
32,38,-6,0,1,1
-5,12,-17,0,1,1
30,20,10,1,1,0
7,7,0,0,1,1
16,-3,19,1,0,1
5,-1,6,1,0,1
19,17,2,1,0,1
21,37,-16,0,0,0
-19,-5,-14,0,0,0
-17,-3,-14,0,0,0
-40,-29,-11,0,0,0
35,30,5,1,0,1
-40,-35,-5,0,1,1
27,33,-6,0,1,1
17,32,-15,0,1,1
7,12,-5,0,1,1
39,34,5,1,1,0
48,33,15,1,1,0
34,18,16,1,1,0
52,38,14,1,1,0
13,-4,17,1,1,0
-11,5,-16,0,1,1
20,35,-15,0,1,1
30,19,11,1,1,0
28,9,19,1,1,0
29,42,-13,0,1,1
-29,-29,0,0,1,1
10,-7,17,1,0,1
18,8,10,1,0,1
-16,-2,-14,0,0,0
-13,-14,1,1,0,1
-31,-32,1,1,0,1
38,30,8,1,0,1
-35,-42,7,1,0,1
-55,-38,-17,0,0,0
22,16,6,1,0,1
24,27,-3,0,0,0
45,26,19,1,0,1
-6,-9,3,1,0,1
-7,13,-20,0,0,0
-11,-23,12,1,0,1
-24,-10,-14,0,0,0
-3,9,-12,0,0,0
-24,-24,0,0,0,0
5,15,-10,0,0,0
-10,-17,7,1,0,1
-17,-35,18,1,0,1
15,4,11,1,0,1
-21,-8,-13,0,1,1
14,11,3,1,1,0
36,41,-5,0,1,1
12,2,10,1,1,0
-10,-11,1,1,1,0
-24,-21,-3,0,1,1
25,21,4,1,1,0
-7,11,-18,0,1,1
-10,-19,9,1,1,0
-6,-6,0,0,1,1
-10,-4,-6,0,1,1
-38,-26,-12,0,1,1
11,1,10,1,0,1
-34,-18,-16,0,0,0
-17,-18,1,1,0,1
-23,-7,-16,0,0,0
9,-8,17,1,0,1
3,11,-8,0,0,0
-51,-36,-15,0,0,0
-30,-10,-20,0,0,0
-34,-24,-10,0,0,0
-2,11,-13,0,0,0
-40,-20,-20,0,0,0
26,24,2,1,0,1
-5,-22,17,1,0,1
-40,-38,-2,0,0,0
22,11,11,1,0,1
15,8,7,1,0,1
-38,-25,-13,0,1,1
-7,-8,1,1,1,0
21,24,-3,0,1,1
-22,-21,-1,0,1,1
39,40,-1,0,1,1
17,18,-1,0,1,1
13,14,-1,0,1,1
47,36,11,1,1,0
54,37,17,1,1,0
-14,-1,-13,0,1,1
-48,-42,-6,0,1,1
45,42,3,1,1,0
-29,-19,-10,0,1,1
13,28,-15,0,1,1
41,26,15,1,0,1
12,1,11,1,0,1
8,-4,12,1,0,1
-10,4,-14,0,0,0
24,12,12,1,0,1
11,-2,13,1,0,1
24,42,-18,0,0,0
-33,-22,-11,0,0,0
5,4,1,1,1,0
-13,-6,-7,0,1,1
-51,-37,-14,0,1,1
-25,-44,19,1,1,0
-7,-15,8,1,1,0
19,39,-20,0,1,1
38,22,16,1,1,0
32,14,18,1,1,0
-38,-38,0,0,1,1
16,7,9,1,0,1
-36,-40,4,1,0,1
-9,1,-10,0,0,0
-8,6,-14,0,0,0
20,30,-10,0,0,0
22,36,-14,0,0,0
-17,-13,-4,0,0,0
32,26,6,1,0,1
-37,-39,2,1,0,1
34,43,-9,0,0,0
14,5,9,1,0,1
-34,-44,10,1,0,1
13,6,7,1,0,1
9,25,-16,0,0,0
-35,-26,-9,0,0,0
25,36,-11,0,0,0
-30,-28,-2,0,0,0
7,20,-13,0,0,0
13,16,-3,0,0,0
16,17,-1,0,1,1
1,-5,6,1,1,0
-5,11,-16,0,1,1
-44,-31,-13,0,1,1
40,41,-1,0,1,1
-20,-4,-16,0,1,1
-13,-18,5,1,1,0
-29,-20,-9,0,1,1
-3,15,-18,0,1,1
27,38,-11,0,1,1
26,14,12,1,1,0
32,30,2,1,1,0
29,19,10,1,1,0
22,39,-17,0,1,1
-5,-18,13,1,1,0
-10,-19,9,1,1,0
-7,-27,20,1,1,0
-54,-39,-15,0,1,1
-14,-6,-8,0,0,0
-33,-35,2,1,0,1
34,41,-7,0,0,0
-40,-29,-11,0,0,0
10,-2,12,1,0,1
38,39,-1,0,0,0
0,-15,15,1,0,1
38,19,19,1,0,1
7,-7,14,1,0,1
5,13,-8,0,0,0
49,29,20,1,0,1
47,34,13,1,0,1
-21,-23,2,1,0,1
-27,-24,-3,0,1,1
-22,-3,-19,0,1,1
-12,-31,19,1,1,0
7,-7,14,1,1,0
17,11,6,1,1,0
-36,-35,-1,0,1,1
43,25,18,1,1,0
32,21,11,1,1,0
-40,-41,1,1,1,0
3,6,-3,0,1,1
-11,-9,-2,0,1,1
38,35,3,1,1,0
33,29,4,1,1,0
16,-1,17,1,1,0
-19,-28,9,1,0,1
33,28,5,1,0,1
9,18,-9,0,0,0
38,24,14,1,0,1
7,4,3,1,0,1
-22,-42,20,1,0,1
34,15,19,1,0,1
20,19,1,1,0,1
-18,-1,-17,0,0,0
19,19,0,0,0,0
26,33,-7,0,0,0
-15,-21,6,1,0,1
-1,-1,0,0,0,0
4,4,0,0,0,0
11,23,-12,0,0,0
-21,-3,-18,0,0,0
-24,-24,0,0,0,0
27,43,-16,0,0,0
-37,-42,5,1,0,1
-51,-34,-17,0,0,0
46,33,13,1,0,1
30,30,0,0,1,1
-45,-31,-14,0,1,1
-3,8,-11,0,1,1
48,37,11,1,1,0
23,8,15,1,1,0
-49,-44,-5,0,1,1
-49,-42,-7,0,1,1
13,27,-14,0,1,1
53,39,14,1,1,0
51,43,8,1,1,0
-28,-41,13,1,1,0
-13,-18,5,1,1,0
-36,-25,-11,0,1,1
13,7,6,1,1,0
-54,-41,-13,0,0,0
8,3,5,1,0,1
-5,-25,20,1,0,1
1,-18,19,1,0,1
44,32,12,1,0,1
-41,-29,-12,0,0,0
36,20,16,1,0,1
-6,-1,-5,0,0,0
10,30,-20,0,1,1
-30,-35,5,1,1,0
-10,-29,19,1,1,0
-29,-26,-3,0,1,1
16,35,-19,0,1,1
30,40,-10,0,1,1
4,-9,13,1,1,0
46,29,17,1,1,0
59,39,20,1,1,0
48,44,4,1,1,0
-8,-23,15,1,1,0
34,28,6,1,1,0
-34,-18,-16,0,1,1
-49,-36,-13,0,1,1
-18,-23,5,1,1,0
-12,3,-15,0,1,1
-38,-42,4,1,1,0
-22,-23,1,1,1,0
18,30,-12,0,0,0
-36,-43,7,1,0,1
31,24,7,1,0,1
21,14,7,1,0,1
11,9,2,1,0,1
30,18,12,1,0,1
27,26,1,1,0,1
-6,10,-16,0,0,0
19,29,-10,0,0,0
-22,-3,-19,0,1,1
-9,-4,-5,0,1,1
-30,-45,15,1,1,0
-23,-41,18,1,1,0
32,26,6,1,1,0
-53,-38,-15,0,1,1
9,-3,12,1,1,0
-39,-20,-19,0,1,1
-9,-8,-1,0,1,1
-32,-24,-8,0,1,1
-55,-41,-14,0,1,1
11,25,-14,0,1,1
48,40,8,1,1,0
11,3,8,1,1,0
16,11,5,1,1,0
-4,-20,16,1,1,0
-3,-21,18,1,1,0
6,-1,7,1,1,0
32,25,7,1,1,0
43,29,14,1,1,0
15,34,-19,0,1,1
-6,-21,15,1,0,1
-17,-5,-12,0,0,0
42,28,14,1,0,1
-21,-23,2,1,0,1
51,32,19,1,0,1
37,25,12,1,0,1
-10,-29,19,1,0,1
21,35,-14,0,0,0
3,11,-8,0,0,0
-6,-21,15,1,0,1
-6,9,-15,0,0,0
-50,-39,-11,0,0,0
-23,-24,1,1,0,1
-3,3,-6,0,0,0
36,27,9,1,0,1
25,21,4,1,0,1
-28,-16,-12,0,1,1
37,21,16,1,1,0
-42,-41,-1,0,1,1
-6,-1,-5,0,1,1
23,3,20,1,1,0
-22,-13,-9,0,1,1
-34,-28,-6,0,1,1
-37,-39,2,1,1,0
-23,-11,-12,0,1,1
5,-1,6,1,1,0
19,3,16,1,1,0
8,16,-8,0,0,0
17,2,15,1,0,1
28,11,17,1,0,1
-6,13,-19,0,0,0
-14,-1,-13,0,0,0
-1,-11,10,1,0,1
22,21,1,1,0,1
17,15,2,1,0,1
39,43,-4,0,1,1
22,9,13,1,1,0
43,43,0,0,1,1
8,0,8,1,1,0
-21,-39,18,1,1,0
-17,-18,1,1,1,0
-50,-41,-9,0,1,1
42,35,7,1,1,0
24,26,-2,0,1,1
23,14,9,1,1,0
1,-8,9,1,1,0
-34,-33,-1,0,1,1
-47,-39,-8,0,1,1
-31,-36,5,1,1,0
-52,-44,-8,0,1,1
-21,-38,17,1,1,0
-26,-17,-9,0,0,0
-2,-18,16,1,0,1
-47,-30,-17,0,0,0
-26,-28,2,1,0,1
-2,-6,4,1,0,1
-10,5,-15,0,0,0
13,-6,19,1,0,1
-19,-25,6,1,0,1
-35,-32,-3,0,0,0
-8,-20,12,1,0,1
26,22,4,1,0,1
-51,-42,-9,0,0,0
45,27,18,1,0,1
-24,-28,4,1,0,1
-17,-27,10,1,0,1
3,0,3,1,0,1
20,26,-6,0,0,0
15,19,-4,0,0,0
24,22,2,1,0,1
27,18,9,1,0,1
39,31,8,1,0,1
38,27,11,1,1,0
-5,-21,16,1,1,0
-37,-24,-13,0,1,1
32,35,-3,0,1,1
52,39,13,1,1,0
15,17,-2,0,1,1
-63,-43,-20,0,1,1
0,-4,4,1,1,0
20,6,14,1,1,0
-10,-30,20,1,1,0
-51,-38,-13,0,1,1
8,-2,10,1,1,0
44,29,15,1,1,0
-17,-3,-14,0,1,1
-50,-40,-10,0,1,1
-23,-37,14,1,0,1
-43,-33,-10,0,0,0
52,37,15,1,0,1
51,43,8,1,0,1
-26,-27,1,1,0,1
-18,1,-19,0,0,0
-19,-33,14,1,0,1
-3,9,-12,0,0,0
44,34,10,1,0,1
10,29,-19,0,0,0
7,13,-6,0,0,0
36,20,16,1,0,1
-39,-31,-8,0,0,0
-15,-3,-12,0,0,0
55,38,17,1,0,1
-47,-44,-3,0,0,0
16,21,-5,0,0,0
37,41,-4,0,0,0
47,29,18,1,0,1
-10,-26,16,1,0,1
24,6,18,1,0,1
15,11,4,1,1,0
14,-2,16,1,1,0
-41,-41,0,0,1,1
17,23,-6,0,1,1
38,32,6,1,1,0
-40,-37,-3,0,1,1
-39,-28,-11,0,1,1
-4,1,-5,0,1,1
39,27,12,1,1,0
30,29,1,1,1,0
33,17,16,1,1,0
-25,-22,-3,0,1,1
48,43,5,1,0,1
8,19,-11,0,0,0
-19,-10,-9,0,0,0
1,13,-12,0,0,0
11,5,6,1,0,1
-26,-19,-7,0,0,0
30,21,9,1,0,1
25,11,14,1,0,1
-17,-20,3,1,0,1
-7,-6,-1,0,1,1
19,29,-10,0,1,1
-21,-10,-11,0,1,1
-35,-23,-12,0,1,1
-5,8,-13,0,1,1
50,44,6,1,1,0
-20,-10,-10,0,1,1
-29,-9,-20,0,1,1
-11,-19,8,1,1,0
16,11,5,1,1,0
2,8,-6,0,1,1
39,21,18,1,1,0
29,29,0,0,0,0
11,27,-16,0,0,0
-40,-20,-20,0,0,0
30,24,6,1,0,1
14,33,-19,0,0,0
-49,-38,-11,0,0,0
-44,-35,-9,0,0,0
-27,-12,-15,0,0,0
-42,-26,-16,0,0,0
-18,-14,-4,0,1,1
47,43,4,1,1,0
-37,-37,0,0,1,1
-53,-42,-11,0,1,1
22,41,-19,0,1,1
19,16,3,1,1,0
-52,-37,-15,0,1,1
23,34,-11,0,1,1
14,14,0,0,1,1
35,28,7,1,1,0
21,33,-12,0,1,1
8,20,-12,0,1,1
12,9,3,1,1,0
2,-18,20,1,0,1
29,42,-13,0,0,0
-3,-8,5,1,0,1
12,0,12,1,0,1
36,41,-5,0,0,0
6,4,2,1,0,1
14,34,-20,0,0,0
46,28,18,1,0,1
12,5,7,1,0,1
-31,-32,1,1,0,1
-10,1,-11,0,0,0
-9,-29,20,1,1,0
-5,-7,2,1,1,0
39,24,15,1,1,0
-16,-16,0,0,1,1
-17,-2,-15,0,1,1
-48,-44,-4,0,1,1
-28,-27,-1,0,1,1
52,41,11,1,1,0
27,26,1,1,1,0
-29,-21,-8,0,1,1
-39,-44,5,1,1,0
-4,-9,5,1,1,0
-23,-9,-14,0,0,0
28,31,-3,0,0,0
-21,-1,-20,0,0,0
-13,-17,4,1,0,1
-30,-27,-3,0,0,0
-21,-33,12,1,0,1
-8,-16,8,1,0,1
-31,-14,-17,0,0,0
38,41,-3,0,0,0
-11,-24,13,1,0,1
34,44,-10,0,0,0
39,30,9,1,0,1
60,44,16,1,1,0
-19,-7,-12,0,1,1
-24,-41,17,1,1,0
-26,-7,-19,0,1,1
-36,-24,-12,0,1,1
20,5,15,1,1,0
58,40,18,1,1,0
5,17,-12,0,1,1
38,21,17,1,1,0
35,37,-2,0,1,1
-7,4,-11,0,1,1
-21,-18,-3,0,0,0
-32,-45,13,1,0,1
23,13,10,1,0,1
-21,-19,-2,0,0,0
-32,-33,1,1,0,1
8,8,0,0,0,0
2,-7,9,1,0,1
-26,-27,1,1,0,1
40,26,14,1,0,1
38,41,-3,0,0,0
16,15,1,1,0,1
-27,-33,6,1,1,0
-14,6,-20,0,1,1
-21,-31,10,1,1,0
-10,-30,20,1,1,0
-39,-35,-4,0,1,1
-34,-45,11,1,1,0
8,-7,15,1,1,0
47,30,17,1,1,0
34,35,-1,0,1,1
36,36,0,0,1,1
16,20,-4,0,1,1
3,10,-7,0,1,1
-54,-40,-14,0,1,1
8,8,0,0,1,1
13,6,7,1,1,0
17,20,-3,0,1,1
3,9,-6,0,1,1
17,29,-12,0,1,1
-32,-21,-11,0,1,1
-1,5,-6,0,1,1
55,40,15,1,1,0
1,1,0,0,0,0
47,44,3,1,0,1
53,44,9,1,0,1
-13,-15,2,1,0,1
40,27,13,1,0,1
37,34,3,1,0,1
48,33,15,1,0,1
-38,-40,2,1,0,1
-19,-37,18,1,0,1
3,12,-9,0,0,0
26,6,20,1,0,1
23,24,-1,0,0,0
-58,-40,-18,0,0,0
59,41,18,1,0,1
24,21,3,1,0,1
-11,-19,8,1,0,1
4,-7,11,1,0,1
31,33,-2,0,0,0
-17,-5,-12,0,1,1
-42,-38,-4,0,1,1
-24,-32,8,1,1,0
-12,-32,20,1,1,0
13,2,11,1,1,0
-40,-20,-20,0,1,1
-35,-16,-19,0,1,1
24,11,13,1,1,0
23,19,4,1,0,1
-6,10,-16,0,0,0
16,19,-3,0,0,0
34,37,-3,0,0,0
-26,-26,0,0,0,0
25,43,-18,0,0,0
0,-11,11,1,0,1
34,24,10,1,0,1
12,19,-7,0,0,0
-50,-45,-5,0,0,0
27,43,-16,0,0,0
50,42,8,1,0,1
-11,-10,-1,0,0,0
-9,-20,11,1,0,1
18,25,-7,0,1,1
20,31,-11,0,1,1
25,22,3,1,1,0
39,43,-4,0,1,1
-10,-11,1,1,1,0
0,0,0,0,1,1
11,-6,17,1,1,0
-26,-30,4,1,1,0
33,31,2,1,1,0
-32,-18,-14,0,1,1
-41,-42,1,1,1,0
-10,-3,-7,0,1,1
20,30,-10,0,1,1
-33,-31,-2,0,1,1
-4,-6,2,1,1,0
-2,-1,-1,0,1,1
35,44,-9,0,1,1
-23,-27,4,1,0,1
-23,-43,20,1,0,1
-22,-24,2,1,0,1
-9,3,-12,0,0,0
-12,-20,8,1,0,1
-5,-4,-1,0,0,0
-7,-18,11,1,0,1
-5,-5,0,0,0,0
21,3,18,1,0,1
23,13,10,1,0,1
-40,-27,-13,0,0,0
-25,-33,8,1,0,1
-6,4,-10,0,0,0
-21,-30,9,1,0,1
-2,-20,18,1,1,0
-58,-38,-20,0,1,1
35,24,11,1,1,0
9,9,0,0,1,1
24,5,19,1,1,0
-33,-33,0,0,1,1
-1,-20,19,1,1,0
-38,-36,-2,0,1,1
-1,16,-17,0,1,1
27,12,15,1,1,0
-42,-22,-20,0,1,1
-55,-45,-10,0,1,1
-36,-25,-11,0,0,0
-12,-14,2,1,0,1
36,37,-1,0,0,0
9,24,-15,0,0,0
-18,2,-20,0,0,0
-14,-11,-3,0,0,0
-42,-30,-12,0,0,0
-38,-21,-17,0,0,0
-2,2,-4,0,0,0
-10,-20,10,1,1,0
41,37,4,1,1,0
53,39,14,1,1,0
-8,0,-8,0,1,1
-51,-45,-6,0,1,1
27,42,-15,0,1,1
38,44,-6,0,1,1
-8,6,-14,0,1,1
-47,-43,-4,0,1,1
-14,-32,18,1,1,0
42,30,12,1,1,0
16,10,6,1,0,1
-27,-42,15,1,0,1
-44,-39,-5,0,0,0
16,22,-6,0,0,0
34,20,14,1,0,1
-52,-35,-17,0,0,0
15,18,-3,0,0,0
30,14,16,1,0,1
30,37,-7,0,1,1
-12,-26,14,1,1,0
6,-1,7,1,1,0
-3,-9,6,1,1,0
-4,-22,18,1,1,0
-55,-36,-19,0,1,1
-3,-18,15,1,1,0
-17,1,-18,0,1,1
-40,-40,0,0,1,1
39,20,19,1,1,0
-46,-27,-19,0,1,1
-21,-21,0,0,1,1
4,-8,12,1,1,0
32,28,4,1,1,0
19,24,-5,0,1,1
40,29,11,1,1,0
21,16,5,1,0,1
18,6,12,1,0,1
43,44,-1,0,0,0
49,37,12,1,0,1
-2,17,-19,0,0,0
25,25,0,0,0,0
-26,-34,8,1,0,1
8,4,4,1,0,1
36,24,12,1,0,1
46,33,13,1,0,1
26,43,-17,0,1,1
-41,-35,-6,0,1,1
25,34,-9,0,1,1
-36,-26,-10,0,1,1
-23,-14,-9,0,1,1
-20,-25,5,1,1,0
-42,-24,-18,0,1,1
19,25,-6,0,1,1
33,34,-1,0,1,1
-5,-11,6,1,1,0
-2,9,-11,0,1,1
-48,-35,-13,0,1,1
5,15,-10,0,1,1
15,33,-18,0,1,1
-3,-18,15,1,0,1
52,39,13,1,0,1
46,42,4,1,0,1
40,35,5,1,0,1
-22,-24,2,1,0,1
-31,-45,14,1,0,1
-16,-28,12,1,0,1
-15,-2,-13,0,0,0
32,21,11,1,0,1
15,-1,16,1,0,1
24,11,13,1,0,1
21,32,-11,0,1,1
-4,-14,10,1,1,0
-36,-35,-1,0,1,1
-3,-1,-2,0,1,1
-10,0,-10,0,1,1
-31,-17,-14,0,1,1
-5,7,-12,0,1,1
-8,-25,17,1,1,0
11,30,-19,0,1,1
30,34,-4,0,1,1
43,31,12,1,1,0
23,43,-20,0,1,1
7,-11,18,1,1,0
-51,-36,-15,0,1,1
0,-17,17,1,1,0
-25,-14,-11,0,1,1
-25,-42,17,1,1,0
-23,-35,12,1,1,0
-15,-29,14,1,1,0
17,7,10,1,1,0
10,-2,12,1,1,0
-22,-2,-20,0,0,0
-19,-17,-2,0,0,0
4,-3,7,1,0,1
-42,-25,-17,0,0,0
16,9,7,1,0,1
-2,7,-9,0,0,0
-41,-34,-7,0,0,0
-28,-10,-18,0,0,0
35,26,9,1,0,1
43,29,14,1,0,1
-10,-8,-2,0,0,0
-25,-8,-17,0,0,0
27,11,16,1,0,1
-9,6,-15,0,0,0
-36,-29,-7,0,0,0
-45,-43,-2,0,0,0
-25,-13,-12,0,0,0
-28,-30,2,1,0,1
5,-7,12,1,1,0
16,24,-8,0,1,1
47,32,15,1,1,0
-4,-11,7,1,1,0
60,43,17,1,1,0
3,-9,12,1,1,0
-56,-40,-16,0,1,1
-7,10,-17,0,1,1
28,32,-4,0,1,1
-12,5,-17,0,1,1
-45,-28,-17,0,1,1
8,24,-16,0,1,1
-14,-15,1,1,0,1
58,42,16,1,0,1
35,21,14,1,0,1
1,9,-8,0,0,0
-43,-34,-9,0,0,0
28,41,-13,0,0,0
33,30,3,1,0,1
56,39,17,1,0,1
-38,-44,6,1,0,1
-39,-41,2,1,0,1
-7,-25,18,1,0,1
16,7,9,1,0,1
4,14,-10,0,0,0
18,28,-10,0,0,0
50,43,7,1,0,1
-21,-32,11,1,0,1
-31,-31,0,0,0,0
-43,-26,-17,0,0,0
-47,-33,-14,0,0,0
28,16,12,1,1,0
12,26,-14,0,1,1
0,-5,5,1,1,0
-39,-35,-4,0,1,1
-39,-36,-3,0,1,1
21,21,0,0,1,1
17,14,3,1,1,0
30,20,10,1,1,0
-7,-18,11,1,1,0
5,1,4,1,1,0
13,-3,16,1,0,1
-28,-34,6,1,0,1
25,13,12,1,0,1
15,24,-9,0,0,0
19,18,1,1,0,1
-11,-31,20,1,0,1
36,23,13,1,0,1
2,21,-19,0,0,0
-8,10,-18,0,0,0
-39,-20,-19,0,0,0
-8,-19,11,1,0,1
-35,-17,-18,0,0,0
4,9,-5,0,1,1
21,11,10,1,1,0
6,20,-14,0,1,1
-49,-39,-10,0,1,1
-50,-32,-18,0,1,1
2,5,-3,0,1,1
-8,-4,-4,0,1,1
4,-11,15,1,1,0
-13,-4,-9,0,1,1
-37,-37,0,0,1,1
4,-15,19,1,1,0
-29,-27,-2,0,1,1
9,4,5,1,1,0
-33,-39,6,1,1,0
57,38,19,1,0,1
-23,-9,-14,0,0,0
-56,-40,-16,0,0,0
21,26,-5,0,0,0
12,16,-4,0,0,0
-10,-6,-4,0,0,0
48,36,12,1,0,1
-38,-31,-7,0,0,0
8,6,2,1,1,0
35,33,2,1,1,0
-25,-37,12,1,1,0
-3,-15,12,1,1,0
-13,-12,-1,0,1,1
1,-16,17,1,1,0
-44,-24,-20,0,1,1
-50,-37,-13,0,1,1
2,-17,19,1,1,0
32,24,8,1,1,0
-4,-23,19,1,0,1
22,34,-12,0,0,0
46,26,20,1,0,1
22,14,8,1,0,1
4,22,-18,0,0,0
19,16,3,1,0,1
-34,-27,-7,0,0,0
-1,-17,16,1,0,1
20,21,-1,0,0,0
-32,-14,-18,0,0,0
14,32,-18,0,0,0
33,22,11,1,0,1
11,21,-10,0,0,0
-10,-30,20,1,0,1
27,15,12,1,0,1
-51,-44,-7,0,0,0
49,38,11,1,0,1
-23,-28,5,1,0,1
-37,-27,-10,0,0,0
-13,-7,-6,0,0,0
-33,-26,-7,0,0,0
-40,-44,4,1,1,0
-31,-21,-10,0,1,1
54,43,11,1,1,0
29,19,10,1,1,0
-20,-17,-3,0,1,1
4,24,-20,0,1,1
-41,-23,-18,0,1,1
-46,-38,-8,0,1,1
39,21,18,1,1,0
-3,1,-4,0,0,0
-16,-6,-10,0,0,0
-33,-43,10,1,0,1
-33,-37,4,1,0,1
39,38,1,1,0,1
4,16,-12,0,0,0
-55,-43,-12,0,0,0
-24,-10,-14,0,0,0
-64,-45,-19,0,0,0
56,44,12,1,0,1
-9,-6,-3,0,0,0
-6,-9,3,1,0,1
31,37,-6,0,0,0
-58,-39,-19,0,0,0
3,7,-4,0,0,0
-35,-37,2,1,0,1
-28,-10,-18,0,0,0
49,44,5,1,0,1
20,3,17,1,0,1
22,14,8,1,0,1
-8,11,-19,0,0,0
-37,-33,-4,0,1,1
22,7,15,1,1,0
11,-1,12,1,1,0
-12,-27,15,1,1,0
53,39,14,1,1,0
-37,-35,-2,0,1,1
6,-14,20,1,1,0
18,32,-14,0,1,1
18,1,17,1,1,0
-26,-18,-8,0,1,1
46,36,10,1,1,0
0,-5,5,1,1,0
52,34,18,1,1,0
-16,-5,-11,0,1,1
-17,-12,-5,0,1,1
-36,-27,-9,0,1,1
-15,-7,-8,0,1,1
25,44,-19,0,1,1
-5,-19,14,1,1,0
-9,8,-17,0,1,1
23,4,19,1,1,0
-16,-31,15,1,0,1
22,24,-2,0,0,0
-49,-29,-20,0,0,0
37,23,14,1,0,1
23,25,-2,0,0,0
13,14,-1,0,0,0
-34,-26,-8,0,0,0
-5,-16,11,1,0,1
-43,-36,-7,0,0,0
-2,16,-18,0,0,0
6,-7,13,1,0,1
21,20,1,1,0,1
16,12,4,1,1,0
6,26,-20,0,1,1
12,17,-5,0,1,1
-4,16,-20,0,1,1
18,22,-4,0,1,1
13,24,-11,0,1,1
28,28,0,0,1,1
18,3,15,1,1,0
5,25,-20,0,1,1
-36,-17,-19,0,1,1
-16,-9,-7,0,0,0
-29,-26,-3,0,0,0
-33,-23,-10,0,0,0
-27,-12,-15,0,0,0
-16,-29,13,1,0,1
-12,-1,-11,0,0,0
-43,-31,-12,0,0,0
-2,10,-12,0,0,0
-21,-28,7,1,0,1
25,17,8,1,0,1
-45,-44,-1,0,0,0
37,40,-3,0,0,0
12,21,-9,0,0,0
-14,-20,6,1,0,1
-35,-33,-2,0,0,0
3,-14,17,1,0,1
-7,-15,8,1,0,1
-36,-26,-10,0,0,0
-42,-32,-10,0,0,0
-13,-21,8,1,0,1
-16,-17,1,1,0,1
-25,-21,-4,0,1,1
-37,-25,-12,0,1,1
42,28,14,1,1,0
59,43,16,1,1,0
-6,-2,-4,0,1,1
37,23,14,1,1,0
32,31,1,1,1,0
33,15,18,1,1,0
19,8,11,1,1,0
27,18,9,1,1,0
-25,-15,-10,0,1,1
47,30,17,1,1,0
-9,7,-16,0,1,1
6,18,-12,0,1,1
-12,5,-17,0,1,1
-17,-11,-6,0,1,1
24,29,-5,0,1,1
-15,-12,-3,0,1,1
19,16,3,1,1,0
-52,-32,-20,0,1,1
-11,-22,11,1,1,0
14,22,-8,0,0,0
8,24,-16,0,0,0
-38,-18,-20,0,0,0
-45,-28,-17,0,0,0
17,10,7,1,0,1
-16,-3,-13,0,0,0
45,26,19,1,0,1
37,19,18,1,0,1
-31,-12,-19,0,0,0
-40,-27,-13,0,0,0
61,41,20,1,0,1
-47,-45,-2,0,0,0
-2,-19,17,1,0,1
-24,-35,11,1,0,1
-21,-39,18,1,0,1
6,8,-2,0,0,0
-23,-8,-15,0,0,0
-7,10,-17,0,0,0
7,16,-9,0,1,1
11,13,-2,0,1,1
43,38,5,1,1,0
-30,-18,-12,0,1,1
-21,-25,4,1,1,0
31,37,-6,0,1,1
4,2,2,1,1,0
5,8,-3,0,1,1
17,18,-1,0,0,0
29,37,-8,0,0,0
-34,-21,-13,0,0,0
19,0,19,1,0,1
27,43,-16,0,0,0
-11,-17,6,1,0,1
-28,-44,16,1,0,1
-44,-42,-2,0,0,0
-13,-24,11,1,0,1
11,13,-2,0,0,0
-9,-24,15,1,0,1
-15,-30,15,1,0,1
-36,-45,9,1,0,1
-30,-14,-16,0,0,0
-30,-12,-18,0,0,0
48,42,6,1,0,1
-43,-40,-3,0,0,0
-44,-40,-4,0,0,0
-50,-30,-20,0,0,0
-5,-25,20,1,0,1
20,13,7,1,0,1
21,4,17,1,1,0
19,0,19,1,1,0
8,-6,14,1,1,0
-29,-13,-16,0,1,1
-27,-21,-6,0,1,1
-2,-21,19,1,1,0
13,13,0,0,1,1
-1,-9,8,1,1,0
-28,-12,-16,0,1,1
23,9,14,1,1,0
-12,-26,14,1,1,0
47,33,14,1,1,0
22,22,0,0,1,1
-39,-22,-17,0,1,1
-48,-45,-3,0,0,0
-10,-18,8,1,0,1
-29,-31,2,1,0,1
-36,-17,-19,0,0,0
-18,-22,4,1,0,1
-13,-21,8,1,0,1
10,19,-9,0,0,0
5,-10,15,1,0,1
-40,-34,-6,0,0,0
-9,-26,17,1,0,1
11,20,-9,0,0,0
-31,-31,0,0,0,0
12,26,-14,0,0,0
24,22,2,1,0,1
3,10,-7,0,0,0
8,0,8,1,0,1
19,26,-7,0,0,0
-6,-19,13,1,0,1
45,28,17,1,0,1
-8,-24,16,1,0,1
-59,-41,-18,0,0,0
-19,-36,17,1,1,0
29,19,10,1,1,0
-45,-33,-12,0,1,1
-14,-34,20,1,1,0
-25,-42,17,1,1,0
-13,-6,-7,0,1,1
-1,8,-9,0,1,1
-35,-44,9,1,1,0
-30,-22,-8,0,1,1
3,23,-20,0,1,1
4,-3,7,1,1,0
-19,-18,-1,0,1,1
-23,-43,20,1,1,0
9,-7,16,1,1,0
10,1,9,1,1,0
32,26,6,1,1,0
-42,-30,-12,0,1,1
-15,-25,10,1,1,0
9,11,-2,0,1,1
-13,-5,-8,0,1,1
-35,-36,1,1,1,0
-13,5,-18,0,0,0
19,6,13,1,0,1
6,19,-13,0,0,0
-65,-45,-20,0,0,0
-14,-31,17,1,0,1
-23,-4,-19,0,0,0
36,16,20,1,0,1
38,44,-6,0,0,0
-28,-14,-14,0,1,1
-16,-31,15,1,1,0
1,10,-9,0,1,1
-18,-35,17,1,1,0
-2,6,-8,0,1,1
5,7,-2,0,1,1
-12,-7,-5,0,1,1
4,12,-8,0,1,1
30,42,-12,0,1,1
-11,-17,6,1,1,0
33,36,-3,0,1,1
11,-7,18,1,0,1
20,15,5,1,0,1
11,-8,19,1,0,1
35,31,4,1,0,1
6,22,-16,0,0,0
8,7,1,1,0,1
-34,-41,7,1,0,1
44,27,17,1,0,1
-3,-1,-2,0,0,0
20,1,19,1,0,1
-19,-14,-5,0,0,0
-30,-30,0,0,0,0
-49,-37,-12,0,0,0
-41,-38,-3,0,0,0
-13,-3,-10,0,1,1
-41,-36,-5,0,1,1
-53,-33,-20,0,1,1
-11,-25,14,1,1,0
5,7,-2,0,1,1
-25,-10,-15,0,1,1
33,16,17,1,1,0
40,37,3,1,1,0
-21,-39,18,1,1,0
-14,-21,7,1,1,0
-53,-35,-18,0,1,1
-23,-28,5,1,1,0
8,15,-7,0,1,1
-26,-15,-11,0,1,1
-9,10,-19,0,1,1
-6,-16,10,1,1,0
18,23,-5,0,1,1
44,39,5,1,1,0
-5,0,-5,0,1,1
49,32,17,1,0,1
56,40,16,1,0,1
16,27,-11,0,0,0
-23,-31,8,1,0,1
28,44,-16,0,0,0
26,20,6,1,0,1
24,30,-6,0,0,0
-33,-28,-5,0,0,0
39,42,-3,0,0,0
-18,-16,-2,0,0,0
-37,-39,2,1,0,1
22,31,-9,0,0,0
-45,-33,-12,0,0,0
-21,-39,18,1,0,1
3,8,-5,0,0,0
-35,-20,-15,0,0,0
-9,1,-10,0,0,0
-5,12,-17,0,0,0
30,29,1,1,0,1
-15,5,-20,0,0,0
37,20,17,1,0,1
-26,-29,3,1,1,0
20,32,-12,0,1,1
43,28,15,1,1,0
22,12,10,1,1,0
-26,-26,0,0,1,1
25,40,-15,0,1,1
44,40,4,1,1,0
42,31,11,1,1,0
57,41,16,1,1,0
-42,-35,-7,0,1,1
57,39,18,1,1,0
-25,-19,-6,0,1,1
38,30,8,1,1,0
11,27,-16,0,1,1
-25,-10,-15,0,1,1
1,5,-4,0,1,1
40,35,5,1,1,0
7,-10,17,1,1,0
-19,-34,15,1,0,1
-11,-14,3,1,0,1
63,43,20,1,0,1
25,11,14,1,0,1
2,4,-2,0,0,0
50,32,18,1,0,1
43,32,11,1,0,1
-49,-40,-9,0,0,0
47,44,3,1,0,1
15,16,-1,0,0,0
-11,-22,11,1,1,0
0,-4,4,1,1,0
-36,-19,-17,0,1,1
-3,4,-7,0,1,1
-13,1,-14,0,1,1
-40,-42,2,1,1,0
-14,-29,15,1,1,0
24,27,-3,0,1,1
-2,4,-6,0,1,1
38,42,-4,0,1,1
-2,-12,10,1,1,0
-24,-33,9,1,1,0
-44,-24,-20,0,1,1
-24,-11,-13,0,1,1
-32,-31,-1,0,1,1
50,44,6,1,1,0
2,15,-13,0,1,1
-24,-39,15,1,1,0
-4,-24,20,1,1,0
36,32,4,1,1,0
49,32,17,1,1,0
47,31,16,1,0,1
-46,-45,-1,0,0,0
-14,-9,-5,0,0,0
42,42,0,0,0,0
20,39,-19,0,0,0
5,19,-14,0,0,0
10,18,-8,0,0,0
2,0,2,1,0,1
-48,-30,-18,0,0,0
-53,-35,-18,0,0,0
-13,-10,-3,0,0,0
14,14,0,0,0,0
32,15,17,1,0,1
-51,-41,-10,0,0,0
14,3,11,1,0,1
-5,13,-18,0,1,1
41,39,2,1,1,0
11,6,5,1,1,0
-61,-41,-20,0,1,1
-4,-23,19,1,1,0
22,22,0,0,1,1
-20,-17,-3,0,1,1
-23,-16,-7,0,1,1
10,-5,15,1,1,0
21,34,-13,0,1,1
-37,-39,2,1,1,0
-36,-35,-1,0,1,1
33,39,-6,0,1,1
-30,-35,5,1,1,0
34,15,19,1,1,0
-22,-40,18,1,1,0
-6,-10,4,1,0,1
30,21,9,1,0,1
-48,-30,-18,0,0,0
-21,-28,7,1,0,1
-8,4,-12,0,0,0
43,25,18,1,0,1
22,23,-1,0,0,0
18,26,-8,0,0,0
10,22,-12,0,0,0
6,17,-11,0,0,0
-5,-15,10,1,0,1
-25,-27,2,1,0,1
-52,-43,-9,0,0,0
-9,-7,-2,0,0,0
24,9,15,1,0,1
55,42,13,1,0,1
-26,-39,13,1,0,1
-14,-19,5,1,0,1
35,24,11,1,0,1
25,13,12,1,0,1
-24,-16,-8,0,0,0
2,8,-6,0,1,1
13,23,-10,0,1,1
32,35,-3,0,1,1
-24,-25,1,1,1,0
15,11,4,1,1,0
-3,-6,3,1,1,0
29,28,1,1,1,0
-38,-37,-1,0,1,1
-16,2,-18,0,0,0
24,11,13,1,0,1
-38,-36,-2,0,0,0
8,13,-5,0,0,0
-24,-27,3,1,0,1
19,36,-17,0,0,0
17,29,-12,0,0,0
13,25,-12,0,0,0
-47,-42,-5,0,0,0
18,14,4,1,0,1
6,14,-8,0,0,0
-17,-19,2,1,0,1
-21,-40,19,1,0,1
-4,-14,10,1,0,1
30,18,12,1,0,1
-57,-38,-19,0,0,0
-19,-35,16,1,0,1
-20,-22,2,1,0,1
-3,-1,-2,0,0,0
-33,-26,-7,0,0,0
19,18,1,1,0,1
-24,-4,-20,0,1,1
28,27,1,1,1,0
25,5,20,1,1,0
-37,-40,3,1,1,0
-48,-30,-18,0,1,1
-35,-23,-12,0,1,1
-22,-8,-14,0,1,1
40,20,20,1,1,0
37,21,16,1,1,0
57,44,13,1,1,0
-39,-41,2,1,0,1
19,35,-16,0,0,0
-54,-40,-14,0,0,0
-48,-32,-16,0,0,0
23,40,-17,0,0,0
-14,3,-17,0,0,0
-3,-4,1,1,0,1
0,-16,16,1,0,1
6,10,-4,0,0,0
27,44,-17,0,0,0
-12,4,-16,0,0,0
-7,-24,17,1,0,1
5,-5,10,1,1,0
-1,3,-4,0,1,1
38,40,-2,0,1,1
10,4,6,1,1,0
-9,-8,-1,0,1,1
-37,-36,-1,0,1,1
7,21,-14,0,1,1
-39,-27,-12,0,1,1
32,17,15,1,1,0
0,4,-4,0,1,1
-30,-32,2,1,1,0
-2,6,-8,0,1,1
3,10,-7,0,1,1
-32,-19,-13,0,1,1
13,15,-2,0,1,1
40,44,-4,0,1,1
-17,-26,9,1,1,0
-40,-20,-20,0,1,1
8,27,-19,0,1,1
22,6,16,1,1,0
-30,-42,12,1,1,0
4,4,0,0,0,0
31,30,1,1,0,1
21,27,-6,0,0,0
-46,-44,-2,0,0,0
-10,-13,3,1,0,1
39,41,-2,0,0,0
22,4,18,1,0,1
15,4,11,1,0,1
6,11,-5,0,0,0
-24,-14,-10,0,1,1
34,40,-6,0,1,1
-9,-2,-7,0,1,1
9,-6,15,1,1,0
-31,-27,-4,0,1,1
18,30,-12,0,1,1
-37,-19,-18,0,1,1
48,37,11,1,1,0
26,20,6,1,1,0
-17,-20,3,1,1,0
36,20,16,1,1,0
35,20,15,1,0,1
60,44,16,1,0,1
25,5,20,1,0,1
27,12,15,1,0,1
11,24,-13,0,0,0
-32,-39,7,1,0,1
-6,-8,2,1,0,1
40,29,11,1,0,1
1,-5,6,1,0,1
24,35,-11,0,0,0
-34,-30,-4,0,0,0
16,31,-15,0,0,0
-11,1,-12,0,0,0
-41,-38,-3,0,0,0
20,5,15,1,0,1
-2,-14,12,1,0,1
-43,-43,0,0,0,0
19,18,1,1,0,1
31,36,-5,0,0,0
-35,-32,-3,0,0,0
-19,-25,6,1,0,1
-9,-25,16,1,1,0
51,44,7,1,1,0
-20,-27,7,1,1,0
37,40,-3,0,1,1
-23,-33,10,1,1,0
-27,-45,18,1,1,0
-17,-27,10,1,1,0
12,20,-8,0,1,1
30,32,-2,0,1,1
-21,-35,14,1,1,0
40,39,1,1,1,0
53,39,14,1,1,0
-10,10,-20,0,1,1
-10,10,-20,0,1,1
17,15,2,1,1,0
-27,-18,-9,0,1,1
24,43,-19,0,1,1
12,18,-6,0,0,0
-2,11,-13,0,0,0
-13,-28,15,1,0,1
-19,-5,-14,0,0,0
21,28,-7,0,0,0
-35,-20,-15,0,0,0
-6,-24,18,1,0,1
-17,-33,16,1,0,1
-40,-40,0,0,0,0
-22,-6,-16,0,0,0
-30,-20,-10,0,0,0
37,17,20,1,1,0
44,30,14,1,1,0
17,15,2,1,1,0
29,17,12,1,1,0
-7,-22,15,1,1,0
9,16,-7,0,1,1
17,23,-6,0,1,1
-12,-25,13,1,1,0
28,24,4,1,1,0
-28,-21,-7,0,1,1
-9,-12,3,1,1,0
4,7,-3,0,1,1
43,43,0,0,1,1
-14,-8,-6,0,1,1
-2,-6,4,1,1,0
-44,-40,-4,0,0,0
27,19,8,1,0,1
61,42,19,1,0,1
-8,-28,20,1,0,1
-22,-4,-18,0,0,0
-38,-29,-9,0,0,0
-45,-34,-11,0,0,0
23,41,-18,0,0,0
31,33,-2,0,0,0
-48,-45,-3,0,0,0
60,41,19,1,0,1
29,32,-3,0,0,0
32,14,18,1,0,1
-23,-38,15,1,0,1
-3,-11,8,1,0,1
-6,-20,14,1,0,1
-37,-44,7,1,0,1
2,-4,6,1,0,1
-31,-32,1,1,0,1
-36,-40,4,1,0,1
-21,-3,-18,0,0,0
-26,-40,14,1,1,0
-37,-19,-18,0,1,1
-55,-44,-11,0,1,1
8,2,6,1,1,0
-23,-17,-6,0,1,1
-42,-42,0,0,1,1
-57,-39,-18,0,1,1
6,7,-1,0,1,1
17,10,7,1,1,0
24,28,-4,0,0,0
-16,-7,-9,0,0,0
0,-13,13,1,0,1
58,41,17,1,0,1
18,19,-1,0,0,0
55,44,11,1,0,1
-33,-40,7,1,0,1
17,-1,18,1,0,1
20,9,11,1,0,1
-44,-29,-15,0,1,1
-37,-44,7,1,1,0
-2,-21,19,1,1,0
-29,-40,11,1,1,0
2,9,-7,0,1,1
20,20,0,0,1,1
-49,-40,-9,0,1,1
-32,-13,-19,0,1,1
2,-5,7,1,1,0
-40,-24,-16,0,1,1
37,34,3,1,0,1
-35,-21,-14,0,0,0
-30,-24,-6,0,0,0
-35,-45,10,1,0,1
52,37,15,1,0,1
-15,-18,3,1,0,1
3,8,-5,0,0,0
30,12,18,1,0,1
-47,-33,-14,0,0,0
2,2,0,0,0,0
-1,-12,11,1,0,1
25,5,20,1,0,1
4,-15,19,1,0,1
-26,-38,12,1,1,0
-45,-42,-3,0,1,1
48,34,14,1,1,0
-64,-45,-19,0,1,1
-20,-31,11,1,1,0
-10,-16,6,1,1,0
-10,-28,18,1,1,0
8,-3,11,1,1,0
29,30,-1,0,1,1
-4,-7,3,1,1,0
-42,-34,-8,0,1,1
-3,17,-20,0,1,1
40,43,-3,0,0,0
-11,-24,13,1,0,1
11,-7,18,1,0,1
35,15,20,1,0,1
31,19,12,1,0,1
6,2,4,1,0,1
-36,-23,-13,0,0,0
5,-11,16,1,0,1
-11,-20,9,1,0,1
-4,-20,16,1,0,1
19,19,0,0,0,0
-10,-18,8,1,0,1
36,44,-8,0,0,0
-10,-12,2,1,0,1
-23,-25,2,1,0,1
-14,4,-18,0,0,0
29,28,1,1,0,1
37,17,20,1,0,1
26,25,1,1,1,0
-15,1,-16,0,1,1
-11,-13,2,1,1,0
-19,-7,-12,0,1,1
-36,-43,7,1,1,0
29,35,-6,0,1,1
28,14,14,1,1,0
-28,-31,3,1,1,0
4,-9,13,1,1,0
-27,-13,-14,0,1,1
30,34,-4,0,1,1
44,35,9,1,1,0
-24,-19,-5,0,0,0
25,44,-19,0,0,0
-61,-44,-17,0,0,0
59,40,19,1,0,1
45,40,5,1,0,1
-24,-21,-3,0,0,0
3,-3,6,1,0,1
17,15,2,1,0,1
42,38,4,1,0,1
-28,-40,12,1,0,1
-24,-7,-17,0,0,0
-27,-45,18,1,0,1
-7,-18,11,1,0,1
-11,-28,17,1,0,1
-47,-37,-10,0,0,0
5,-1,6,1,0,1
-34,-20,-14,0,0,0
-6,-4,-2,0,0,0
-16,3,-19,0,0,0
-17,-7,-10,0,0,0
-26,-40,14,1,0,1
-28,-18,-10,0,1,1
-43,-44,1,1,1,0
33,37,-4,0,1,1
2,-17,19,1,1,0
15,1,14,1,1,0
3,-4,7,1,1,0
7,-11,18,1,1,0
-51,-34,-17,0,1,1
-23,-28,5,1,1,0
18,37,-19,0,1,1
10,-6,16,1,1,0
34,42,-8,0,1,1
-28,-36,8,1,0,1
0,-20,20,1,0,1
-22,-10,-12,0,0,0
-11,-15,4,1,0,1
26,26,0,0,0,0
27,35,-8,0,0,0
10,11,-1,0,0,0
12,23,-11,0,0,0
11,20,-9,0,0,0
-3,5,-8,0,0,0
10,-1,11,1,0,1
-28,-10,-18,0,1,1
38,27,11,1,1,0
30,26,4,1,1,0
-9,-7,-2,0,1,1
7,16,-9,0,1,1
25,18,7,1,1,0
-28,-23,-5,0,1,1
-8,-1,-7,0,1,1
19,4,15,1,1,0
49,32,17,1,1,0
24,27,-3,0,1,1
-36,-42,6,1,1,0
30,40,-10,0,1,1
41,43,-2,0,1,1
19,13,6,1,1,0
42,30,12,1,1,0
24,12,12,1,1,0
35,26,9,1,1,0
29,11,18,1,0,1
-31,-34,3,1,0,1
24,21,3,1,0,1
0,-11,11,1,0,1
-56,-44,-12,0,0,0
-22,-22,0,0,0,0
-14,-8,-6,0,0,0
-31,-20,-11,0,0,0
42,42,0,0,0,0
24,39,-15,0,0,0
-35,-39,4,1,0,1
-7,-20,13,1,0,1
-14,-29,15,1,0,1
-12,-3,-9,0,0,0
44,43,1,1,1,0
-47,-31,-16,0,1,1
-16,-23,7,1,1,0
-23,-10,-13,0,1,1
26,34,-8,0,1,1
19,19,0,0,1,1
-42,-30,-12,0,1,1
46,41,5,1,1,0
12,21,-9,0,1,1
-3,3,-6,0,1,1
8,19,-11,0,1,1
-34,-17,-17,0,1,1
-13,4,-17,0,1,1
4,-5,9,1,1,0
-34,-33,-1,0,1,1
0,15,-15,0,1,1
20,15,5,1,1,0
-34,-15,-19,0,1,1
3,-15,18,1,1,0
-23,-38,15,1,0,1
18,-1,19,1,0,1
25,28,-3,0,0,0
-5,-21,16,1,0,1
4,18,-14,0,0,0
-27,-25,-2,0,0,0
-21,-37,16,1,0,1
-25,-32,7,1,0,1
-32,-26,-6,0,0,0
57,41,16,1,0,1
54,44,10,1,0,1
-11,-24,13,1,0,1
-7,-15,8,1,0,1
43,43,0,0,0,0
28,15,13,1,0,1
12,25,-13,0,0,0
-25,-16,-9,0,0,0
13,23,-10,0,0,0
-21,-9,-12,0,0,0
21,27,-6,0,0,0
40,23,17,1,0,1
-22,-28,6,1,1,0
-26,-26,0,0,1,1
31,28,3,1,1,0
49,32,17,1,1,0
-20,-1,-19,0,1,1
-21,-18,-3,0,1,1
13,30,-17,0,1,1
54,41,13,1,1,0
10,23,-13,0,1,1
20,24,-4,0,1,1
6,-10,16,1,0,1
4,10,-6,0,0,0
-57,-45,-12,0,0,0
-33,-45,12,1,0,1
-1,4,-5,0,0,0
-32,-31,-1,0,0,0
-13,-12,-1,0,0,0
2,2,0,0,0,0
-22,-24,2,1,0,1
-33,-30,-3,0,0,0
-21,-29,8,1,0,1
-11,-20,9,1,0,1
-5,1,-6,0,0,0
-28,-17,-11,0,0,0
-26,-7,-19,0,0,0
-20,-38,18,1,0,1
20,2,18,1,0,1
12,18,-6,0,0,0
24,29,-5,0,0,0
-38,-18,-20,0,0,0
-28,-22,-6,0,0,0
17,21,-4,0,1,1
19,34,-15,0,1,1
40,21,19,1,1,0
-19,-12,-7,0,1,1
-21,-41,20,1,1,0
28,13,15,1,1,0
-11,-10,-1,0,1,1
-36,-21,-15,0,1,1
4,22,-18,0,1,1
-28,-23,-5,0,1,1
13,28,-15,0,1,1
2,11,-9,0,1,1
-10,-4,-6,0,1,1
52,34,18,1,1,0
15,-5,20,1,1,0
-5,-12,7,1,0,1
-7,-12,5,1,0,1
41,25,16,1,0,1
-33,-18,-15,0,0,0
25,44,-19,0,0,0
-29,-26,-3,0,0,0
-10,-7,-3,0,0,0
-23,-21,-2,0,0,0
25,44,-19,0,0,0
15,2,13,1,0,1
4,16,-12,0,0,0
8,1,7,1,0,1
-45,-44,-1,0,0,0
-20,-5,-15,0,0,0
29,12,17,1,1,0
-41,-34,-7,0,1,1
-18,-22,4,1,1,0
20,6,14,1,1,0
18,27,-9,0,1,1
6,-14,20,1,1,0
19,29,-10,0,1,1
-12,-10,-2,0,1,1
53,39,14,1,1,0
-29,-40,11,1,1,0
29,17,12,1,1,0
18,32,-14,0,0,0
-2,16,-18,0,0,0
29,25,4,1,0,1
-33,-20,-13,0,0,0
-34,-21,-13,0,0,0
5,8,-3,0,0,0
16,35,-19,0,0,0
-48,-44,-4,0,0,0
-26,-7,-19,0,0,0
-5,6,-11,0,1,1
8,3,5,1,1,0
-5,-16,11,1,1,0
-22,-18,-4,0,1,1
-18,-8,-10,0,1,1
-18,-33,15,1,1,0
-15,-14,-1,0,1,1
-7,-27,20,1,1,0
-44,-38,-6,0,1,1
3,15,-12,0,1,1
31,44,-13,0,1,1
-20,-23,3,1,1,0
28,40,-12,0,1,1
31,14,17,1,1,0
29,39,-10,0,1,1
-33,-15,-18,0,1,1
-13,5,-18,0,1,1
5,-1,6,1,1,0
6,16,-10,0,1,1
-24,-15,-9,0,1,1
54,38,16,1,1,0
-3,8,-11,0,0,0
-54,-43,-11,0,0,0
0,2,-2,0,0,0
-6,-2,-4,0,0,0
-4,-10,6,1,0,1
3,9,-6,0,0,0
-19,-29,10,1,0,1
-36,-18,-18,0,0,0
-41,-41,0,0,0,0
-46,-45,-1,0,0,0
-2,-22,20,1,0,1
28,21,7,1,0,1
-16,3,-19,0,0,0
22,11,11,1,0,1
-10,-6,-4,0,1,1
-8,10,-18,0,1,1
-44,-34,-10,0,1,1
-4,-16,12,1,1,0
-14,-7,-7,0,1,1
-21,-21,0,0,1,1
17,21,-4,0,1,1
6,11,-5,0,1,1
15,25,-10,0,1,1
19,2,17,1,1,0
-5,-16,11,1,1,0
-2,-13,11,1,1,0
21,36,-15,0,1,1
-37,-45,8,1,0,1
-7,-26,19,1,0,1
-4,-15,11,1,0,1
25,35,-10,0,0,0
-28,-8,-20,0,0,0
32,32,0,0,0,0
-45,-44,-1,0,0,0
1,-13,14,1,0,1
-53,-38,-15,0,0,0
-43,-27,-16,0,0,0
1,15,-14,0,0,0
11,13,-2,0,0,0
-41,-44,3,1,1,0
6,25,-19,0,1,1
5,8,-3,0,1,1
-26,-40,14,1,1,0
-1,-5,4,1,1,0
32,22,10,1,1,0
-26,-12,-14,0,1,1
-36,-45,9,1,1,0
16,2,14,1,1,0
-10,7,-17,0,1,1
6,-11,17,1,1,0
-35,-32,-3,0,1,1
-36,-37,1,1,1,0
22,35,-13,0,1,1
20,30,-10,0,1,1
8,-5,13,1,1,0
14,14,0,0,1,1
-6,-24,18,1,1,0
36,24,12,1,1,0
27,11,16,1,1,0
-25,-8,-17,0,1,1
7,-5,12,1,0,1
7,24,-17,0,0,0
32,35,-3,0,0,0
10,5,5,1,0,1
14,4,10,1,0,1
6,8,-2,0,0,0
-15,-24,9,1,0,1
-29,-12,-17,0,0,0
39,40,-1,0,0,0
-14,-23,9,1,0,1
-51,-40,-11,0,0,0
36,40,-4,0,0,0
-26,-24,-2,0,0,0
17,27,-10,0,0,0
-8,-3,-5,0,1,1
-25,-33,8,1,1,0
-43,-24,-19,0,1,1
-11,-22,11,1,1,0
-10,-30,20,1,1,0
22,7,15,1,1,0
2,-12,14,1,1,0
43,24,19,1,1,0
45,36,9,1,1,0
-14,-22,8,1,1,0
4,22,-18,0,1,1
-24,-9,-15,0,1,1
2,1,1,1,1,0
29,11,18,1,1,0
-25,-19,-6,0,0,0
-32,-12,-20,0,0,0
-44,-26,-18,0,0,0
33,39,-6,0,0,0
-60,-40,-20,0,0,0
18,15,3,1,0,1
-6,12,-18,0,0,0
-5,-12,7,1,0,1
62,43,19,1,0,1
12,7,5,1,0,1
12,-6,18,1,0,1
-9,-26,17,1,0,1
-8,-27,19,1,0,1
-29,-16,-13,0,0,0
-8,4,-12,0,0,0
0,-14,14,1,0,1
-6,10,-16,0,0,0
21,25,-4,0,0,0
2,4,-2,0,0,0
-6,-23,17,1,1,0
-24,-23,-1,0,1,1
-44,-26,-18,0,1,1
6,-13,19,1,1,0
27,41,-14,0,1,1
11,-6,17,1,1,0
1,9,-8,0,1,1
-11,-14,3,1,1,0
-6,11,-17,0,1,1
3,3,0,0,1,1
7,18,-11,0,1,1
30,42,-12,0,0,0
9,7,2,1,0,1
3,-12,15,1,0,1
-23,-7,-16,0,0,0
-23,-19,-4,0,0,0
-40,-21,-19,0,0,0
-10,9,-19,0,0,0
-15,-16,1,1,0,1
45,44,1,1,0,1
-7,-9,2,1,0,1
6,-3,9,1,1,0
16,4,12,1,1,0
-29,-45,16,1,1,0
-2,-14,12,1,1,0
-4,6,-10,0,1,1
-50,-30,-20,0,1,1
17,27,-10,0,1,1
25,27,-2,0,1,1
28,27,1,1,0,1
-37,-18,-19,0,0,0
-22,-34,12,1,0,1
55,37,18,1,0,1
-29,-25,-4,0,0,0
37,31,6,1,0,1
49,34,15,1,0,1
42,37,5,1,0,1
18,5,13,1,0,1
10,26,-16,0,0,0
6,-6,12,1,0,1
-2,7,-9,0,0,0
-39,-30,-9,0,0,0
22,29,-7,0,0,0
37,23,14,1,0,1
-1,-14,13,1,0,1
21,39,-18,0,0,0
-1,-3,2,1,0,1
-24,-7,-17,0,0,0
-9,-8,-1,0,0,0
29,10,19,1,0,1
-18,-38,20,1,1,0
22,28,-6,0,1,1
-47,-37,-10,0,1,1
-56,-39,-17,0,1,1
36,17,19,1,1,0
5,25,-20,0,1,1
52,35,17,1,1,0
-6,-15,9,1,1,0
13,17,-4,0,1,1
-46,-37,-9,0,1,1
9,5,4,1,1,0
17,35,-18,0,1,1
-9,-15,6,1,1,0
-20,-18,-2,0,1,1
-6,12,-18,0,1,1
-32,-36,4,1,1,0
50,40,10,1,1,0
13,3,10,1,1,0
-14,-8,-6,0,1,1
36,32,4,1,1,0
21,13,8,1,1,0
21,20,1,1,0,1
22,4,18,1,0,1
29,29,0,0,0,0
-27,-42,15,1,0,1
-15,-5,-10,0,0,0
11,4,7,1,0,1
24,32,-8,0,0,0
-39,-20,-19,0,0,0
-32,-25,-7,0,0,0
-57,-42,-15,0,0,0
-8,0,-8,0,0,0
3,-9,12,1,0,1
-21,-14,-7,0,0,0
-35,-35,0,0,0,0
-41,-23,-18,0,0,0
-37,-44,7,1,0,1
-24,-16,-8,0,0,0
-3,-20,17,1,0,1
2,19,-17,0,0,0
9,13,-4,0,0,0
-30,-12,-18,0,0,0
17,12,5,1,1,0
-2,16,-18,0,1,1
-38,-34,-4,0,1,1
-6,-26,20,1,1,0
-47,-36,-11,0,1,1
-13,-4,-9,0,1,1
-23,-36,13,1,1,0
-2,-20,18,1,1,0
-18,-32,14,1,1,0
-8,-27,19,1,1,0
15,4,11,1,1,0
60,42,18,1,1,0
-26,-17,-9,0,1,1
-10,-14,4,1,0,1
18,13,5,1,0,1
-35,-44,9,1,0,1
-28,-23,-5,0,0,0
-20,-23,3,1,0,1
-10,10,-20,0,0,0
-33,-26,-7,0,0,0
18,19,-1,0,0,0
15,5,10,1,0,1
-51,-31,-20,0,1,1
-54,-45,-9,0,1,1
-25,-5,-20,0,1,1
35,18,17,1,1,0
41,42,-1,0,1,1
-23,-25,2,1,1,0
28,30,-2,0,1,1
20,26,-6,0,1,1
-4,-5,1,1,1,0
-26,-43,17,1,1,0
-16,-18,2,1,1,0
-7,12,-19,0,0,0
-22,-10,-12,0,0,0
-24,-32,8,1,0,1
-14,-18,4,1,0,1
-21,-10,-11,0,0,0
-22,-40,18,1,0,1
55,44,11,1,0,1
-2,-18,16,1,0,1
12,23,-11,0,0,0
-4,1,-5,0,0,0
-6,-16,10,1,0,1
-20,-26,6,1,0,1
13,-5,18,1,0,1
-54,-41,-13,0,0,0
-28,-19,-9,0,0,0
26,7,19,1,0,1
-59,-43,-16,0,0,0
31,32,-1,0,0,0
-17,-5,-12,0,0,0
-34,-29,-5,0,0,0
-25,-22,-3,0,0,0
27,42,-15,0,1,1
36,30,6,1,1,0
37,31,6,1,1,0
-25,-34,9,1,1,0
-8,-7,-1,0,1,1
56,43,13,1,1,0
-7,-25,18,1,1,0
2,21,-19,0,1,1
52,40,12,1,1,0
-37,-40,3,1,1,0
15,35,-20,0,1,1
-37,-36,-1,0,1,1
39,39,0,0,0,0
-61,-43,-18,0,0,0
-11,-30,19,1,0,1
18,20,-2,0,0,0
28,42,-14,0,0,0
34,22,12,1,0,1
30,26,4,1,0,1
14,4,10,1,0,1
60,41,19,1,0,1
-23,-40,17,1,0,1
-4,-7,3,1,0,1
49,38,11,1,0,1
37,27,10,1,1,0
-27,-42,15,1,1,0
19,34,-15,0,1,1
-33,-33,0,0,1,1
-17,-23,6,1,1,0
2,-9,11,1,1,0
40,44,-4,0,1,1
39,37,2,1,1,0
-44,-35,-9,0,1,1
-43,-41,-2,0,1,1
-9,-10,1,1,0,1
-22,-15,-7,0,0,0
-3,-2,-1,0,0,0
20,22,-2,0,0,0
12,-1,13,1,0,1
17,20,-3,0,0,0
16,5,11,1,0,1
-12,-12,0,0,0,0
-24,-7,-17,0,0,0
-25,-28,3,1,1,0
30,12,18,1,1,0
51,38,13,1,1,0
3,5,-2,0,1,1
-28,-22,-6,0,1,1
-12,3,-15,0,1,1
-21,-8,-13,0,1,1
-27,-28,1,1,1,0
8,13,-5,0,1,1
-15,-4,-11,0,1,1
-14,-24,10,1,1,0
-28,-23,-5,0,1,1
17,15,2,1,1,0
-55,-43,-12,0,1,1
23,43,-20,0,1,1
-24,-44,20,1,1,0
47,32,15,1,1,0
28,22,6,1,1,0
34,32,2,1,0,1
4,16,-12,0,0,0
-50,-36,-14,0,0,0
-35,-33,-2,0,0,0
-7,-5,-2,0,0,0
-3,-22,19,1,0,1
27,30,-3,0,0,0
31,37,-6,0,0,0
31,11,20,1,0,1
44,41,3,1,1,0
14,32,-18,0,1,1
44,34,10,1,1,0
34,35,-1,0,1,1
41,40,1,1,1,0
35,38,-3,0,1,1
2,-5,7,1,1,0
42,26,16,1,1,0
10,-9,19,1,1,0
-17,-27,10,1,1,0
41,38,3,1,1,0
-16,-5,-11,0,1,1
33,20,13,1,0,1
-15,-18,3,1,0,1
-56,-40,-16,0,0,0
7,17,-10,0,0,0
35,18,17,1,0,1
-30,-29,-1,0,0,0
17,19,-2,0,0,0
-1,-14,13,1,0,1
-10,-20,10,1,0,1
49,41,8,1,0,1
21,23,-2,0,0,0
0,-3,3,1,0,1
-51,-32,-19,0,0,0
-9,7,-16,0,0,0
31,14,17,1,0,1
0,-7,7,1,0,1
30,30,0,0,0,0
-42,-36,-6,0,0,0
24,13,11,1,0,1
-17,-23,6,1,0,1
-4,12,-16,0,0,0
-22,-41,19,1,1,0
29,26,3,1,1,0
7,12,-5,0,1,1
-56,-43,-13,0,1,1
5,22,-17,0,1,1
18,18,0,0,1,1
-20,-25,5,1,1,0
-50,-39,-11,0,1,1
32,36,-4,0,1,1
-17,-15,-2,0,1,1
-3,-7,4,1,1,0
6,-7,13,1,1,0
41,39,2,1,1,0
1,-7,8,1,1,0
42,29,13,1,1,0
-17,-17,0,0,1,1
-35,-17,-18,0,1,1
39,41,-2,0,1,1
-8,3,-11,0,1,1
-30,-13,-17,0,1,1
-5,-13,8,1,1,0
-12,3,-15,0,0,0
42,29,13,1,0,1
19,31,-12,0,0,0
-62,-45,-17,0,0,0
-25,-44,19,1,0,1
-16,-22,6,1,0,1
-9,-8,-1,0,0,0
11,24,-13,0,0,0
30,30,0,0,0,0
-13,1,-14,0,0,0
48,41,7,1,1,0
13,1,12,1,1,0
46,39,7,1,1,0
-2,-2,0,0,1,1
23,12,11,1,1,0
-14,-27,13,1,1,0
2,-10,12,1,1,0
21,24,-3,0,1,1
-33,-13,-20,0,1,1
-17,-29,12,1,1,0
19,13,6,1,1,0
0,-8,8,1,1,0
24,21,3,1,1,0
0,-12,12,1,1,0
-20,-33,13,1,1,0
63,44,19,1,1,0
40,23,17,1,1,0
-19,-8,-11,0,1,1
-4,14,-18,0,1,1
7,-1,8,1,1,0
1,17,-16,0,1,1
-12,-13,1,1,0,1
37,33,4,1,0,1
-12,-12,0,0,0,0
-36,-19,-17,0,0,0
-36,-21,-15,0,0,0
32,32,0,0,0,0
-62,-43,-19,0,0,0
39,38,1,1,0,1
33,14,19,1,0,1
-29,-25,-4,0,0,0
16,-2,18,1,0,1
-29,-12,-17,0,0,0
-30,-44,14,1,0,1
41,31,10,1,0,1
-29,-34,5,1,0,1
19,2,17,1,0,1
0,1,-1,0,0,0
-61,-42,-19,0,0,0
9,11,-2,0,0,0
42,35,7,1,0,1
23,22,1,1,1,0
3,15,-12,0,1,1
10,-10,20,1,1,0
-20,-26,6,1,1,0
11,-5,16,1,1,0
7,10,-3,0,1,1
-3,-13,10,1,1,0
6,-13,19,1,1,0
-27,-38,11,1,1,0
7,26,-19,0,0,0
35,33,2,1,0,1
-39,-28,-11,0,0,0
-48,-44,-4,0,0,0
-3,-4,1,1,0,1
-3,-22,19,1,0,1
12,29,-17,0,0,0
-35,-17,-18,0,0,0
-11,-16,5,1,0,1
-28,-18,-10,0,0,0
42,42,0,0,0,0
19,5,14,1,1,0
-20,-11,-9,0,1,1
-7,-19,12,1,1,0
25,29,-4,0,1,1
40,40,0,0,1,1
6,-2,8,1,1,0
1,-9,10,1,1,0
24,32,-8,0,1,1
21,21,0,0,1,1
-47,-34,-13,0,1,1
28,28,0,0,1,1
44,36,8,1,1,0
51,40,11,1,1,0
17,7,10,1,1,0
-3,-4,1,1,0,1
-25,-21,-4,0,0,0
-58,-39,-19,0,0,0
-21,-13,-8,0,0,0
20,25,-5,0,0,0
-27,-35,8,1,0,1
8,18,-10,0,0,0
-4,-15,11,1,0,1
11,20,-9,0,0,0
8,-12,20,1,0,1
0,-8,8,1,0,1
54,42,12,1,0,1
33,32,1,1,0,1
27,11,16,1,0,1
1,8,-7,0,0,0
39,36,3,1,1,0
46,43,3,1,1,0
34,36,-2,0,1,1
-17,-23,6,1,1,0
24,31,-7,0,1,1
-38,-29,-9,0,1,1
27,33,-6,0,1,1
34,18,16,1,1,0
-39,-45,6,1,1,0
-3,-11,8,1,1,0
49,43,6,1,1,0
50,44,6,1,1,0
41,40,1,1,1,0
-25,-36,11,1,1,0
-22,-9,-13,0,1,1
16,18,-2,0,1,1
-25,-31,6,1,0,1
2,1,1,1,0,1
-50,-35,-15,0,0,0
-49,-38,-11,0,0,0
-10,9,-19,0,0,0
-35,-17,-18,0,0,0
-17,-10,-7,0,0,0
-4,-20,16,1,0,1
-4,-20,16,1,0,1
43,27,16,1,0,1
33,44,-11,0,0,0
-34,-28,-6,0,1,1
22,18,4,1,1,0
37,35,2,1,1,0
-41,-36,-5,0,1,1
18,27,-9,0,1,1
35,25,10,1,1,0
30,31,-1,0,1,1
-19,-12,-7,0,1,1
54,36,18,1,1,0
25,38,-13,0,1,1
-31,-25,-6,0,1,1
-35,-30,-5,0,1,1
-5,10,-15,0,1,1
33,43,-10,0,1,1
25,37,-12,0,1,1
30,21,9,1,1,0
14,8,6,1,1,0
-5,9,-14,0,1,1
-12,-12,0,0,1,1
-42,-22,-20,0,1,1
22,7,15,1,1,0
0,2,-2,0,0,0
-30,-29,-1,0,0,0
-24,-43,19,1,0,1
19,2,17,1,0,1
31,20,11,1,0,1
-33,-38,5,1,0,1
-20,-31,11,1,0,1
-20,-26,6,1,0,1
-28,-41,13,1,0,1
-65,-45,-20,0,0,0
6,-5,11,1,0,1
16,-4,20,1,0,1
-25,-23,-2,0,0,0
-36,-34,-2,0,0,0
10,7,3,1,0,1
-1,-5,4,1,0,1
-20,-40,20,1,0,1
-21,-12,-9,0,0,0
-30,-42,12,1,0,1
5,13,-8,0,0,0
7,27,-20,0,0,0
-7,-20,13,1,1,0
54,44,10,1,1,0
5,-13,18,1,1,0
-8,-8,0,0,1,1
-38,-21,-17,0,1,1
-20,-35,15,1,1,0
31,17,14,1,1,0
3,13,-10,0,1,1
-2,12,-14,0,1,1
-48,-29,-19,0,1,1
22,26,-4,0,1,1
7,-5,12,1,1,0
31,27,4,1,1,0
-19,-17,-2,0,1,1
15,7,8,1,1,0
53,42,11,1,1,0
-3,13,-16,0,1,1
34,39,-5,0,1,1
-23,-25,2,1,1,0
-25,-37,12,1,1,0
-52,-42,-10,0,1,1
-7,7,-14,0,0,0
-29,-24,-5,0,0,0
-49,-30,-19,0,0,0
2,-1,3,1,0,1
-28,-12,-16,0,0,0
-30,-25,-5,0,0,0
32,23,9,1,0,1
-34,-37,3,1,0,1
12,3,9,1,0,1
-46,-31,-15,0,0,0
33,31,2,1,0,1
16,-3,19,1,1,0
-15,-28,13,1,1,0
47,41,6,1,1,0
-20,-24,4,1,1,0
31,39,-8,0,1,1
-32,-28,-4,0,1,1
45,28,17,1,1,0
-44,-42,-2,0,1,1
-45,-26,-19,0,1,1
-15,-14,-1,0,1,1
10,25,-15,0,1,1
39,34,5,1,1,0
38,43,-5,0,0,0
6,8,-2,0,0,0
2,-3,5,1,0,1
-6,9,-15,0,0,0
-29,-35,6,1,0,1
-48,-33,-15,0,0,0
-48,-28,-20,0,0,0
21,30,-9,0,0,0
36,37,-1,0,1,1
3,1,2,1,1,0
17,-1,18,1,1,0
53,36,17,1,1,0
-27,-44,17,1,1,0
4,-5,9,1,1,0
-12,-14,2,1,1,0
-58,-40,-18,0,1,1
5,9,-4,0,1,1
-14,-5,-9,0,1,1
49,31,18,1,1,0
40,37,3,1,1,0
-13,-14,1,1,1,0
-33,-19,-14,0,1,1
-2,1,-3,0,1,1
25,15,10,1,1,0
-1,-14,13,1,1,0
-7,10,-17,0,1,1
-6,-8,2,1,1,0
28,43,-15,0,1,1
-39,-28,-11,0,1,1
-38,-45,7,1,0,1
57,40,17,1,0,1
26,33,-7,0,0,0
14,20,-6,0,0,0
-12,-1,-11,0,0,0
35,41,-6,0,0,0
29,19,10,1,0,1
-7,12,-19,0,0,0
54,39,15,1,0,1
38,28,10,1,0,1
-48,-28,-20,0,0,0
28,33,-5,0,0,0
-53,-34,-19,0,0,0
-25,-12,-13,0,0,0
-15,5,-20,0,1,1
32,14,18,1,1,0
-16,-3,-13,0,1,1
-46,-39,-7,0,1,1
3,-4,7,1,1,0
18,21,-3,0,1,1
45,25,20,1,1,0
-17,-10,-7,0,1,1
20,15,5,1,1,0
-41,-34,-7,0,0,0
-39,-37,-2,0,0,0
4,8,-4,0,0,0
-11,4,-15,0,0,0
3,-3,6,1,0,1
11,18,-7,0,0,0
20,13,7,1,0,1
-14,-17,3,1,0,1
-4,-3,-1,0,0,0
-29,-31,2,1,0,1
-2,-5,3,1,0,1
34,14,20,1,0,1
55,37,18,1,0,1
-34,-29,-5,0,0,0
2,17,-15,0,1,1
-10,9,-19,0,1,1
-15,-13,-2,0,1,1
9,14,-5,0,1,1
-6,10,-16,0,1,1
14,0,14,1,1,0
28,25,3,1,1,0
17,9,8,1,1,0
-20,-3,-17,0,1,1
-1,15,-16,0,1,1
-42,-41,-1,0,1,1
3,-1,4,1,0,1
29,43,-14,0,0,0
35,31,4,1,0,1
-27,-39,12,1,0,1
-22,-38,16,1,0,1
37,17,20,1,0,1
-35,-39,4,1,0,1
-22,-6,-16,0,0,0
21,10,11,1,0,1
27,10,17,1,1,0
16,26,-10,0,1,1
48,38,10,1,1,0
14,14,0,0,1,1
18,38,-20,0,1,1
22,39,-17,0,1,1
-43,-25,-18,0,1,1
50,41,9,1,1,0
33,14,19,1,1,0
-2,-15,13,1,1,0
-35,-27,-8,0,1,1
-43,-23,-20,0,1,1
-19,-4,-15,0,1,1
-5,-11,6,1,0,1
17,19,-2,0,0,0
38,34,4,1,0,1
36,34,2,1,0,1
44,43,1,1,0,1
7,6,1,1,0,1
26,16,10,1,0,1
-40,-29,-11,0,0,0
-20,-9,-11,0,0,0
31,35,-4,0,0,0
35,42,-7,0,0,0
-36,-33,-3,0,0,0
-22,-33,11,1,1,0
-16,-10,-6,0,1,1
-23,-42,19,1,1,0
-38,-34,-4,0,1,1
17,10,7,1,1,0
-33,-17,-16,0,1,1
7,15,-8,0,1,1
11,20,-9,0,1,1
-11,-14,3,1,1,0
-3,8,-11,0,1,1
-31,-28,-3,0,0,0
19,14,5,1,0,1
-23,-15,-8,0,0,0
44,42,2,1,0,1
41,34,7,1,0,1
31,41,-10,0,0,0
-40,-38,-2,0,0,0
-28,-28,0,0,0,0
-20,-3,-17,0,0,0
-54,-37,-17,0,1,1
-37,-22,-15,0,1,1
-9,-14,5,1,1,0
6,-5,11,1,1,0
2,0,2,1,1,0
32,36,-4,0,1,1
24,11,13,1,1,0
27,12,15,1,1,0
-40,-42,2,1,1,0
13,26,-13,0,1,1
-15,-25,10,1,1,0
30,20,10,1,1,0
-31,-22,-9,0,1,1
-19,-28,9,1,1,0
17,29,-12,0,1,1
3,-11,14,1,1,0
-29,-30,1,1,1,0
-24,-42,18,1,1,0
56,39,17,1,1,0
27,25,2,1,1,0
45,40,5,1,1,0
48,41,7,1,0,1
8,12,-4,0,0,0
-9,-18,9,1,0,1
26,18,8,1,0,1
1,2,-1,0,0,0
-38,-41,3,1,0,1
-22,-7,-15,0,0,0
18,3,15,1,0,1
-51,-31,-20,0,1,1
-27,-14,-13,0,1,1
6,-11,17,1,1,0
-23,-10,-13,0,1,1
-27,-44,17,1,1,0
17,34,-17,0,1,1
-21,-34,13,1,1,0
-39,-26,-13,0,1,1
21,1,20,1,1,0
9,13,-4,0,1,1
-3,-9,6,1,1,0
-44,-35,-9,0,1,1
44,33,11,1,1,0
30,27,3,1,1,0
-42,-33,-9,0,1,1
47,40,7,1,1,0
-37,-42,5,1,1,0
-19,-5,-14,0,1,1
-43,-30,-13,0,1,1
-5,14,-19,0,1,1
-24,-19,-5,0,1,1
8,-11,19,1,0,1
-15,-27,12,1,0,1
31,14,17,1,0,1
-34,-15,-19,0,0,0
-20,-19,-1,0,0,0
-2,-20,18,1,0,1
16,6,10,1,0,1
-21,-26,5,1,0,1
12,14,-2,0,0,0
-1,18,-19,0,0,0
17,14,3,1,0,1
-41,-38,-3,0,0,0
-15,0,-15,0,0,0
-18,0,-18,0,1,1
26,44,-18,0,1,1
3,11,-8,0,1,1
14,-2,16,1,1,0
-29,-33,4,1,1,0
10,-5,15,1,1,0
16,24,-8,0,1,1
-7,9,-16,0,1,1
31,25,6,1,0,1
62,43,19,1,0,1
-36,-30,-6,0,0,0
22,12,10,1,0,1
-20,-3,-17,0,0,0
-15,-20,5,1,0,1
-7,13,-20,0,0,0
21,37,-16,0,0,0
-36,-35,-1,0,1,1
-49,-43,-6,0,1,1
-27,-9,-18,0,1,1
8,9,-1,0,1,1
-30,-36,6,1,1,0
-17,-37,20,1,1,0
-12,-28,16,1,1,0
0,16,-16,0,1,1
24,16,8,1,1,0
30,21,9,1,1,0
-47,-31,-16,0,1,1
-9,-11,2,1,1,0
-19,-27,8,1,1,0
-61,-45,-16,0,1,1
-10,-22,12,1,0,1
44,33,11,1,0,1
-2,15,-17,0,0,0
35,21,14,1,0,1
-36,-29,-7,0,0,0
-4,-20,16,1,0,1
25,23,2,1,0,1
16,2,14,1,0,1
12,29,-17,0,0,0
9,16,-7,0,1,1
-17,-30,13,1,1,0
0,-1,1,1,1,0
4,12,-8,0,1,1
24,11,13,1,1,0
7,27,-20,0,1,1
-11,-20,9,1,1,0
12,4,8,1,1,0
-9,5,-14,0,1,1
16,24,-8,0,1,1
-64,-45,-19,0,1,1
44,37,7,1,1,0
-1,-18,17,1,1,0
48,31,17,1,1,0
13,2,11,1,1,0
-18,-6,-12,0,1,1
-43,-33,-10,0,1,1
27,17,10,1,1,0
-18,-30,12,1,1,0
-28,-43,15,1,1,0
-16,-24,8,1,1,0
-9,10,-19,0,0,0
19,33,-14,0,0,0
17,6,11,1,0,1
-10,3,-13,0,0,0
-19,-29,10,1,0,1
1,10,-9,0,0,0
-44,-28,-16,0,0,0
26,34,-8,0,0,0
-8,-4,-4,0,0,0
-25,-19,-6,0,0,0
-21,-40,19,1,0,1
23,38,-15,0,0,0
-31,-19,-12,0,0,0
-15,-35,20,1,0,1
13,-5,18,1,0,1
-39,-35,-4,0,0,0
-28,-8,-20,0,0,0
-25,-38,13,1,0,1
-28,-18,-10,0,0,0
35,21,14,1,0,1
-19,-18,-1,0,0,0
-8,8,-16,0,1,1
-62,-43,-19,0,1,1
-32,-34,2,1,1,0
34,42,-8,0,1,1
8,4,4,1,1,0
-2,-21,19,1,1,0
46,31,15,1,1,0
-9,10,-19,0,1,1
5,-11,16,1,1,0
36,37,-1,0,1,1
3,4,-1,0,1,1
-13,-30,17,1,1,0
27,25,2,1,1,0
19,23,-4,0,1,1
-24,-23,-1,0,1,1
48,32,16,1,1,0
24,7,17,1,1,0
-34,-41,7,1,1,0
-17,-2,-15,0,1,1
38,44,-6,0,1,1
-11,-31,20,1,1,0
-3,6,-9,0,0,0
7,11,-4,0,0,0
-35,-23,-12,0,0,0
-21,-7,-14,0,0,0
13,10,3,1,0,1
22,2,20,1,0,1
-25,-41,16,1,0,1
-17,-24,7,1,0,1
1,-9,10,1,0,1
-9,-11,2,1,0,1
47,27,20,1,0,1
24,7,17,1,0,1
-44,-32,-12,0,0,0
15,20,-5,0,0,0
-49,-45,-4,0,0,0
1,21,-20,0,0,0
-15,-19,4,1,0,1
-39,-44,5,1,0,1
44,38,6,1,0,1
-25,-29,4,1,0,1
-37,-32,-5,0,0,0
33,38,-5,0,1,1
-41,-41,0,0,1,1
30,36,-6,0,1,1
-17,-5,-12,0,1,1
24,16,8,1,1,0
-17,-10,-7,0,1,1
-12,-32,20,1,1,0
57,39,18,1,1,0
-30,-25,-5,0,1,1
-62,-43,-19,0,1,1
-2,-20,18,1,1,0
42,37,5,1,1,0
0,0,0,0,0,0
26,18,8,1,0,1
9,-3,12,1,0,1
6,4,2,1,0,1
18,2,16,1,0,1
42,37,5,1,0,1
-13,-13,0,0,0,0
23,15,8,1,0,1
53,39,14,1,0,1
41,37,4,1,1,0
26,29,-3,0,1,1
23,3,20,1,1,0
20,27,-7,0,1,1
22,36,-14,0,1,1
23,40,-17,0,1,1
37,22,15,1,1,0
-16,-32,16,1,1,0
5,23,-18,0,1,1
14,-3,17,1,1,0
-60,-44,-16,0,1,1
-24,-13,-11,0,1,1
40,44,-4,0,1,1
49,43,6,1,1,0
46,37,9,1,1,0
12,17,-5,0,1,1
-16,-26,10,1,1,0
33,42,-9,0,1,1
20,12,8,1,1,0
35,35,0,0,1,1
15,23,-8,0,1,1
43,28,15,1,0,1
-25,-20,-5,0,0,0
-8,-22,14,1,0,1
-20,-2,-18,0,0,0
-18,0,-18,0,0,0
41,23,18,1,0,1
6,-14,20,1,0,1
25,41,-16,0,0,0
3,-13,16,1,0,1
25,35,-10,0,0,0
47,36,11,1,1,0
-24,-37,13,1,1,0
4,-9,13,1,1,0
-31,-21,-10,0,1,1
-13,-21,8,1,1,0
12,19,-7,0,1,1
26,37,-11,0,1,1
14,31,-17,0,1,1
-51,-36,-15,0,0,0
45,42,3,1,0,1
0,2,-2,0,0,0
15,22,-7,0,0,0
-20,-23,3,1,0,1
3,10,-7,0,0,0
-7,-7,0,0,0,0
-51,-36,-15,0,0,0
44,36,8,1,0,1
-42,-36,-6,0,0,0
5,-9,14,1,0,1
-6,-7,1,1,0,1
16,0,16,1,0,1
-30,-18,-12,0,0,0
-7,-25,18,1,0,1
31,26,5,1,0,1
30,42,-12,0,0,0
21,12,9,1,1,0
-12,1,-13,0,1,1
-33,-42,9,1,1,0
-54,-37,-17,0,1,1
-26,-31,5,1,1,0
30,37,-7,0,1,1
33,26,7,1,1,0
39,28,11,1,1,0
-2,-20,18,1,1,0
14,34,-20,0,1,1
-26,-32,6,1,1,0
32,40,-8,0,0,0
-34,-17,-17,0,0,0
7,17,-10,0,0,0
8,-9,17,1,0,1
-29,-23,-6,0,0,0
-58,-38,-20,0,0,0
-6,11,-17,0,0,0
-44,-30,-14,0,0,0
21,12,9,1,0,1
-48,-41,-7,0,0,0
43,25,18,1,1,0
22,16,6,1,1,0
-41,-36,-5,0,1,1
-32,-28,-4,0,1,1
8,-1,9,1,1,0
-40,-39,-1,0,1,1
-63,-45,-18,0,1,1
-54,-36,-18,0,1,1
21,36,-15,0,1,1
-33,-22,-11,0,1,1
-55,-45,-10,0,1,1
12,28,-16,0,1,1
-9,-25,16,1,1,0
2,-15,17,1,1,0
4,13,-9,0,1,1
-11,-8,-3,0,1,1
-2,12,-14,0,0,0
-54,-43,-11,0,0,0
-20,-15,-5,0,0,0
21,6,15,1,0,1
-35,-39,4,1,0,1
15,32,-17,0,0,0
-1,11,-12,0,0,0
25,39,-14,0,0,0
18,37,-19,0,0,0
16,26,-10,0,0,0
-27,-15,-12,0,0,0
-25,-21,-4,0,0,0
-28,-25,-3,0,0,0
-20,-23,3,1,0,1
-34,-25,-9,0,0,0
-39,-20,-19,0,0,0
-12,-31,19,1,0,1
8,17,-9,0,0,0
40,26,14,1,0,1
43,36,7,1,0,1
27,37,-10,0,0,0
32,42,-10,0,1,1
-51,-42,-9,0,1,1
-24,-27,3,1,1,0
3,18,-15,0,1,1
12,7,5,1,1,0
-27,-41,14,1,1,0
-15,-15,0,0,1,1
-20,-9,-11,0,1,1
23,26,-3,0,1,1
18,5,13,1,1,0
36,22,14,1,1,0
30,12,18,1,1,0
27,41,-14,0,1,1
-7,-5,-2,0,1,1
28,39,-11,0,1,1
-34,-40,6,1,1,0
-26,-33,7,1,1,0
-43,-44,1,1,1,0
-40,-37,-3,0,1,1
-47,-38,-9,0,1,1
26,23,3,1,1,0
-6,-8,2,1,0,1
9,-10,19,1,0,1
14,10,4,1,0,1
2,12,-10,0,0,0
35,33,2,1,0,1
-34,-21,-13,0,0,0
26,6,20,1,0,1
16,4,12,1,0,1
-30,-28,-2,0,1,1
-3,12,-15,0,1,1
-29,-40,11,1,1,0
-24,-11,-13,0,1,1
37,41,-4,0,1,1
-4,-16,12,1,1,0
1,-4,5,1,1,0
2,20,-18,0,1,1
-7,12,-19,0,1,1
-43,-42,-1,0,1,1
2,-1,3,1,1,0
30,39,-9,0,1,1
25,14,11,1,1,0
8,-8,16,1,1,0
13,33,-20,0,0,0
-26,-41,15,1,0,1
-3,-18,15,1,0,1
8,-10,18,1,0,1
8,16,-8,0,0,0
-24,-39,15,1,0,1
53,40,13,1,0,1
53,43,10,1,0,1
-51,-45,-6,0,0,0
6,-6,12,1,0,1
-52,-35,-17,0,0,0
44,36,8,1,0,1
0,-15,15,1,0,1
13,32,-19,0,0,0
44,30,14,1,0,1
14,0,14,1,0,1
22,30,-8,0,0,0
20,16,4,1,0,1
33,43,-10,0,0,0
-23,-8,-15,0,0,0
22,41,-19,0,0,0
-16,-26,10,1,1,0
37,40,-3,0,1,1
24,11,13,1,1,0
-21,-20,-1,0,1,1
-5,10,-15,0,1,1
-35,-36,1,1,1,0
1,14,-13,0,1,1
21,32,-11,0,1,1
23,27,-4,0,0,0
-7,-24,17,1,0,1
-48,-30,-18,0,0,0
9,-11,20,1,0,1
38,40,-2,0,0,0
-16,4,-20,0,0,0
-25,-7,-18,0,0,0
-12,1,-13,0,0,0
11,8,3,1,0,1
35,30,5,1,1,0
-50,-35,-15,0,1,1
9,21,-12,0,1,1
36,40,-4,0,1,1
-48,-37,-11,0,1,1
25,26,-1,0,1,1
37,40,-3,0,1,1
7,11,-4,0,1,1
32,40,-8,0,1,1
2,-4,6,1,1,0
6,17,-11,0,1,1
6,-4,10,1,1,0
40,41,-1,0,1,1
-6,10,-16,0,1,1
28,13,15,1,1,0
27,37,-10,0,1,1
-36,-33,-3,0,1,1
-54,-42,-12,0,1,1
7,0,7,1,1,0
13,29,-16,0,1,1
-6,-9,3,1,1,0
-27,-43,16,1,0,1
-28,-13,-15,0,0,0
33,34,-1,0,0,0
24,5,19,1,0,1
-31,-38,7,1,0,1
58,38,20,1,0,1
-18,-25,7,1,0,1
38,40,-2,0,0,0
21,4,17,1,0,1
9,28,-19,0,0,0
28,41,-13,0,1,1
18,26,-8,0,1,1
1,10,-9,0,1,1
0,11,-11,0,1,1
16,23,-7,0,1,1
-18,-34,16,1,1,0
50,42,8,1,1,0
-20,-38,18,1,1,0
-11,1,-12,0,1,1
-10,3,-13,0,1,1
27,27,0,0,1,1
33,33,0,0,0,0
23,39,-16,0,0,0
-17,-16,-1,0,0,0
-35,-19,-16,0,0,0
5,19,-14,0,0,0
33,14,19,1,0,1
31,43,-12,0,0,0
49,36,13,1,0,1
8,-6,14,1,0,1
20,33,-13,0,0,0
-26,-17,-9,0,0,0
-5,3,-8,0,0,0
-44,-37,-7,0,0,0
21,7,14,1,0,1
-29,-42,13,1,0,1
38,34,4,1,0,1
11,18,-7,0,0,0
-26,-39,13,1,0,1
28,29,-1,0,0,0
-6,-15,9,1,0,1
-52,-37,-15,0,1,1
-10,-5,-5,0,1,1
-16,3,-19,0,1,1
37,43,-6,0,1,1
48,29,19,1,1,0
45,43,2,1,1,0
-40,-44,4,1,1,0
4,4,0,0,1,1
5,10,-5,0,1,1
24,34,-10,0,1,1
53,42,11,1,1,0
-35,-19,-16,0,0,0
40,24,16,1,0,1
-4,15,-19,0,0,0
25,5,20,1,0,1
33,24,9,1,0,1
22,34,-12,0,0,0
-5,14,-19,0,0,0
29,25,4,1,0,1
-56,-43,-13,0,0,0
22,35,-13,0,0,0
-14,-3,-11,0,1,1
4,19,-15,0,1,1
22,40,-18,0,1,1
-17,-25,8,1,1,0
-20,-9,-11,0,1,1
45,26,19,1,1,0
-38,-20,-18,0,1,1
28,43,-15,0,1,1
-13,-7,-6,0,1,1
-13,0,-13,0,1,1
8,-1,9,1,1,0
5,7,-2,0,1,1
23,30,-7,0,1,1
-27,-14,-13,0,1,1
-5,-14,9,1,0,1
-5,12,-17,0,0,0
3,5,-2,0,0,0
6,0,6,1,0,1
-33,-37,4,1,0,1
25,30,-5,0,0,0
36,37,-1,0,0,0
-33,-25,-8,0,0,0
52,43,9,1,0,1
-4,-18,14,1,0,1
2,-10,12,1,0,1
-17,-5,-12,0,0,0
-53,-34,-19,0,0,0
27,24,3,1,0,1
-6,4,-10,0,0,0
-59,-44,-15,0,0,0
-2,-3,1,1,0,1
-48,-33,-15,0,0,0
-52,-32,-20,0,0,0
-14,-1,-13,0,0,0
-39,-30,-9,0,0,0
-19,-22,3,1,1,0
17,3,14,1,1,0
-28,-23,-5,0,1,1
-37,-27,-10,0,1,1
-10,-15,5,1,1,0
-35,-26,-9,0,1,1
-25,-5,-20,0,1,1
-30,-10,-20,0,1,1
-5,2,-7,0,1,1
-25,-17,-8,0,1,1
12,26,-14,0,1,1
-27,-25,-2,0,1,1
-40,-26,-14,0,0,0
26,8,18,1,0,1
26,7,19,1,0,1
32,12,20,1,0,1
-14,-24,10,1,0,1
17,27,-10,0,0,0
-35,-42,7,1,0,1
11,-7,18,1,0,1
-20,-14,-6,0,0,0
-19,-8,-11,0,0,0
39,38,1,1,0,1
31,41,-10,0,0,0
5,-12,17,1,0,1
-23,-31,8,1,0,1
-13,6,-19,0,0,0
-40,-20,-20,0,0,0
59,44,15,1,0,1
25,10,15,1,0,1
10,20,-10,0,0,0
-17,-20,3,1,0,1
28,16,12,1,0,1
-27,-12,-15,0,1,1
-12,-2,-10,0,1,1
-62,-43,-19,0,1,1
-26,-34,8,1,1,0
-42,-37,-5,0,1,1
45,35,10,1,1,0
2,10,-8,0,1,1
-10,-16,6,1,1,0
-51,-45,-6,0,0,0
5,-1,6,1,0,1
-33,-44,11,1,0,1
-9,-15,6,1,0,1
27,42,-15,0,0,0
-16,-30,14,1,0,1
51,35,16,1,0,1
18,1,17,1,0,1
17,24,-7,0,0,0
1,-11,12,1,0,1
25,32,-7,0,0,0
11,3,8,1,0,1
9,18,-9,0,0,0
3,-1,4,1,0,1
-21,-41,20,1,0,1
-18,2,-20,0,0,0
7,16,-9,0,0,0
17,10,7,1,0,1
4,13,-9,0,0,0
33,21,12,1,0,1
39,37,2,1,0,1
12,-5,17,1,1,0
16,-1,17,1,1,0
38,28,10,1,1,0
0,20,-20,0,1,1
41,41,0,0,1,1
-21,-4,-17,0,1,1
11,9,2,1,1,0
-35,-34,-1,0,1,1
-7,-2,-5,0,1,1
-24,-17,-7,0,1,1
-26,-18,-8,0,0,0
-7,-17,10,1,0,1
-39,-26,-13,0,0,0
-8,3,-11,0,0,0
-57,-38,-19,0,0,0
-42,-30,-12,0,0,0
23,28,-5,0,0,0
7,4,3,1,0,1
-49,-34,-15,0,0,0
-21,-5,-16,0,0,0
21,6,15,1,0,1
10,29,-19,0,0,0
36,20,16,1,0,1
-27,-41,14,1,0,1
3,11,-8,0,0,0
-28,-18,-10,0,0,0
-2,-19,17,1,0,1
21,13,8,1,0,1
11,22,-11,0,0,0
19,16,3,1,0,1
27,28,-1,0,0,0
-42,-23,-19,0,1,1
-11,1,-12,0,1,1
-19,-13,-6,0,1,1
-34,-30,-4,0,1,1
-27,-43,16,1,1,0
-47,-44,-3,0,1,1
-39,-43,4,1,1,0
8,-10,18,1,1,0
-41,-45,4,1,1,0
-8,2,-10,0,1,1
34,43,-9,0,1,1
49,39,10,1,1,0
24,22,2,1,1,0
5,-2,7,1,1,0
-22,-38,16,1,1,0
12,29,-17,0,1,1
7,16,-9,0,1,1
-10,-21,11,1,1,0
-29,-41,12,1,1,0
3,21,-18,0,0,0
-40,-42,2,1,0,1
-25,-13,-12,0,0,0
-4,-13,9,1,0,1
-10,-4,-6,0,0,0
18,9,9,1,0,1
-8,-24,16,1,0,1
49,29,20,1,0,1
-20,-15,-5,0,0,0
64,44,20,1,0,1
58,38,20,1,0,1
37,21,16,1,1,0
12,5,7,1,1,0
18,18,0,0,1,1
-26,-24,-2,0,1,1
-23,-36,13,1,1,0
-43,-25,-18,0,1,1
-12,-17,5,1,1,0
27,35,-8,0,1,1
28,11,17,1,1,0
1,17,-16,0,0,0
25,41,-16,0,0,0
-31,-33,2,1,0,1
-19,-3,-16,0,0,0
-39,-43,4,1,0,1
41,42,-1,0,0,0
-4,-8,4,1,0,1
-11,-30,19,1,0,1
4,-10,14,1,0,1
-44,-30,-14,0,0,0
-18,-7,-11,0,0,0
1,11,-10,0,1,1
-54,-34,-20,0,1,1
-16,3,-19,0,1,1
34,31,3,1,1,0
-12,6,-18,0,1,1
-38,-22,-16,0,1,1
-25,-13,-12,0,1,1
-29,-25,-4,0,1,1
28,31,-3,0,1,1
-1,3,-4,0,1,1
20,6,14,1,1,0
-14,-16,2,1,1,0
28,39,-11,0,1,1
28,25,3,1,1,0
33,34,-1,0,1,1
-35,-36,1,1,1,0
0,-4,4,1,1,0
12,7,5,1,1,0
28,26,2,1,1,0
0,-18,18,1,1,0
-33,-44,11,1,1,0
30,37,-7,0,0,0
48,44,4,1,0,1
34,23,11,1,0,1
-27,-35,8,1,0,1
-5,3,-8,0,0,0
11,17,-6,0,0,0
22,4,18,1,0,1
-15,-17,2,1,0,1
-4,-20,16,1,0,1
-28,-31,3,1,0,1
34,23,11,1,0,1
-8,-18,10,1,0,1
-6,0,-6,0,0,0
0,4,-4,0,0,0
42,34,8,1,1,0
34,24,10,1,1,0
-30,-40,10,1,1,0
-36,-31,-5,0,1,1
7,6,1,1,1,0
0,-7,7,1,1,0
8,-10,18,1,1,0
7,0,7,1,1,0
42,25,17,1,1,0
-9,4,-13,0,1,1
24,26,-2,0,1,1
-6,-26,20,1,1,0
40,42,-2,0,1,1
-38,-37,-1,0,1,1
-18,-19,1,1,1,0
-55,-43,-12,0,1,1
55,40,15,1,0,1
-2,12,-14,0,0,0
57,42,15,1,0,1
-27,-42,15,1,0,1
-33,-26,-7,0,0,0
47,39,8,1,0,1
-35,-24,-11,0,0,0
-12,-19,7,1,0,1
-49,-42,-7,0,0,0
5,13,-8,0,0,0
-19,-21,2,1,0,1
30,21,9,1,1,0
-5,4,-9,0,1,1
-17,2,-19,0,1,1
21,1,20,1,1,0
-18,-11,-7,0,1,1
24,37,-13,0,1,1
57,39,18,1,1,0
-9,-18,9,1,1,0
-52,-43,-9,0,0,0
17,22,-5,0,0,0
-8,7,-15,0,0,0
-16,-24,8,1,0,1
-5,15,-20,0,0,0
-21,-41,20,1,0,1
42,26,16,1,0,1
-1,-19,18,1,0,1
-45,-39,-6,0,0,0
-14,-9,-5,0,0,0
34,35,-1,0,0,0
12,32,-20,0,0,0
-26,-22,-4,0,0,0
-23,-28,5,1,0,1
42,23,19,1,0,1
14,-1,15,1,1,0
-52,-32,-20,0,1,1
-30,-21,-9,0,1,1
-27,-42,15,1,1,0
-26,-18,-8,0,1,1
-32,-14,-18,0,1,1
-40,-24,-16,0,1,1
-44,-26,-18,0,1,1
-7,-4,-3,0,1,1
-16,-13,-3,0,0,0
24,40,-16,0,0,0
15,2,13,1,0,1
2,15,-13,0,0,0
18,6,12,1,0,1
-48,-45,-3,0,0,0
19,35,-16,0,0,0
9,23,-14,0,0,0
-14,-27,13,1,0,1
-15,-23,8,1,0,1
-16,-6,-10,0,0,0
7,-7,14,1,0,1
-29,-37,8,1,0,1
15,20,-5,0,0,0
-23,-24,1,1,0,1
-31,-41,10,1,1,0
-59,-45,-14,0,1,1
-31,-30,-1,0,1,1
-40,-39,-1,0,1,1
27,11,16,1,1,0
4,12,-8,0,1,1
28,18,10,1,1,0
47,29,18,1,1,0
12,22,-10,0,1,1
-38,-40,2,1,1,0
21,4,17,1,1,0
-17,1,-18,0,1,1
-4,-12,8,1,1,0
-22,-26,4,1,0,1
26,11,15,1,0,1
42,25,17,1,0,1
-5,-22,17,1,0,1
-1,-7,6,1,0,1
60,41,19,1,0,1
-8,10,-18,0,0,0
12,17,-5,0,0,0
-7,-2,-5,0,0,0
6,-4,10,1,0,1
-20,-31,11,1,0,1
1,5,-4,0,0,0
-48,-39,-9,0,0,0
-5,5,-10,0,0,0
-25,-42,17,1,0,1
-19,-23,4,1,1,0
1,-1,2,1,1,0
40,23,17,1,1,0
5,16,-11,0,1,1
4,8,-4,0,1,1
3,21,-18,0,1,1
-7,1,-8,0,1,1
-8,-8,0,0,1,1
6,-2,8,1,1,0
23,13,10,1,1,0
-16,-20,4,1,1,0
5,12,-7,0,1,1
-36,-26,-10,0,1,1
-29,-45,16,1,0,1
-23,-39,16,1,0,1
-48,-37,-11,0,0,0
-6,-5,-1,0,0,0
-15,4,-19,0,0,0
-34,-19,-15,0,0,0
24,38,-14,0,0,0
-32,-39,7,1,0,1
39,30,9,1,1,0
42,29,13,1,1,0
-40,-27,-13,0,1,1
15,-2,17,1,1,0
2,-13,15,1,1,0
31,17,14,1,1,0
32,35,-3,0,1,1
-13,5,-18,0,1,1
22,21,1,1,1,0
-49,-30,-19,0,1,1
-28,-24,-4,0,1,1
12,-2,14,1,1,0
28,32,-4,0,1,1
61,41,20,1,1,0
-1,-16,15,1,1,0
16,1,15,1,1,0
6,17,-11,0,1,1
-34,-30,-4,0,1,1
-46,-45,-1,0,1,1
11,10,1,1,0,1
4,-5,9,1,0,1
1,11,-10,0,0,0
-28,-11,-17,0,0,0
7,1,6,1,0,1
-56,-42,-14,0,0,0
13,23,-10,0,0,0
20,29,-9,0,0,0
28,37,-9,0,0,0
-18,-20,2,1,1,0
-25,-16,-9,0,1,1
20,8,12,1,1,0
-49,-42,-7,0,1,1
20,18,2,1,1,0
-57,-45,-12,0,1,1
49,39,10,1,1,0
-41,-25,-16,0,1,1
35,16,19,1,1,0
-12,6,-18,0,1,1
-11,1,-12,0,1,1
-17,-22,5,1,1,0
0,18,-18,0,1,1
-18,-33,15,1,1,0
27,21,6,1,1,0
51,36,15,1,1,0
-29,-15,-14,0,1,1
-1,-8,7,1,1,0
-21,-7,-14,0,1,1
63,44,19,1,1,0
-21,-10,-11,0,1,1
-15,-15,0,0,0,0
-40,-45,5,1,0,1
-1,16,-17,0,0,0
-35,-38,3,1,0,1
-34,-15,-19,0,0,0
-54,-37,-17,0,0,0
-34,-41,7,1,0,1
25,27,-2,0,0,0
10,4,6,1,0,1
-25,-37,12,1,1,0
-5,5,-10,0,1,1
-49,-29,-20,0,1,1
-19,-34,15,1,1,0
37,18,19,1,1,0
26,14,12,1,1,0
-15,-26,11,1,1,0
-49,-36,-13,0,1,1
6,5,1,1,0,1
52,43,9,1,0,1
-30,-13,-17,0,0,0
-28,-33,5,1,0,1
-31,-29,-2,0,0,0
-59,-40,-19,0,0,0
30,38,-8,0,0,0
-14,-7,-7,0,0,0
-40,-23,-17,0,0,0
-40,-29,-11,0,0,0
7,-2,9,1,0,1
2,2,0,0,1,1
-15,0,-15,0,1,1
-6,-10,4,1,1,0
-26,-39,13,1,1,0
-20,-34,14,1,1,0
1,14,-13,0,1,1
39,42,-3,0,1,1
-1,-17,16,1,1,0
20,21,-1,0,1,1
15,8,7,1,1,0
-24,-17,-7,0,1,1
23,22,1,1,1,0
33,21,12,1,1,0
28,28,0,0,1,1
15,-5,20,1,1,0
26,38,-12,0,1,1
47,39,8,1,1,0
60,42,18,1,1,0
40,26,14,1,1,0
-13,-21,8,1,1,0
-31,-25,-6,0,1,1
-11,-9,-2,0,0,0
-19,-20,1,1,0,1
13,0,13,1,0,1
-13,-24,11,1,0,1
-44,-37,-7,0,0,0
30,35,-5,0,0,0
-63,-45,-18,0,0,0
23,9,14,1,0,1
-3,-17,14,1,0,1
11,4,7,1,0,1
19,16,3,1,0,1
-58,-39,-19,0,0,0
51,35,16,1,0,1
-27,-36,9,1,0,1
-28,-15,-13,0,0,0
-3,-21,18,1,0,1
59,43,16,1,0,1
-3,15,-18,0,0,0
8,9,-1,0,0,0
-3,10,-13,0,0,0
25,15,10,1,0,1
-28,-20,-8,0,1,1
-8,-14,6,1,1,0
-25,-45,20,1,1,0
14,13,1,1,1,0
31,39,-8,0,1,1
53,37,16,1,1,0
36,26,10,1,1,0
2,-11,13,1,1,0
-47,-44,-3,0,1,1
11,16,-5,0,0,0
20,17,3,1,0,1
-42,-35,-7,0,0,0
5,10,-5,0,0,0
31,33,-2,0,0,0
43,37,6,1,0,1
-32,-18,-14,0,0,0
-9,5,-14,0,0,0
22,33,-11,0,0,0
-45,-33,-12,0,0,0
31,38,-7,0,1,1
-16,-18,2,1,1,0
0,-15,15,1,1,0
29,22,7,1,1,0
-24,-7,-17,0,1,1
-54,-45,-9,0,1,1
26,6,20,1,1,0
-27,-36,9,1,1,0
-9,5,-14,0,1,1
8,-4,12,1,1,0
-45,-45,0,0,1,1
-19,-19,0,0,1,1
13,15,-2,0,1,1
12,9,3,1,1,0
60,40,20,1,1,0
-13,-21,8,1,0,1
45,27,18,1,0,1
-14,-3,-11,0,0,0
12,30,-18,0,0,0
51,44,7,1,0,1
-24,-21,-3,0,0,0
-53,-34,-19,0,0,0
-16,1,-17,0,0,0
-15,-21,6,1,0,1
28,26,2,1,0,1
4,-6,10,1,1,0
24,20,4,1,1,0
-39,-43,4,1,1,0
-53,-45,-8,0,1,1
-17,0,-17,0,1,1
19,35,-16,0,1,1
24,44,-20,0,1,1
-16,3,-19,0,1,1
-58,-38,-20,0,1,1
19,28,-9,0,1,1
-30,-24,-6,0,1,1
51,37,14,1,1,0
23,41,-18,0,0,0
-21,-35,14,1,0,1
-5,-2,-3,0,0,0
-18,-37,19,1,0,1
0,10,-10,0,0,0
34,18,16,1,0,1
5,14,-9,0,0,0
9,24,-15,0,0,0
14,5,9,1,0,1
-53,-44,-9,0,0,0
-26,-12,-14,0,0,0
-55,-41,-14,0,0,0
-21,-18,-3,0,0,0
31,41,-10,0,0,0
-15,5,-20,0,0,0
-62,-42,-20,0,0,0
15,11,4,1,0,1
7,-12,19,1,0,1
29,31,-2,0,0,0
-19,1,-20,0,1,1
63,44,19,1,1,0
-19,-6,-13,0,1,1
47,29,18,1,1,0
-50,-43,-7,0,1,1
-46,-35,-11,0,1,1
17,0,17,1,1,0
25,43,-18,0,1,1
-12,-22,10,1,1,0
-31,-37,6,1,1,0
33,24,9,1,0,1
1,-11,12,1,0,1
-24,-36,12,1,0,1
-25,-39,14,1,0,1
40,33,7,1,0,1
-16,-24,8,1,0,1
-16,-27,11,1,0,1
9,11,-2,0,0,0
-11,-28,17,1,0,1
5,23,-18,0,0,0
27,12,15,1,0,1
-33,-29,-4,0,0,0
-36,-37,1,1,1,0
26,28,-2,0,1,1
16,16,0,0,1,1
27,33,-6,0,1,1
-49,-40,-9,0,1,1
19,1,18,1,1,0
4,23,-19,0,1,1
-17,0,-17,0,1,1
15,10,5,1,1,0
18,34,-16,0,1,1
-36,-22,-14,0,1,1
-48,-29,-19,0,1,1
-2,-18,16,1,1,0
17,19,-2,0,1,1
-30,-33,3,1,1,0
-1,-19,18,1,0,1
-15,-6,-9,0,0,0
-1,10,-11,0,0,0
39,20,19,1,0,1
5,14,-9,0,0,0
-26,-29,3,1,0,1
5,9,-4,0,0,0
-28,-44,16,1,0,1
-50,-34,-16,0,1,1
-37,-17,-20,0,1,1
16,23,-7,0,1,1
50,39,11,1,1,0
-29,-44,15,1,1,0
-25,-21,-4,0,1,1
-11,-27,16,1,1,0
11,10,1,1,1,0
31,19,12,1,1,0
33,38,-5,0,1,1
-52,-36,-16,0,1,1
-29,-44,15,1,1,0
18,3,15,1,1,0
-45,-37,-8,0,1,1
-10,7,-17,0,1,1
-42,-28,-14,0,1,1
44,44,0,0,1,1
-3,-22,19,1,1,0
-12,8,-20,0,1,1
-51,-32,-19,0,1,1
31,38,-7,0,1,1
-16,-30,14,1,0,1
36,18,18,1,0,1
10,5,5,1,0,1
49,44,5,1,0,1
19,14,5,1,0,1
-19,-16,-3,0,0,0
21,1,20,1,0,1
-4,5,-9,0,0,0
36,32,4,1,0,1
31,25,6,1,0,1
-23,-20,-3,0,0,0
23,8,15,1,0,1
18,19,-1,0,1,1
30,43,-13,0,1,1
24,10,14,1,1,0
-33,-23,-10,0,1,1
-37,-38,1,1,1,0
-45,-32,-13,0,1,1
-22,-22,0,0,1,1
5,-10,15,1,1,0
-38,-20,-18,0,1,1
7,7,0,0,1,1
23,33,-10,0,1,1
4,-4,8,1,1,0
-32,-39,7,1,1,0
-27,-31,4,1,1,0
-32,-16,-16,0,1,1
-9,-14,5,1,1,0
-12,-31,19,1,0,1
-17,-33,16,1,0,1
-5,8,-13,0,0,0
-55,-42,-13,0,0,0
21,39,-18,0,0,0
-12,-21,9,1,0,1
37,26,11,1,0,1
24,40,-16,0,0,0
12,-6,18,1,0,1
-34,-26,-8,0,0,0
-32,-31,-1,0,0,0
52,39,13,1,0,1
9,-9,18,1,0,1
44,30,14,1,0,1
29,28,1,1,1,0
-17,-4,-13,0,1,1
-10,-11,1,1,1,0
4,-16,20,1,1,0
11,10,1,1,1,0
-46,-44,-2,0,1,1
10,10,0,0,1,1
-15,-24,9,1,1,0
38,20,18,1,1,0
4,11,-7,0,1,1
-28,-17,-11,0,1,1
30,21,9,1,1,0
18,3,15,1,1,0
-12,-30,18,1,1,0
-35,-37,2,1,1,0
-25,-45,20,1,1,0
-15,2,-17,0,1,1
-24,-28,4,1,0,1
36,33,3,1,0,1
-15,-25,10,1,0,1
-3,-22,19,1,0,1
30,16,14,1,0,1
2,13,-11,0,0,0
-63,-43,-20,0,0,0
27,41,-14,0,0,0
15,18,-3,0,0,0
25,34,-9,0,0,0
29,22,7,1,0,1
-44,-38,-6,0,0,0
7,5,2,1,0,1
7,4,3,1,0,1
16,28,-12,0,0,0
11,-7,18,1,0,1
-5,0,-5,0,0,0
-34,-36,2,1,0,1
-4,-3,-1,0,0,0
-15,-13,-2,0,0,0
-28,-45,17,1,0,1
34,24,10,1,1,0
3,-17,20,1,1,0
5,16,-11,0,1,1
-48,-39,-9,0,1,1
-56,-43,-13,0,1,1
-1,-11,10,1,1,0
23,3,20,1,1,0
-37,-19,-18,0,1,1
17,30,-13,0,1,1
-20,-11,-9,0,1,1
-15,-24,9,1,0,1
-13,-5,-8,0,0,0
-18,-3,-15,0,0,0
4,3,1,1,0,1
52,37,15,1,0,1
-26,-13,-13,0,0,0
-6,-2,-4,0,0,0
4,0,4,1,0,1
-1,12,-13,0,0,0
-22,-29,7,1,0,1
44,29,15,1,0,1
-36,-44,8,1,0,1
53,37,16,1,0,1
44,27,17,1,0,1
0,-5,5,1,0,1
-13,-28,15,1,0,1
2,9,-7,0,0,0
9,-11,20,1,0,1
10,20,-10,0,0,0
27,24,3,1,1,0
-14,-14,0,0,1,1
27,38,-11,0,1,1
27,9,18,1,1,0
-13,0,-13,0,1,1
-12,-3,-9,0,1,1
-7,-11,4,1,1,0
-26,-37,11,1,1,0
-56,-37,-19,0,1,1
-32,-45,13,1,1,0
-25,-25,0,0,0,0
39,27,12,1,0,1
-38,-21,-17,0,0,0
13,33,-20,0,0,0
-43,-44,1,1,0,1
26,6,20,1,0,1
46,27,19,1,0,1
-27,-41,14,1,0,1
14,10,4,1,0,1
-28,-16,-12,0,0,0
-25,-44,19,1,0,1
15,20,-5,0,0,0
-31,-30,-1,0,0,0
-8,-3,-5,0,1,1
23,42,-19,0,1,1
-3,-16,13,1,1,0
-14,-31,17,1,1,0
-31,-16,-15,0,1,1
-13,2,-15,0,1,1
13,-2,15,1,1,0
-41,-33,-8,0,1,1
16,25,-9,0,0,0
-29,-17,-12,0,0,0
0,13,-13,0,0,0
21,39,-18,0,0,0
38,31,7,1,0,1
34,19,15,1,0,1
-46,-33,-13,0,0,0
-9,-26,17,1,0,1
-26,-17,-9,0,0,0
18,16,2,1,1,0
9,10,-1,0,1,1
34,30,4,1,1,0
29,22,7,1,1,0
-21,-15,-6,0,1,1
-22,-24,2,1,1,0
33,20,13,1,1,0
-8,-23,15,1,1,0
29,18,11,1,1,0
25,44,-19,0,1,1
-6,3,-9,0,1,1
-13,-26,13,1,0,1
11,8,3,1,0,1
31,25,6,1,0,1
-3,-10,7,1,0,1
14,1,13,1,0,1
-19,-38,19,1,0,1
-14,-27,13,1,0,1
34,20,14,1,0,1
-9,6,-15,0,0,0
14,-6,20,1,0,1
-26,-34,8,1,0,1
25,42,-17,0,0,0
0,5,-5,0,0,0
15,-3,18,1,0,1
0,-7,7,1,0,1
25,37,-12,0,0,0
-9,-12,3,1,0,1
-6,-12,6,1,0,1
33,33,0,0,0,0
36,44,-8,0,0,0
-26,-22,-4,0,0,0
1,16,-15,0,1,1
30,24,6,1,1,0
-31,-23,-8,0,1,1
-20,-39,19,1,1,0
14,13,1,1,1,0
10,-6,16,1,1,0
29,22,7,1,1,0
-40,-34,-6,0,1,1
-15,-12,-3,0,1,1
50,31,19,1,1,0
-22,-13,-9,0,1,1
39,32,7,1,1,0
-30,-35,5,1,1,0
10,5,5,1,1,0
20,1,19,1,1,0
50,35,15,1,1,0
14,31,-17,0,1,1
-19,-25,6,1,1,0
-4,15,-19,0,0,0
5,19,-14,0,0,0
-14,6,-20,0,0,0
-37,-22,-15,0,0,0
-28,-33,5,1,0,1
-11,-20,9,1,0,1
46,36,10,1,0,1
27,9,18,1,0,1
22,4,18,1,0,1
55,36,19,1,1,0
-20,-32,12,1,1,0
40,29,11,1,1,0
37,43,-6,0,1,1
51,38,13,1,1,0
-29,-39,10,1,1,0
29,10,19,1,1,0
-42,-41,-1,0,1,1
-31,-42,11,1,1,0
15,18,-3,0,1,1
-46,-43,-3,0,1,1
30,11,19,1,1,0
58,40,18,1,1,0
-37,-37,0,0,1,1
47,34,13,1,1,0
-8,-12,4,1,1,0
26,31,-5,0,1,1
48,34,14,1,1,0
46,44,2,1,1,0
-41,-23,-18,0,1,1
36,44,-8,0,1,1
1,9,-8,0,0,0
-31,-32,1,1,0,1
26,32,-6,0,0,0
15,19,-4,0,0,0
21,4,17,1,0,1
-42,-23,-19,0,0,0
-37,-20,-17,0,0,0
26,42,-16,0,0,0
-1,7,-8,0,0,0
-27,-24,-3,0,0,0
42,25,17,1,0,1
39,22,17,1,0,1
-20,-36,16,1,0,1
39,34,5,1,0,1
-18,-11,-7,0,0,0
3,10,-7,0,0,0
-4,4,-8,0,0,0
-53,-44,-9,0,0,0
-27,-39,12,1,1,0
-6,-25,19,1,1,0
-9,3,-12,0,1,1
4,7,-3,0,1,1
-15,-2,-13,0,1,1
56,43,13,1,1,0
-14,-26,12,1,1,0
41,21,20,1,1,0
-6,4,-10,0,1,1
-9,7,-16,0,0,0
23,43,-20,0,0,0
40,36,4,1,0,1
-4,-3,-1,0,0,0
-21,-7,-14,0,0,0
-34,-31,-3,0,0,0
-4,14,-18,0,0,0
-32,-15,-17,0,0,0
-27,-32,5,1,0,1
30,15,15,1,0,1
-44,-34,-10,0,0,0
-25,-15,-10,0,1,1
7,-8,15,1,1,0
62,42,20,1,1,0
7,18,-11,0,1,1
-29,-9,-20,0,1,1
34,41,-7,0,1,1
-63,-44,-19,0,1,1
38,25,13,1,1,0
43,33,10,1,1,0
14,25,-11,0,1,1
-3,-23,20,1,1,0
-24,-43,19,1,1,0
-13,-24,11,1,1,0
-42,-33,-9,0,1,1
-14,3,-17,0,1,1
11,20,-9,0,1,1
-12,7,-19,0,1,1
-32,-41,9,1,1,0
47,27,20,1,1,0
-20,-6,-14,0,1,1
-15,-33,18,1,1,0
-7,-13,6,1,0,1
-18,-6,-12,0,0,0
-35,-24,-11,0,0,0
-17,-31,14,1,0,1
34,23,11,1,0,1
-20,-40,20,1,0,1
-44,-41,-3,0,0,0
45,36,9,1,0,1
31,42,-11,0,0,0
-15,-16,1,1,0,1
-33,-37,4,1,0,1
-23,-29,6,1,0,1
51,37,14,1,0,1
-5,-15,10,1,0,1
-1,13,-14,0,0,0
-30,-15,-15,0,1,1
-37,-24,-13,0,1,1
-6,-14,8,1,1,0
-7,-7,0,0,1,1
20,5,15,1,1,0
55,43,12,1,1,0
-4,-7,3,1,1,0
-7,-7,0,0,1,1
-31,-43,12,1,1,0
-26,-19,-7,0,1,1
23,3,20,1,1,0
-22,-23,1,1,1,0
1,-16,17,1,1,0
-63,-45,-18,0,1,1
5,-2,7,1,1,0
-17,-32,15,1,1,0
-34,-24,-10,0,1,1
10,8,2,1,1,0
-56,-37,-19,0,1,1
13,-5,18,1,1,0
-43,-40,-3,0,1,1
-14,-25,11,1,0,1
25,8,17,1,0,1
28,24,4,1,0,1
-12,-20,8,1,0,1
42,39,3,1,0,1
-21,-29,8,1,0,1
28,22,6,1,0,1
23,26,-3,0,0,0
-45,-31,-14,0,0,0
32,25,7,1,0,1
-29,-43,14,1,0,1
-30,-30,0,0,0,0
48,36,12,1,0,1
-46,-28,-18,0,0,0
-40,-21,-19,0,0,0
19,1,18,1,0,1
18,10,8,1,0,1
7,12,-5,0,0,0
-9,-13,4,1,0,1
20,18,2,1,0,1
6,24,-18,0,0,0
36,39,-3,0,1,1
-37,-42,5,1,1,0
-20,-20,0,0,1,1
-8,-26,18,1,1,0
-19,-20,1,1,1,0
-31,-18,-13,0,1,1
8,1,7,1,1,0
29,12,17,1,1,0
-23,-9,-14,0,1,1
38,30,8,1,1,0
1,-8,9,1,1,0
-5,13,-18,0,1,1
50,36,14,1,1,0
-17,-11,-6,0,1,1
42,36,6,1,1,0
8,2,6,1,1,0
-7,-19,12,1,1,0
25,24,1,1,1,0
-23,-24,1,1,1,0
-4,0,-4,0,1,1
22,31,-9,0,1,1
42,37,5,1,0,1
48,29,19,1,0,1
9,10,-1,0,0,0
63,43,20,1,0,1
-42,-37,-5,0,0,0
-27,-25,-2,0,0,0
-20,-22,2,1,0,1
35,36,-1,0,0,0
23,15,8,1,0,1
-32,-43,11,1,0,1
-41,-33,-8,0,0,0
24,42,-18,0,0,0
-25,-18,-7,0,0,0
40,43,-3,0,1,1
-29,-36,7,1,1,0
-29,-41,12,1,1,0
-19,-28,9,1,1,0
-4,-2,-2,0,1,1
35,39,-4,0,1,1
11,11,0,0,1,1
64,44,20,1,1,0
-46,-33,-13,0,1,1
-33,-25,-8,0,1,1
23,40,-17,0,1,1
-43,-33,-10,0,0,0
-45,-36,-9,0,0,0
-29,-19,-10,0,0,0
30,24,6,1,0,1
16,12,4,1,0,1
3,1,2,1,0,1
0,7,-7,0,0,0
-13,-32,19,1,0,1
-4,-14,10,1,0,1
-21,-13,-8,0,0,0
23,25,-2,0,0,0
-9,-23,14,1,0,1
36,20,16,1,0,1
-11,5,-16,0,0,0
10,-7,17,1,0,1
33,43,-10,0,0,0
-5,-21,16,1,0,1
-36,-30,-6,0,0,0
-12,-30,18,1,0,1
-30,-39,9,1,0,1
-6,3,-9,0,0,0
-42,-32,-10,0,1,1
2,-3,5,1,1,0
16,30,-14,0,1,1
5,14,-9,0,1,1
-12,5,-17,0,1,1
-3,12,-15,0,1,1
31,31,0,0,1,1
-20,-16,-4,0,1,1
-6,-14,8,1,1,0
4,19,-15,0,1,1
8,10,-2,0,1,1
14,23,-9,0,1,1
-36,-33,-3,0,1,1
-9,-17,8,1,1,0
17,0,17,1,1,0
-25,-19,-6,0,1,1
56,38,18,1,1,0
-2,-10,8,1,1,0
11,25,-14,0,1,1
-18,-3,-15,0,1,1
-37,-23,-14,0,1,1
15,-1,16,1,0,1
-22,-26,4,1,0,1
-6,1,-7,0,0,0
-8,10,-18,0,0,0
42,42,0,0,0,0
-20,-2,-18,0,0,0
-28,-19,-9,0,0,0
-26,-6,-20,0,0,0
1,-3,4,1,0,1
3,16,-13,0,0,0
-47,-31,-16,0,0,0
46,38,8,1,0,1
7,22,-15,0,0,0
28,8,20,1,0,1
15,19,-4,0,1,1
17,23,-6,0,1,1
11,2,9,1,1,0
-12,6,-18,0,1,1
3,-13,16,1,1,0
-38,-33,-5,0,1,1
31,26,5,1,1,0
-22,-37,15,1,1,0
60,43,17,1,1,0
27,14,13,1,1,0
-16,-10,-6,0,1,1
37,43,-6,0,1,1
-17,-12,-5,0,1,1
-1,12,-13,0,0,0
-53,-41,-12,0,0,0
8,-5,13,1,0,1
-47,-34,-13,0,0,0
17,11,6,1,0,1
33,15,18,1,0,1
-25,-34,9,1,0,1
-60,-45,-15,0,0,0
-55,-43,-12,0,0,0
10,6,4,1,0,1
-25,-43,18,1,0,1
-6,9,-15,0,0,0
31,14,17,1,0,1
-22,-38,16,1,0,1
-26,-13,-13,0,0,0
-16,-25,9,1,0,1
34,33,1,1,0,1
-29,-33,4,1,0,1
-5,-21,16,1,0,1
14,10,4,1,0,1
-12,-10,-2,0,0,0
-6,7,-13,0,1,1
-20,-17,-3,0,1,1
8,-6,14,1,1,0
-13,-3,-10,0,1,1
-39,-29,-10,0,1,1
-2,-20,18,1,1,0
25,28,-3,0,1,1
-1,8,-9,0,1,1
33,24,9,1,1,0
43,23,20,1,0,1
40,29,11,1,0,1
44,43,1,1,0,1
-62,-43,-19,0,0,0
-35,-44,9,1,0,1
38,34,4,1,0,1
-16,-17,1,1,0,1
29,38,-9,0,0,0
23,27,-4,0,0,0
10,0,10,1,0,1
3,-14,17,1,0,1
-58,-44,-14,0,0,0
-16,-4,-12,0,0,0
-6,-21,15,1,0,1
-37,-40,3,1,0,1
8,1,7,1,0,1
15,-5,20,1,0,1
-14,-25,11,1,0,1
12,2,10,1,0,1
17,20,-3,0,0,0
9,12,-3,0,0,0
27,43,-16,0,1,1
1,18,-17,0,1,1
17,25,-8,0,1,1
1,9,-8,0,1,1
4,20,-16,0,1,1
-16,-18,2,1,1,0
20,16,4,1,1,0
-10,1,-11,0,1,1
-37,-41,4,1,0,1
5,-12,17,1,0,1
50,41,9,1,0,1
-5,-14,9,1,0,1
-32,-27,-5,0,0,0
39,28,11,1,0,1
-10,-10,0,0,0,0
-30,-42,12,1,0,1
-8,-27,19,1,0,1
7,22,-15,0,0,0
14,4,10,1,0,1
7,27,-20,0,0,0
10,21,-11,0,1,1
-5,1,-6,0,1,1
31,33,-2,0,1,1
41,28,13,1,1,0
13,14,-1,0,1,1
-3,-1,-2,0,1,1
-11,-9,-2,0,1,1
-9,3,-12,0,1,1
15,34,-19,0,1,1
-19,-8,-11,0,1,1
25,14,11,1,1,0
19,20,-1,0,1,1
-40,-26,-14,0,1,1
-5,-11,6,1,1,0
-43,-31,-12,0,1,1
-34,-21,-13,0,1,1
19,23,-4,0,1,1
30,40,-10,0,1,1
-21,-14,-7,0,1,1
29,21,8,1,1,0
2,16,-14,0,1,1
40,32,8,1,0,1
-3,10,-13,0,0,0
-30,-16,-14,0,0,0
-24,-14,-10,0,0,0
-4,7,-11,0,0,0
42,35,7,1,0,1
-34,-14,-20,0,0,0
41,37,4,1,0,1
-42,-31,-11,0,0,0
21,1,20,1,0,1
6,5,1,1,0,1
56,36,20,1,0,1
-1,7,-8,0,0,0
8,20,-12,0,0,0
29,10,19,1,0,1
-39,-44,5,1,0,1
-27,-37,10,1,0,1
-39,-41,2,1,0,1
8,12,-4,0,0,0
-28,-28,0,0,0,0
22,25,-3,0,0,0
17,10,7,1,1,0
-54,-34,-20,0,1,1
-36,-31,-5,0,1,1
-38,-40,2,1,1,0
-42,-41,-1,0,1,1
-4,-17,13,1,1,0
-41,-36,-5,0,1,1
-7,8,-15,0,1,1
-30,-20,-10,0,1,1
-36,-20,-16,0,1,1
-34,-26,-8,0,1,1
-34,-20,-14,0,1,1
21,9,12,1,1,0
30,42,-12,0,1,1
-50,-41,-9,0,1,1
-51,-36,-15,0,1,1
31,37,-6,0,1,1
12,16,-4,0,1,1
51,41,10,1,0,1
38,23,15,1,0,1
48,39,9,1,0,1
-16,-3,-13,0,0,0
15,34,-19,0,0,0
-42,-32,-10,0,0,0
-7,-1,-6,0,0,0
-50,-35,-15,0,0,0
-48,-35,-13,0,1,1
48,39,9,1,1,0
18,23,-5,0,1,1
13,5,8,1,1,0
-13,-28,15,1,1,0
17,10,7,1,1,0
42,32,10,1,1,0
-5,8,-13,0,1,1
9,-10,19,1,1,0
53,36,17,1,1,0
22,31,-9,0,1,1
-15,-27,12,1,1,0
-41,-32,-9,0,1,1
22,36,-14,0,1,1
-37,-42,5,1,1,0
18,-2,20,1,1,0
-4,-7,3,1,1,0
-19,-21,2,1,1,0
-48,-40,-8,0,1,1
40,23,17,1,1,0
-33,-34,1,1,1,0
-32,-22,-10,0,0,0
27,37,-10,0,0,0
37,36,1,1,0,1
23,13,10,1,0,1
-48,-37,-11,0,0,0
39,24,15,1,0,1
-12,-12,0,0,0,0
-11,-16,5,1,0,1
-23,-36,13,1,0,1
-14,-33,19,1,1,0
-39,-27,-12,0,1,1
12,12,0,0,1,1
18,19,-1,0,1,1
17,13,4,1,1,0
-11,-25,14,1,1,0
21,13,8,1,1,0
13,25,-12,0,1,1
-10,-30,20,1,1,0
-23,-43,20,1,1,0
23,14,9,1,1,0
-3,-5,2,1,1,0
-25,-34,9,1,1,0
-32,-37,5,1,1,0
-37,-44,7,1,1,0
-42,-31,-11,0,1,1
-62,-43,-19,0,1,1
-35,-27,-8,0,1,1
-39,-36,-3,0,1,1
-44,-42,-2,0,1,1
-24,-16,-8,0,0,0
-60,-42,-18,0,0,0
1,2,-1,0,0,0
42,34,8,1,0,1
-3,-3,0,0,0,0
34,30,4,1,0,1
41,31,10,1,0,1
33,41,-8,0,0,0
-33,-33,0,0,0,0
18,33,-15,0,0,0
-53,-36,-17,0,0,0
-32,-38,6,1,0,1
21,38,-17,0,1,1
-48,-29,-19,0,1,1
8,8,0,0,1,1
35,33,2,1,1,0
51,44,7,1,1,0
-56,-40,-16,0,1,1
46,32,14,1,1,0
-22,-2,-20,0,1,1
-7,2,-9,0,1,1
-25,-26,1,1,1,0
7,18,-11,0,1,1
-35,-37,2,1,1,0
20,37,-17,0,1,1
8,3,5,1,1,0
44,25,19,1,1,0
34,39,-5,0,1,1
27,32,-5,0,1,1
-50,-44,-6,0,1,1
52,41,11,1,1,0
11,10,1,1,1,0
48,32,16,1,1,0
48,33,15,1,0,1
-1,15,-16,0,0,0
45,35,10,1,0,1
-8,6,-14,0,0,0
13,13,0,0,0,0
54,38,16,1,0,1
49,41,8,1,0,1
0,3,-3,0,0,0
8,14,-6,0,0,0
-31,-44,13,1,1,0
-49,-31,-18,0,1,1
-1,16,-17,0,1,1
32,43,-11,0,1,1
19,36,-17,0,1,1
-5,15,-20,0,1,1
-42,-43,1,1,1,0
-33,-21,-12,0,1,1
-15,-18,3,1,1,0
51,35,16,1,1,0
5,25,-20,0,1,1
-40,-28,-12,0,0,0
-42,-43,1,1,0,1
-48,-36,-12,0,0,0
1,-16,17,1,0,1
-30,-23,-7,0,0,0
-27,-35,8,1,0,1
-8,12,-20,0,0,0
-43,-29,-14,0,0,0
23,30,-7,0,0,0
14,13,1,1,0,1
-45,-32,-13,0,0,0
9,-9,18,1,0,1
-42,-41,-1,0,0,0
9,0,9,1,0,1
47,28,19,1,0,1
20,35,-15,0,0,0
-28,-25,-3,0,1,1
-26,-42,16,1,1,0
22,25,-3,0,1,1
-29,-10,-19,0,1,1
33,31,2,1,1,0
22,34,-12,0,1,1
-47,-36,-11,0,1,1
24,34,-10,0,1,1
1,-9,10,1,0,1
22,22,0,0,0,0
15,10,5,1,0,1
-38,-33,-5,0,0,0
-22,-18,-4,0,0,0
61,44,17,1,0,1
38,36,2,1,0,1
17,4,13,1,0,1
-14,-2,-12,0,0,0
-54,-37,-17,0,0,0
0,4,-4,0,0,0
26,14,12,1,0,1
35,25,10,1,0,1
-12,2,-14,0,0,0
14,30,-16,0,0,0
2,4,-2,0,0,0
-14,-26,12,1,0,1
10,6,4,1,1,0
17,24,-7,0,1,1
-44,-32,-12,0,1,1
-10,-24,14,1,1,0
14,21,-7,0,1,1
-24,-28,4,1,1,0
36,39,-3,0,1,1
4,1,3,1,1,0
36,17,19,1,1,0
13,15,-2,0,1,1
42,34,8,1,1,0
7,17,-10,0,1,1
-26,-30,4,1,1,0
-23,-20,-3,0,1,1
-20,-17,-3,0,1,1
25,6,19,1,0,1
41,42,-1,0,0,0
-30,-29,-1,0,0,0
12,1,11,1,0,1
41,43,-2,0,0,0
-22,-20,-2,0,0,0
2,-12,14,1,0,1
13,22,-9,0,0,0
-17,-25,8,1,0,1
49,37,12,1,0,1
-53,-39,-14,0,0,0
-1,-19,18,1,1,0
-20,-40,20,1,1,0
23,31,-8,0,1,1
30,20,10,1,1,0
-4,-16,12,1,1,0
-7,2,-9,0,1,1
3,12,-9,0,1,1
-40,-23,-17,0,1,1
11,22,-11,0,1,1
7,-8,15,1,1,0
27,12,15,1,1,0
-2,17,-19,0,1,1
-26,-16,-10,0,1,1
-23,-33,10,1,1,0
-11,-28,17,1,1,0
21,37,-16,0,1,1
-18,-22,4,1,1,0
10,2,8,1,1,0
0,-3,3,1,1,0
-31,-20,-11,0,1,1
-2,9,-11,0,1,1
-16,-36,20,1,0,1
6,5,1,1,0,1
7,17,-10,0,0,0
-13,-16,3,1,0,1
19,6,13,1,0,1
-14,-26,12,1,0,1
-8,-21,13,1,0,1
-25,-11,-14,0,0,0
-14,-3,-11,0,0,0
-16,3,-19,0,0,0
-10,-30,20,1,0,1
-47,-39,-8,0,0,0
20,34,-14,0,0,0
-43,-33,-10,0,0,0
-9,-20,11,1,0,1
5,-5,10,1,0,1
59,41,18,1,1,0
2,1,1,1,1,0
-24,-34,10,1,1,0
22,26,-4,0,1,1
-32,-43,11,1,1,0
-4,11,-15,0,1,1
-4,-2,-2,0,1,1
14,23,-9,0,1,1
23,16,7,1,1,0
16,23,-7,0,0,0
-13,-28,15,1,0,1
-19,0,-19,0,0,0
49,30,19,1,0,1
37,44,-7,0,0,0
-1,18,-19,0,0,0
6,-12,18,1,0,1
22,13,9,1,0,1
-12,-19,7,1,0,1
-46,-41,-5,0,0,0
-6,-6,0,0,0,0
37,31,6,1,0,1
15,29,-14,0,0,0
20,1,19,1,0,1
26,10,16,1,0,1
-41,-42,1,1,0,1
13,-4,17,1,0,1
-23,-14,-9,0,0,0
-11,-5,-6,0,0,0
1,-9,10,1,0,1
-14,-24,10,1,0,1
6,7,-1,0,1,1
21,36,-15,0,1,1
-46,-32,-14,0,1,1
-25,-19,-6,0,1,1
-19,-15,-4,0,1,1
5,4,1,1,1,0
52,37,15,1,1,0
-47,-41,-6,0,1,1
-5,-9,4,1,1,0
-32,-39,7,1,1,0
0,-8,8,1,1,0
-24,-25,1,1,1,0
-28,-9,-19,0,1,1
12,17,-5,0,1,1
-8,8,-16,0,0,0
33,28,5,1,0,1
-53,-42,-11,0,0,0
14,6,8,1,0,1
9,-7,16,1,0,1
16,17,-1,0,0,0
-29,-28,-1,0,0,0
33,17,16,1,0,1
-17,-1,-16,0,0,0
48,35,13,1,0,1
-8,-20,12,1,0,1
18,10,8,1,1,0
-3,-23,20,1,1,0
-9,-29,20,1,1,0
12,5,7,1,1,0
18,34,-16,0,1,1
13,4,9,1,1,0
-7,2,-9,0,1,1
11,7,4,1,1,0
40,26,14,1,1,0
8,3,5,1,1,0
10,25,-15,0,1,1
-17,-4,-13,0,1,1
54,36,18,1,1,0
50,39,11,1,1,0
41,29,12,1,1,0
-52,-41,-11,0,1,1
23,14,9,1,1,0
6,-2,8,1,1,0
27,43,-16,0,1,1
-30,-32,2,1,1,0
-18,-13,-5,0,1,1
4,14,-10,0,0,0
-2,4,-6,0,0,0
19,4,15,1,0,1
36,41,-5,0,0,0
10,3,7,1,0,1
20,30,-10,0,0,0
-16,4,-20,0,0,0
28,11,17,1,0,1
24,20,4,1,0,1
-33,-45,12,1,0,1
16,32,-16,0,0,0
-4,-8,4,1,0,1
28,37,-9,0,0,0
-50,-41,-9,0,0,0
-12,-22,10,1,0,1
-21,-4,-17,0,0,0
-44,-44,0,0,0,0
5,22,-17,0,0,0
12,32,-20,0,0,0
41,24,17,1,0,1
-19,-23,4,1,0,1
-20,-21,1,1,1,0
-31,-37,6,1,1,0
37,35,2,1,1,0
-18,-22,4,1,1,0
35,31,4,1,1,0
24,9,15,1,1,0
-17,-27,10,1,1,0
-5,-7,2,1,1,0
7,-13,20,1,1,0
-55,-37,-18,0,1,1
-15,-18,3,1,0,1
-36,-16,-20,0,0,0
-53,-45,-8,0,0,0
24,43,-19,0,0,0
-43,-26,-17,0,0,0
-30,-44,14,1,0,1
-16,-32,16,1,0,1
44,30,14,1,0,1
-11,7,-18,0,1,1
24,15,9,1,1,0
-25,-24,-1,0,1,1
39,20,19,1,1,0
-41,-32,-9,0,1,1
26,7,19,1,1,0
4,2,2,1,1,0
-29,-36,7,1,1,0
53,33,20,1,1,0
6,-14,20,1,1,0
-7,-26,19,1,1,0
-13,7,-20,0,1,1
-9,-4,-5,0,1,1
-46,-31,-15,0,1,1
11,2,9,1,1,0
-3,-14,11,1,1,0
-20,-26,6,1,1,0
12,8,4,1,1,0
43,34,9,1,0,1
-43,-40,-3,0,0,0
34,40,-6,0,0,0
35,31,4,1,0,1
-4,-15,11,1,0,1
4,1,3,1,0,1
28,42,-14,0,0,0
31,25,6,1,0,1
38,42,-4,0,0,0
-5,1,-6,0,0,0
-27,-27,0,0,0,0
-37,-18,-19,0,0,0
-26,-34,8,1,0,1
-41,-35,-6,0,0,0
28,29,-1,0,0,0
-19,-7,-12,0,0,0
48,32,16,1,0,1
-41,-26,-15,0,0,0
63,44,19,1,0,1
3,-2,5,1,0,1
19,25,-6,0,0,0
-44,-43,-1,0,1,1
-16,-7,-9,0,1,1
17,23,-6,0,1,1
19,6,13,1,1,0
1,4,-3,0,1,1
-4,6,-10,0,1,1
48,41,7,1,1,0
-16,-18,2,1,1,0
-11,7,-18,0,1,1
-3,17,-20,0,1,1
-12,-26,14,1,1,0
-3,-3,0,0,1,1
29,34,-5,0,1,1
48,42,6,1,1,0
-30,-39,9,1,0,1
-2,-1,-1,0,0,0
7,9,-2,0,0,0
8,26,-18,0,0,0
-21,-28,7,1,0,1
-29,-18,-11,0,0,0
1,7,-6,0,0,0
-46,-27,-19,0,0,0
48,41,7,1,0,1
-13,-17,4,1,0,1
-1,-15,14,1,0,1
35,43,-8,0,0,0
11,8,3,1,0,1
-40,-24,-16,0,0,0
-2,17,-19,0,0,0
14,12,2,1,0,1
-16,-22,6,1,1,0
-4,-16,12,1,1,0
22,32,-10,0,1,1
6,5,1,1,1,0
36,21,15,1,1,0
-16,-1,-15,0,1,1
31,30,1,1,1,0
-35,-26,-9,0,1,1
-6,-22,16,1,1,0
8,-10,18,1,1,0
8,19,-11,0,1,1
-26,-42,16,1,1,0
7,-4,11,1,1,0
-58,-40,-18,0,1,1
11,23,-12,0,1,1
-42,-37,-5,0,1,1
-15,-33,18,1,1,0
16,10,6,1,1,0
-12,-29,17,1,0,1
-7,-1,-6,0,0,0
-29,-23,-6,0,0,0
41,40,1,1,0,1
-49,-34,-15,0,0,0
17,24,-7,0,0,0
-1,3,-4,0,0,0
-25,-20,-5,0,0,0
36,42,-6,0,0,0
32,25,7,1,0,1
17,25,-8,0,0,0
-49,-40,-9,0,0,0
8,26,-18,0,1,1
-7,-6,-1,0,1,1
-19,-36,17,1,1,0
34,14,20,1,1,0
16,18,-2,0,1,1
-22,-20,-2,0,1,1
-27,-38,11,1,1,0
-18,-35,17,1,1,0
18,5,13,1,1,0
-36,-21,-15,0,1,1
0,-13,13,1,1,0
5,15,-10,0,1,1
-7,-26,19,1,1,0
12,-4,16,1,1,0
-32,-42,10,1,1,0
27,26,1,1,1,0
36,16,20,1,1,0
-5,-2,-3,0,1,1
-6,4,-10,0,1,1
-42,-38,-4,0,1,1
16,7,9,1,1,0
-47,-40,-7,0,0,0
-3,15,-18,0,0,0
20,11,9,1,0,1
-42,-23,-19,0,0,0
17,28,-11,0,0,0
-12,-2,-10,0,0,0
37,41,-4,0,0,0
0,18,-18,0,0,0
7,8,-1,0,0,0
19,33,-14,0,0,0
-29,-9,-20,0,0,0
-38,-31,-7,0,0,0
26,17,9,1,0,1
-24,-37,13,1,0,1
15,28,-13,0,0,0
-57,-37,-20,0,1,1
-17,-5,-12,0,1,1
-19,-25,6,1,1,0
-28,-17,-11,0,1,1
-25,-21,-4,0,1,1
42,38,4,1,1,0
41,29,12,1,1,0
-56,-37,-19,0,1,1
-62,-45,-17,0,1,1
-6,9,-15,0,1,1
11,10,1,1,1,0
28,16,12,1,0,1
18,27,-9,0,0,0
-33,-31,-2,0,0,0
7,15,-8,0,0,0
6,7,-1,0,0,0
9,18,-9,0,0,0
-41,-36,-5,0,0,0
2,22,-20,0,0,0
34,28,6,1,0,1
-26,-39,13,1,0,1
31,11,20,1,0,1
11,25,-14,0,0,0
23,13,10,1,0,1
-25,-40,15,1,0,1
-28,-18,-10,0,0,0
-17,-20,3,1,0,1
22,41,-19,0,0,0
-9,-26,17,1,0,1
-48,-33,-15,0,0,0
-12,2,-14,0,1,1
15,-2,17,1,1,0
43,27,16,1,1,0
2,-17,19,1,1,0
-26,-40,14,1,1,0
-38,-41,3,1,1,0
-29,-33,4,1,1,0
-27,-30,3,1,1,0
-25,-34,9,1,1,0
-9,-18,9,1,1,0
-23,-40,17,1,1,0
-34,-36,2,1,0,1
-38,-23,-15,0,0,0
11,27,-16,0,0,0
21,12,9,1,0,1
-24,-21,-3,0,0,0
28,40,-12,0,0,0
-29,-24,-5,0,0,0
23,13,10,1,0,1
6,18,-12,0,1,1
-43,-45,2,1,1,0
8,9,-1,0,1,1
21,25,-4,0,1,1
-57,-39,-18,0,1,1
27,36,-9,0,1,1
-39,-40,1,1,1,0
-3,-23,20,1,1,0
-31,-29,-2,0,1,1
-27,-45,18,1,1,0
27,23,4,1,1,0
-18,-21,3,1,1,0
9,13,-4,0,1,1
9,-6,15,1,1,0
-38,-29,-9,0,1,1
29,24,5,1,0,1
10,2,8,1,0,1
-44,-25,-19,0,0,0
53,43,10,1,0,1
16,11,5,1,0,1
-12,-22,10,1,0,1
-3,-23,20,1,0,1
15,13,2,1,0,1
-24,-13,-11,0,0,0
43,28,15,1,0,1
31,30,1,1,0,1
-25,-45,20,1,0,1
31,13,18,1,0,1
9,7,2,1,0,1
22,41,-19,0,0,0
2,-10,12,1,1,0
25,34,-9,0,1,1
3,22,-19,0,1,1
8,-8,16,1,1,0
30,20,10,1,1,0
8,-3,11,1,1,0
-12,-26,14,1,1,0
-43,-43,0,0,1,1
13,9,4,1,1,0
-13,-33,20,1,1,0
-6,-3,-3,0,1,1
23,25,-2,0,1,1
-9,-17,8,1,1,0
-38,-20,-18,0,1,1
8,7,1,1,1,0
-9,7,-16,0,1,1
-18,-21,3,1,1,0
-3,15,-18,0,1,1
-11,-24,13,1,1,0
7,27,-20,0,1,1
27,11,16,1,1,0
13,9,4,1,0,1
-39,-20,-19,0,0,0
-22,-22,0,0,0,0
8,-12,20,1,0,1
17,7,10,1,0,1
30,17,13,1,0,1
29,17,12,1,0,1
37,21,16,1,0,1
-14,-10,-4,0,0,0
-4,-7,3,1,0,1
-37,-17,-20,0,1,1
48,28,20,1,1,0
47,35,12,1,1,0
-3,-7,4,1,1,0
-25,-35,10,1,1,0
-29,-38,9,1,1,0
12,24,-12,0,1,1
-42,-33,-9,0,1,1
-57,-43,-14,0,1,1
14,-6,20,1,1,0
-37,-38,1,1,1,0
-30,-37,7,1,1,0
15,20,-5,0,1,1
-48,-43,-5,0,1,1
-9,-20,11,1,1,0
-29,-28,-1,0,1,1
30,38,-8,0,1,1
50,42,8,1,0,1
-38,-32,-6,0,0,0
22,19,3,1,0,1
-20,-21,1,1,0,1
23,15,8,1,0,1
17,23,-6,0,0,0
-28,-17,-11,0,0,0
28,31,-3,0,0,0
-34,-34,0,0,0,0
10,3,7,1,0,1
-38,-18,-20,0,0,0
-41,-33,-8,0,0,0
17,30,-13,0,0,0
-17,-25,8,1,0,1
42,34,8,1,0,1
30,22,8,1,0,1
26,34,-8,0,0,0
-16,-5,-11,0,0,0
38,37,1,1,0,1
51,39,12,1,0,1
-3,11,-14,0,0,0
36,33,3,1,1,0
-32,-18,-14,0,1,1
-8,-19,11,1,1,0
16,19,-3,0,1,1
-29,-45,16,1,1,0
22,23,-1,0,1,1
-2,8,-10,0,1,1
-1,-16,15,1,1,0
-21,-39,18,1,1,0
26,42,-16,0,1,1
-6,-26,20,1,1,0
-25,-39,14,1,1,0
39,43,-4,0,1,1
1,-5,6,1,1,0
-36,-26,-10,0,1,1
9,5,4,1,1,0
10,-4,14,1,1,0
-55,-37,-18,0,1,1
-30,-22,-8,0,0,0
-26,-24,-2,0,0,0
-34,-18,-16,0,0,0
-20,-25,5,1,0,1
18,3,15,1,0,1
-7,-9,2,1,0,1
-28,-14,-14,0,0,0
-52,-33,-19,0,0,0
15,12,3,1,0,1
60,42,18,1,0,1
40,33,7,1,0,1
28,32,-4,0,0,0
30,38,-8,0,0,0
4,21,-17,0,0,0
-24,-38,14,1,0,1
-45,-40,-5,0,0,0
-30,-30,0,0,0,0
17,30,-13,0,0,0
10,-9,19,1,0,1
18,7,11,1,0,1
7,18,-11,0,0,0
-50,-44,-6,0,1,1
45,39,6,1,1,0
-18,-33,15,1,1,0
29,25,4,1,1,0
-49,-41,-8,0,1,1
-41,-43,2,1,1,0
-29,-41,12,1,1,0
-59,-45,-14,0,1,1
14,27,-13,0,1,1
18,36,-18,0,1,1
15,-2,17,1,1,0
44,27,17,1,1,0
7,2,5,1,1,0
-32,-26,-6,0,1,1
12,29,-17,0,1,1
25,8,17,1,1,0
-62,-44,-18,0,1,1
2,16,-14,0,1,1
29,30,-1,0,1,1
49,44,5,1,1,0
-41,-40,-1,0,0,0
21,33,-12,0,0,0
5,17,-12,0,0,0
-20,-29,9,1,0,1
-38,-30,-8,0,0,0
-23,-42,19,1,0,1
-30,-21,-9,0,0,0
53,38,15,1,0,1
48,36,12,1,0,1
6,17,-11,0,0,0
7,-11,18,1,0,1
-13,-29,16,1,0,1
-17,0,-17,0,0,0
-36,-45,9,1,0,1
45,32,13,1,0,1
50,39,11,1,0,1
-45,-33,-12,0,0,0
23,24,-1,0,0,0
-28,-26,-2,0,0,0
-24,-37,13,1,0,1
2,19,-17,0,1,1
-40,-25,-15,0,1,1
22,38,-16,0,1,1
-33,-17,-16,0,1,1
-39,-34,-5,0,1,1
-18,-30,12,1,1,0
22,30,-8,0,1,1
9,-9,18,1,1,0
38,34,4,1,1,0
10,-5,15,1,1,0
33,29,4,1,1,0
-24,-10,-14,0,1,1
18,26,-8,0,1,1
-41,-22,-19,0,1,1
4,21,-17,0,1,1
51,44,7,1,1,0
28,19,9,1,0,1
-24,-6,-18,0,0,0
-3,9,-12,0,0,0
53,36,17,1,0,1
19,26,-7,0,0,0
14,11,3,1,0,1
35,25,10,1,0,1
40,44,-4,0,0,0
2,21,-19,0,0,0
10,18,-8,0,0,0
16,28,-12,0,0,0
42,42,0,0,0,0
40,30,10,1,0,1
11,30,-19,0,0,0
3,13,-10,0,1,1
35,40,-5,0,1,1
31,18,13,1,1,0
-8,5,-13,0,1,1
34,42,-8,0,1,1
14,-2,16,1,1,0
7,8,-1,0,1,1
49,32,17,1,1,0
-57,-40,-17,0,1,1
6,11,-5,0,1,1
11,23,-12,0,1,1
-2,-19,17,1,1,0
17,22,-5,0,1,1
13,-6,19,1,1,0
2,16,-14,0,0,0
24,8,16,1,0,1
-28,-9,-19,0,0,0
-31,-29,-2,0,0,0
35,16,19,1,0,1
-27,-23,-4,0,0,0
32,40,-8,0,0,0
36,44,-8,0,0,0
15,21,-6,0,0,0
25,36,-11,0,0,0
-5,-15,10,1,0,1
24,33,-9,0,0,0
31,34,-3,0,0,0
-37,-25,-12,0,0,0
16,10,6,1,0,1
-27,-12,-15,0,0,0
17,27,-10,0,1,1
6,-2,8,1,1,0
-30,-45,15,1,1,0
23,7,16,1,1,0
-5,-7,2,1,1,0
-19,-23,4,1,1,0
22,5,17,1,1,0
1,-13,14,1,1,0
-7,-20,13,1,1,0
17,21,-4,0,1,1
-32,-45,13,1,0,1
20,0,20,1,0,1
41,44,-3,0,0,0
-38,-33,-5,0,0,0
-18,-32,14,1,0,1
24,42,-18,0,0,0
12,-5,17,1,0,1
-2,-13,11,1,0,1
57,44,13,1,0,1
54,35,19,1,0,1
5,20,-15,0,0,0
-34,-31,-3,0,0,0
6,2,4,1,0,1
13,31,-18,0,1,1
-20,-20,0,0,1,1
8,10,-2,0,1,1
-52,-45,-7,0,1,1
-15,-22,7,1,1,0
4,-16,20,1,1,0
17,17,0,0,1,1
17,15,2,1,1,0
11,4,7,1,1,0
-48,-29,-19,0,1,1
-28,-29,1,1,1,0
16,28,-12,0,1,1
-36,-37,1,1,1,0
-19,-24,5,1,1,0
17,29,-12,0,1,1
10,-4,14,1,1,0
-40,-29,-11,0,0,0
6,-11,17,1,0,1
24,8,16,1,0,1
-17,2,-19,0,0,0
44,36,8,1,0,1
5,20,-15,0,0,0
2,-5,7,1,0,1
41,35,6,1,0,1
28,13,15,1,0,1
-19,-23,4,1,0,1
57,40,17,1,0,1
-10,-4,-6,0,0,0
-37,-25,-12,0,0,0
-3,-6,3,1,0,1
-42,-33,-9,0,0,0
-36,-19,-17,0,0,0
35,25,10,1,0,1
-31,-40,9,1,0,1
11,0,11,1,0,1
13,13,0,0,0,0
-4,7,-11,0,0,0
26,26,0,0,1,1
-18,-21,3,1,1,0
27,33,-6,0,1,1
31,12,19,1,1,0
-13,1,-14,0,1,1
52,43,9,1,1,0
-14,-9,-5,0,1,1
-16,-10,-6,0,1,1
-42,-37,-5,0,0,0
36,40,-4,0,0,0
-14,-15,1,1,0,1
-4,-21,17,1,0,1
-14,-12,-2,0,0,0
17,30,-13,0,0,0
42,41,1,1,0,1
-3,13,-16,0,0,0
-6,-3,-3,0,0,0
-57,-44,-13,0,0,0
35,36,-1,0,1,1
38,18,20,1,1,0
30,28,2,1,1,0
13,3,10,1,1,0
25,38,-13,0,1,1
25,17,8,1,1,0
5,5,0,0,1,1
17,20,-3,0,1,1
23,11,12,1,1,0
1,7,-6,0,1,1
9,22,-13,0,1,1
-18,-38,20,1,1,0
0,15,-15,0,1,1
-17,-1,-16,0,1,1
38,44,-6,0,1,1
-49,-37,-12,0,1,1
-4,-22,18,1,1,0
16,23,-7,0,1,1
-33,-42,9,1,0,1
23,35,-12,0,0,0
20,13,7,1,0,1
7,-6,13,1,0,1
45,26,19,1,0,1
29,37,-8,0,0,0
-30,-15,-15,0,0,0
15,14,1,1,0,1
54,41,13,1,0,1
38,24,14,1,0,1
-60,-42,-18,0,0,0
-38,-30,-8,0,0,0
-9,-10,1,1,0,1
-28,-37,9,1,0,1
-58,-38,-20,0,0,0
6,9,-3,0,1,1
-7,-25,18,1,1,0
-12,-22,10,1,1,0
-11,8,-19,0,1,1
-4,-1,-3,0,1,1
7,-9,16,1,1,0
15,28,-13,0,1,1
-4,-18,14,1,1,0
23,10,13,1,1,0
5,16,-11,0,1,1
-19,-1,-18,0,0,0
38,18,20,1,0,1
-3,-4,1,1,0,1
12,18,-6,0,0,0
1,0,1,1,0,1
35,25,10,1,0,1
-14,-11,-3,0,0,0
-55,-38,-17,0,0,0
1,-14,15,1,0,1
47,39,8,1,0,1
-1,0,-1,0,0,0
-28,-38,10,1,0,1
7,2,5,1,0,1
26,14,12,1,0,1
51,43,8,1,0,1
-36,-23,-13,0,0,0
-26,-26,0,0,0,0
-3,3,-6,0,0,0
15,21,-6,0,0,0
26,39,-13,0,0,0
27,37,-10,0,0,0
-20,-29,9,1,1,0
-39,-34,-5,0,1,1
30,38,-8,0,1,1
24,41,-17,0,1,1
2,-12,14,1,1,0
4,2,2,1,1,0
-19,-14,-5,0,1,1
-43,-28,-15,0,1,1
28,26,2,1,1,0
2,3,-1,0,1,1
-6,14,-20,0,1,1
-25,-27,2,1,0,1
2,16,-14,0,0,0
19,13,6,1,0,1
-37,-34,-3,0,0,0
-34,-30,-4,0,0,0
6,10,-4,0,0,0
-26,-30,4,1,0,1
-2,17,-19,0,0,0
-9,-1,-8,0,0,0
13,22,-9,0,0,0
-9,-7,-2,0,0,0
-14,-12,-2,0,0,0
-31,-45,14,1,1,0
43,29,14,1,1,0
-47,-41,-6,0,1,1
-22,-17,-5,0,1,1
19,15,4,1,1,0
8,-5,13,1,1,0
-58,-41,-17,0,1,1
49,37,12,1,1,0
18,23,-5,0,1,1
6,-3,9,1,1,0
-9,-9,0,0,1,1
-36,-41,5,1,1,0
50,37,13,1,1,0
21,3,18,1,1,0
15,28,-13,0,1,1
16,13,3,1,0,1
-9,-1,-8,0,0,0
-19,-17,-2,0,0,0
20,20,0,0,0,0
-32,-21,-11,0,0,0
-9,7,-16,0,0,0
6,25,-19,0,0,0
-33,-45,12,1,0,1
-23,-30,7,1,0,1
8,0,8,1,0,1
-11,-8,-3,0,0,0
1,-18,19,1,0,1
18,37,-19,0,0,0
34,27,7,1,0,1
12,16,-4,0,1,1
-8,-12,4,1,1,0
13,32,-19,0,1,1
13,-5,18,1,1,0
45,40,5,1,1,0
20,5,15,1,1,0
-34,-14,-20,0,1,1
-37,-39,2,1,1,0
27,36,-9,0,1,1
30,11,19,1,1,0
-26,-44,18,1,1,0
11,-9,20,1,0,1
-25,-8,-17,0,0,0
9,6,3,1,0,1
44,42,2,1,0,1
-19,-33,14,1,0,1
14,20,-6,0,0,0
60,40,20,1,0,1
-29,-17,-12,0,0,0
55,36,19,1,1,0
21,8,13,1,1,0
29,35,-6,0,1,1
43,26,17,1,1,0
-14,-1,-13,0,1,1
27,29,-2,0,1,1
12,-6,18,1,1,0
-27,-9,-18,0,1,1
52,36,16,1,1,0
39,40,-1,0,1,1
-29,-33,4,1,1,0
16,6,10,1,0,1
-9,-9,0,0,0,0
55,43,12,1,0,1
15,13,2,1,0,1
32,40,-8,0,0,0
-35,-36,1,1,0,1
41,28,13,1,0,1
-10,-8,-2,0,0,0
54,44,10,1,0,1
-15,-15,0,0,0,0
16,13,3,1,0,1
43,39,4,1,0,1
17,33,-16,0,0,0
-26,-40,14,1,0,1
-33,-23,-10,0,0,0
34,21,13,1,0,1
-23,-9,-14,0,0,0
23,14,9,1,1,0
29,22,7,1,1,0
-26,-45,19,1,1,0
-5,-7,2,1,1,0
3,2,1,1,1,0
-16,-16,0,0,1,1
-30,-13,-17,0,1,1
37,37,0,0,1,1
39,26,13,1,1,0
-5,8,-13,0,1,1
-12,-26,14,1,1,0
22,40,-18,0,1,1
-6,-9,3,1,1,0
-30,-20,-10,0,1,1
-34,-38,4,1,1,0
-30,-37,7,1,1,0
-41,-34,-7,0,1,1
-40,-21,-19,0,1,1
39,35,4,1,1,0
-11,3,-14,0,1,1
12,0,12,1,1,0
41,40,1,1,0,1
0,15,-15,0,0,0
22,18,4,1,0,1
-16,3,-19,0,0,0
25,35,-10,0,0,0
-31,-14,-17,0,0,0
-9,1,-10,0,0,0
-49,-41,-8,0,0,0
5,20,-15,0,0,0
-36,-35,-1,0,0,0
-23,-22,-1,0,0,0
-4,-8,4,1,0,1
-18,-4,-14,0,0,0
17,1,16,1,0,1
1,-1,2,1,0,1
-2,12,-14,0,0,0
-22,-10,-12,0,0,0
-1,-10,9,1,0,1
49,32,17,1,1,0
-32,-15,-17,0,1,1
13,1,12,1,1,0
35,27,8,1,1,0
28,20,8,1,1,0
16,11,5,1,1,0
13,-5,18,1,1,0
5,17,-12,0,1,1
-5,-10,5,1,1,0
-2,4,-6,0,0,0
12,13,-1,0,0,0
45,37,8,1,0,1
-17,-4,-13,0,0,0
-51,-42,-9,0,0,0
-26,-6,-20,0,0,0
-1,-17,16,1,0,1
-58,-45,-13,0,0,0
-27,-27,0,0,0,0
30,23,7,1,0,1
-41,-43,2,1,0,1
38,34,4,1,1,0
-45,-41,-4,0,1,1
-21,-30,9,1,1,0
16,35,-19,0,1,1
-21,-25,4,1,1,0
25,41,-16,0,1,1
25,30,-5,0,1,1
-7,-27,20,1,1,0
-14,-22,8,1,1,0
-25,-41,16,1,1,0
-6,-22,16,1,1,0
-13,-30,17,1,1,0
31,12,19,1,1,0
-49,-38,-11,0,1,1
-18,-35,17,1,1,0
-30,-14,-16,0,1,1
-17,-32,15,1,1,0
-33,-42,9,1,1,0
12,19,-7,0,0,0
-36,-42,6,1,0,1
32,41,-9,0,0,0
-5,9,-14,0,0,0
55,39,16,1,0,1
12,28,-16,0,0,0
-50,-38,-12,0,0,0
-32,-37,5,1,0,1
-20,-4,-16,0,1,1
-2,-11,9,1,1,0
14,4,10,1,1,0
14,-4,18,1,1,0
-47,-35,-12,0,1,1
14,-1,15,1,1,0
-49,-45,-4,0,1,1
-34,-37,3,1,1,0
-17,-19,2,1,1,0
1,-14,15,1,1,0
-29,-25,-4,0,0,0
-44,-34,-10,0,0,0
21,29,-8,0,0,0
10,15,-5,0,0,0
-28,-11,-17,0,0,0
-4,-3,-1,0,0,0
-24,-31,7,1,0,1
-8,-28,20,1,0,1
-11,-1,-10,0,0,0
-16,-11,-5,0,0,0
-46,-35,-11,0,0,0
1,11,-10,0,0,0
-47,-42,-5,0,0,0
-47,-43,-4,0,0,0
38,24,14,1,0,1
60,43,17,1,0,1
22,4,18,1,0,1
0,-3,3,1,0,1
-35,-15,-20,0,0,0
41,34,7,1,0,1
-40,-37,-3,0,0,0
17,25,-8,0,1,1
-10,-16,6,1,1,0
-13,-12,-1,0,1,1
21,26,-5,0,1,1
-48,-44,-4,0,1,1
19,39,-20,0,1,1
4,-4,8,1,1,0
19,11,8,1,1,0
-37,-24,-13,0,1,1
-23,-26,3,1,1,0
-15,5,-20,0,1,1
-3,-22,19,1,1,0
25,44,-19,0,1,1
20,20,0,0,1,1
-52,-32,-20,0,1,1
-15,-29,14,1,1,0
-35,-23,-12,0,1,1
2,21,-19,0,1,1
35,27,8,1,1,0
25,19,6,1,1,0
-48,-40,-8,0,1,1
14,23,-9,0,0,0
-24,-4,-20,0,0,0
0,6,-6,0,0,0
22,9,13,1,0,1
-26,-44,18,1,0,1
-56,-45,-11,0,0,0
49,29,20,1,0,1
12,-3,15,1,0,1
45,28,17,1,0,1
-36,-41,5,1,0,1
10,-10,20,1,1,0
17,14,3,1,1,0
15,0,15,1,1,0
35,32,3,1,1,0
-57,-39,-18,0,1,1
-31,-21,-10,0,1,1
28,28,0,0,1,1
45,34,11,1,1,0
4,16,-12,0,1,1
11,14,-3,0,1,1
-20,-7,-13,0,1,1
34,14,20,1,1,0
-16,-14,-2,0,1,1
-61,-44,-17,0,1,1
18,32,-14,0,1,1
41,40,1,1,1,0
21,41,-20,0,1,1
27,31,-4,0,1,1
41,30,11,1,1,0
-35,-26,-9,0,1,1
47,30,17,1,1,0
7,1,6,1,0,1
10,-4,14,1,0,1
-28,-45,17,1,0,1
-19,-7,-12,0,0,0
-15,-15,0,0,0,0
-13,-28,15,1,0,1
-57,-39,-18,0,0,0
47,35,12,1,0,1
-14,-31,17,1,0,1
13,17,-4,0,0,0
-28,-8,-20,0,0,0
-28,-31,3,1,0,1
-29,-42,13,1,0,1
-14,-27,13,1,0,1
-65,-45,-20,0,0,0
-9,-22,13,1,1,0
-27,-39,12,1,1,0
22,39,-17,0,1,1
16,-3,19,1,1,0
-17,-27,10,1,1,0
44,35,9,1,1,0
-19,-32,13,1,1,0
-2,13,-15,0,1,1
2,-3,5,1,1,0
40,32,8,1,1,0
36,24,12,1,1,0
23,7,16,1,1,0
-38,-24,-14,0,1,1
18,3,15,1,1,0
-29,-18,-11,0,1,1
-38,-21,-17,0,1,1
-31,-16,-15,0,1,1
25,33,-8,0,1,1
-12,-9,-3,0,1,1
20,18,2,1,1,0
23,40,-17,0,1,1
29,24,5,1,0,1
7,-13,20,1,0,1
-24,-27,3,1,0,1
1,-3,4,1,0,1
7,26,-19,0,0,0
26,24,2,1,0,1
-1,-2,1,1,0,1
-8,9,-17,0,0,0
-8,-22,14,1,0,1
41,33,8,1,0,1
25,19,6,1,0,1
-65,-45,-20,0,0,0
-37,-29,-8,0,0,0
-1,-13,12,1,0,1
-24,-40,16,1,0,1
9,-10,19,1,0,1
-42,-38,-4,0,0,0
-15,-21,6,1,1,0
21,24,-3,0,1,1
9,-4,13,1,1,0
26,43,-17,0,1,1
-16,-21,5,1,1,0
-5,-23,18,1,1,0
-44,-45,1,1,1,0
11,20,-9,0,1,1
-37,-45,8,1,1,0
-46,-34,-12,0,1,1
-38,-29,-9,0,1,1
-27,-8,-19,0,1,1
31,34,-3,0,0,0
29,42,-13,0,0,0
-23,-42,19,1,0,1
-33,-15,-18,0,0,0
-24,-6,-18,0,0,0
-10,-19,9,1,0,1
-1,17,-18,0,0,0
-47,-37,-10,0,0,0
-16,-32,16,1,1,0
-4,3,-7,0,1,1
3,-9,12,1,1,0
-41,-41,0,0,1,1
5,25,-20,0,1,1
23,42,-19,0,1,1
-29,-16,-13,0,1,1
49,44,5,1,1,0
-8,-14,6,1,1,0
3,-9,12,1,1,0
-8,7,-15,0,1,1
28,21,7,1,1,0
-34,-26,-8,0,1,1
-7,-21,14,1,1,0
-53,-37,-16,0,1,1
-2,5,-7,0,1,1
19,12,7,1,1,0
7,-9,16,1,1,0
-38,-21,-17,0,1,1
-44,-43,-1,0,1,1
-6,0,-6,0,1,1
23,12,11,1,0,1
-28,-29,1,1,0,1
-6,-14,8,1,0,1
-64,-44,-20,0,0,0
19,21,-2,0,0,0
-49,-29,-20,0,0,0
25,6,19,1,0,1
43,27,16,1,0,1
-36,-16,-20,0,0,0
-18,-16,-2,0,0,0
8,-1,9,1,0,1
25,36,-11,0,0,0
-6,4,-10,0,0,0
-6,11,-17,0,1,1
-18,-31,13,1,1,0
-2,3,-5,0,1,1
1,-11,12,1,1,0
8,0,8,1,1,0
2,-13,15,1,1,0
40,34,6,1,1,0
2,-11,13,1,1,0
14,18,-4,0,0,0
-34,-27,-7,0,0,0
15,4,11,1,0,1
34,20,14,1,0,1
41,26,15,1,0,1
41,38,3,1,0,1
51,36,15,1,0,1
-11,-15,4,1,0,1
-11,0,-11,0,0,0
-25,-41,16,1,0,1
-22,-31,9,1,1,0
17,18,-1,0,1,1
-14,-7,-7,0,1,1
45,26,19,1,1,0
22,32,-10,0,1,1
-3,10,-13,0,1,1
28,30,-2,0,1,1
-34,-31,-3,0,1,1
29,22,7,1,1,0
-15,-6,-9,0,1,1
16,36,-20,0,1,1
21,2,19,1,1,0
17,37,-20,0,1,1
17,-1,18,1,1,0
13,33,-20,0,1,1
2,-12,14,1,1,0
28,38,-10,0,1,1
-45,-28,-17,0,1,1
-2,10,-12,0,0,0
0,6,-6,0,0,0
24,36,-12,0,0,0
-5,-16,11,1,0,1
-4,1,-5,0,0,0
-4,-23,19,1,0,1
41,40,1,1,0,1
29,31,-2,0,0,0
-6,13,-19,0,0,0
-58,-42,-16,0,0,0
-55,-37,-18,0,1,1
1,13,-12,0,1,1
15,-4,19,1,1,0
-47,-34,-13,0,1,1
-46,-38,-8,0,1,1
24,43,-19,0,1,1
-30,-20,-10,0,1,1
-15,-13,-2,0,1,1
-42,-26,-16,0,1,1
26,28,-2,0,1,1
28,8,20,1,0,1
43,27,16,1,0,1
5,4,1,1,0,1
-3,-1,-2,0,0,0
47,36,11,1,0,1
-51,-33,-18,0,0,0
43,31,12,1,0,1
42,24,18,1,0,1
-47,-39,-8,0,0,0
-17,-32,15,1,0,1
18,-2,20,1,0,1
12,-4,16,1,0,1
13,20,-7,0,0,0
3,-8,11,1,0,1
-26,-8,-18,0,0,0
31,14,17,1,0,1
-13,-21,8,1,0,1
-40,-28,-12,0,0,0
23,6,17,1,0,1
18,28,-10,0,0,0
-14,-7,-7,0,0,0
36,37,-1,0,1,1
1,18,-17,0,1,1
-11,-26,15,1,1,0
52,44,8,1,1,0
-5,-4,-1,0,1,1
-5,0,-5,0,1,1
23,43,-20,0,1,1
31,11,20,1,1,0
-37,-38,1,1,0,1
7,5,2,1,0,1
-30,-13,-17,0,0,0
-42,-32,-10,0,0,0
-34,-27,-7,0,0,0
-27,-42,15,1,0,1
34,15,19,1,0,1
15,2,13,1,0,1
-1,2,-3,0,0,0
53,41,12,1,0,1
28,25,3,1,0,1
-43,-44,1,1,0,1
24,31,-7,0,0,0
32,17,15,1,0,1
-18,-6,-12,0,0,0
9,15,-6,0,0,0
-3,-7,4,1,0,1
8,-2,10,1,0,1
-28,-25,-3,0,0,0
-26,-25,-1,0,1,1
-41,-22,-19,0,1,1
45,34,11,1,1,0
47,41,6,1,1,0
-2,-17,15,1,1,0
-51,-38,-13,0,1,1
-6,6,-12,0,1,1
7,4,3,1,1,0
25,18,7,1,1,0
-3,-4,1,1,1,0
55,43,12,1,1,0
4,1,3,1,1,0
-14,-16,2,1,1,0
-36,-33,-3,0,0,0
26,6,20,1,0,1
16,15,1,1,0,1
28,25,3,1,0,1
17,34,-17,0,0,0
-16,-4,-12,0,0,0
-3,3,-6,0,0,0
-37,-42,5,1,0,1
12,4,8,1,0,1
-51,-40,-11,0,1,1
7,23,-16,0,1,1
2,4,-2,0,1,1
2,0,2,1,1,0
-25,-22,-3,0,1,1
20,14,6,1,1,0
-16,4,-20,0,1,1
11,3,8,1,1,0
-6,-3,-3,0,1,1
27,28,-1,0,1,1
-18,-20,2,1,1,0
-36,-25,-11,0,1,1
-14,-6,-8,0,1,1
1,-11,12,1,1,0
29,32,-3,0,1,1
4,24,-20,0,1,1
11,27,-16,0,1,1
6,1,5,1,1,0
36,34,2,1,1,0
-33,-30,-3,0,1,1
-23,-3,-20,0,0,0
-9,-1,-8,0,0,0
-17,-16,-1,0,0,0
-20,-18,-2,0,0,0
-21,-38,17,1,0,1
16,36,-20,0,0,0
37,38,-1,0,0,0
-9,10,-19,0,0,0
-20,-27,7,1,0,1
-15,-17,2,1,0,1
-2,-5,3,1,0,1
13,0,13,1,1,0
-37,-18,-19,0,1,1
42,38,4,1,1,0
8,8,0,0,1,1
34,43,-9,0,1,1
17,37,-20,0,1,1
-38,-45,7,1,1,0
42,39,3,1,1,0
38,18,20,1,1,0
30,10,20,1,0,1
-11,9,-20,0,0,0
-44,-38,-6,0,0,0
-13,-32,19,1,0,1
-13,-8,-5,0,0,0
-38,-31,-7,0,0,0
-11,-28,17,1,0,1
30,30,0,0,0,0
-36,-16,-20,0,1,1
-56,-45,-11,0,1,1
27,24,3,1,1,0
38,37,1,1,1,0
-5,-2,-3,0,1,1
-49,-45,-4,0,1,1
-28,-29,1,1,1,0
-12,5,-17,0,1,1
-16,-30,14,1,1,0
-8,-8,0,0,1,1
0,1,-1,0,1,1
-18,-35,17,1,1,0
-30,-25,-5,0,1,1
-4,-22,18,1,1,0
36,28,8,1,1,0
-43,-40,-3,0,1,1
2,18,-16,0,1,1
-12,-9,-3,0,1,1
42,35,7,1,1,0
-16,-7,-9,0,0,0
-18,-17,-1,0,0,0
-7,-6,-1,0,0,0
-8,-24,16,1,0,1
-19,-14,-5,0,0,0
33,24,9,1,0,1
7,4,3,1,0,1
30,14,16,1,0,1
30,10,20,1,0,1
-14,-18,4,1,0,1
-51,-43,-8,0,0,0
-34,-26,-8,0,0,0
-4,-17,13,1,0,1
-40,-37,-3,0,0,0
54,42,12,1,0,1
33,32,1,1,1,0
12,8,4,1,1,0
-12,-2,-10,0,1,1
0,4,-4,0,1,1
58,41,17,1,1,0
-5,10,-15,0,1,1
-15,-10,-5,0,1,1
18,20,-2,0,1,1
-44,-42,-2,0,0,0
12,32,-20,0,0,0
20,7,13,1,0,1
8,-7,15,1,0,1
-44,-24,-20,0,0,0
-22,-12,-10,0,0,0
37,25,12,1,0,1
-32,-22,-10,0,0,0
-23,-5,-18,0,0,0
29,34,-5,0,0,0
-20,-38,18,1,0,1
-3,17,-20,0,0,0
0,6,-6,0,0,0
23,25,-2,0,0,0
53,39,14,1,0,1
-16,-3,-13,0,1,1
-49,-42,-7,0,1,1
16,30,-14,0,1,1
18,22,-4,0,1,1
43,27,16,1,1,0
3,4,-1,0,1,1
7,24,-17,0,1,1
22,30,-8,0,1,1
-18,-6,-12,0,1,1
22,38,-16,0,1,1
-18,-8,-10,0,1,1
52,32,20,1,0,1
-33,-39,6,1,0,1
-28,-14,-14,0,0,0
-4,-3,-1,0,0,0
-40,-36,-4,0,0,0
30,24,6,1,0,1
6,26,-20,0,0,0
27,14,13,1,0,1
-8,-20,12,1,0,1
-42,-28,-14,0,0,0
-25,-19,-6,0,0,0
2,-10,12,1,0,1
-11,-13,2,1,0,1
-43,-37,-6,0,0,0
-22,-40,18,1,1,0
61,44,17,1,1,0
-40,-27,-13,0,1,1
-8,9,-17,0,1,1
15,15,0,0,1,1
38,40,-2,0,1,1
-37,-25,-12,0,1,1
-14,-34,20,1,1,0
-12,6,-18,0,1,1
-16,1,-17,0,1,1
18,7,11,1,1,0
-22,-25,3,1,1,0
-37,-27,-10,0,1,1
-21,-27,6,1,0,1
22,28,-6,0,0,0
32,23,9,1,0,1
-37,-31,-6,0,0,0
4,15,-11,0,0,0
-12,-16,4,1,0,1
30,44,-14,0,0,0
-58,-38,-20,0,0,0
-18,-20,2,1,0,1
39,26,13,1,0,1
52,42,10,1,0,1
-56,-44,-12,0,0,0
23,3,20,1,0,1
30,42,-12,0,0,0
-42,-34,-8,0,0,0
-13,-11,-2,0,1,1
-41,-22,-19,0,1,1
-30,-22,-8,0,1,1
28,30,-2,0,1,1
44,36,8,1,1,0
-3,-3,0,0,1,1
-17,-13,-4,0,1,1
-7,-15,8,1,1,0
-12,-28,16,1,1,0
-27,-17,-10,0,1,1
-24,-4,-20,0,1,1
53,44,9,1,1,0
-32,-18,-14,0,1,1
9,17,-8,0,0,0
12,19,-7,0,0,0
-27,-19,-8,0,0,0
10,18,-8,0,0,0
3,18,-15,0,0,0
30,12,18,1,0,1
-17,-15,-2,0,0,0
-34,-42,8,1,0,1
-27,-42,15,1,0,1
40,30,10,1,0,1
30,26,4,1,0,1
-35,-19,-16,0,0,0
2,4,-2,0,0,0
22,38,-16,0,0,0
-8,-2,-6,0,0,0
9,-2,11,1,0,1
-3,12,-15,0,0,0
11,29,-18,0,0,0
20,21,-1,0,0,0
31,31,0,0,0,0
-25,-38,13,1,0,1
28,38,-10,0,1,1
-35,-43,8,1,1,0
-36,-18,-18,0,1,1
49,29,20,1,1,0
-2,-8,6,1,1,0
27,37,-10,0,1,1
4,13,-9,0,1,1
3,15,-12,0,1,1
26,10,16,1,0,1
1,0,1,1,0,1
-38,-40,2,1,0,1
-17,-20,3,1,0,1
-51,-38,-13,0,0,0
-27,-20,-7,0,0,0
-5,-20,15,1,0,1
42,36,6,1,0,1
-35,-31,-4,0,0,0
-15,-28,13,1,0,1
6,2,4,1,0,1
-30,-45,15,1,0,1
38,42,-4,0,0,0
19,0,19,1,0,1
25,18,7,1,0,1
39,27,12,1,0,1
-16,-21,5,1,0,1
-32,-40,8,1,0,1
-61,-43,-18,0,0,0
-19,-23,4,1,0,1
28,14,14,1,0,1
4,15,-11,0,1,1
31,17,14,1,1,0
46,38,8,1,1,0
-25,-16,-9,0,1,1
-37,-37,0,0,1,1
28,17,11,1,1,0
36,39,-3,0,1,1
-56,-43,-13,0,1,1
56,36,20,1,1,0
-16,-8,-8,0,1,1
-40,-21,-19,0,1,1
9,16,-7,0,1,1
-9,5,-14,0,1,1
-22,-31,9,1,1,0
19,20,-1,0,1,1
-45,-41,-4,0,1,1
24,18,6,1,1,0
26,11,15,1,1,0
-19,-32,13,1,1,0
-28,-36,8,1,1,0
-1,-21,20,1,1,0
22,39,-17,0,0,0
-12,5,-17,0,0,0
-21,-30,9,1,0,1
12,23,-11,0,0,0
29,10,19,1,0,1
-29,-34,5,1,0,1
0,15,-15,0,0,0
-7,-17,10,1,0,1
-18,-26,8,1,0,1
45,26,19,1,0,1
19,20,-1,0,0,0
14,10,4,1,0,1
-27,-13,-14,0,0,0
-32,-31,-1,0,0,0
-60,-42,-18,0,0,0
33,16,17,1,0,1
-19,-18,-1,0,0,0
51,38,13,1,0,1
25,32,-7,0,0,0
-23,-19,-4,0,0,0
28,28,0,0,0,0
-7,13,-20,0,1,1
51,42,9,1,1,0
4,4,0,0,1,1
33,24,9,1,1,0
-13,0,-13,0,1,1
9,-9,18,1,1,0
-36,-28,-8,0,1,1
-21,-33,12,1,1,0
32,25,7,1,1,0
10,18,-8,0,1,1
39,32,7,1,1,0
21,27,-6,0,1,1
-9,-25,16,1,1,0
-57,-40,-17,0,1,1
11,6,5,1,1,0
-61,-45,-16,0,0,0
24,7,17,1,0,1
-29,-14,-15,0,0,0
-20,-29,9,1,0,1
6,19,-13,0,0,0
-19,-25,6,1,0,1
-58,-40,-18,0,0,0
52,38,14,1,0,1
-25,-30,5,1,0,1
-23,-23,0,0,0,0
3,20,-17,0,1,1
52,37,15,1,1,0
43,25,18,1,1,0
11,19,-8,0,1,1
-28,-18,-10,0,1,1
7,-9,16,1,1,0
0,2,-2,0,1,1
-24,-40,16,1,1,0
34,40,-6,0,1,1
-22,-38,16,1,1,0
-15,-7,-8,0,1,1
-54,-35,-19,0,1,1
28,30,-2,0,0,0
52,35,17,1,0,1
34,22,12,1,0,1
-7,-21,14,1,0,1
-1,2,-3,0,0,0
-20,-5,-15,0,0,0
42,30,12,1,0,1
-11,-6,-5,0,0,0
-31,-15,-16,0,0,0
-3,-6,3,1,0,1
-54,-41,-13,0,0,0
47,32,15,1,0,1
-8,7,-15,0,1,1
44,40,4,1,1,0
-22,-26,4,1,1,0
-24,-37,13,1,1,0
-21,-34,13,1,1,0
-23,-38,15,1,1,0
-26,-25,-1,0,1,1
26,32,-6,0,1,1
-44,-40,-4,0,1,1
-4,5,-9,0,1,1
-22,-22,0,0,1,1
-21,-18,-3,0,1,1
21,32,-11,0,0,0
-37,-32,-5,0,0,0
-14,-27,13,1,0,1
-8,6,-14,0,0,0
40,42,-2,0,0,0
6,2,4,1,0,1
56,36,20,1,0,1
18,21,-3,0,0,0
-2,-1,-1,0,0,0
55,38,17,1,0,1
23,6,17,1,0,1
14,30,-16,0,0,0
-4,-11,7,1,0,1
14,-3,17,1,0,1
-47,-32,-15,0,0,0
29,38,-9,0,0,0
19,34,-15,0,0,0
-1,-19,18,1,0,1
6,9,-3,0,0,0
-52,-37,-15,0,0,0
-8,-10,2,1,0,1
22,22,0,0,1,1
28,39,-11,0,1,1
37,36,1,1,1,0
-32,-36,4,1,1,0
33,37,-4,0,1,1
-15,-33,18,1,1,0
-17,-25,8,1,1,0
26,17,9,1,1,0
12,9,3,1,1,0
-12,-20,8,1,1,0
-52,-34,-18,0,1,1
43,33,10,1,1,0
19,34,-15,0,1,1
23,12,11,1,1,0
25,42,-17,0,1,1
14,-1,15,1,1,0
11,11,0,0,1,1
-49,-40,-9,0,1,1
62,43,19,1,1,0
6,15,-9,0,1,1
24,23,1,1,1,0
12,-5,17,1,0,1
53,39,14,1,0,1
-35,-32,-3,0,0,0
20,3,17,1,0,1
-17,-25,8,1,0,1
26,8,18,1,0,1
-33,-27,-6,0,0,0
18,26,-8,0,0,0
-28,-40,12,1,0,1
27,10,17,1,0,1
7,8,-1,0,0,0
-28,-38,10,1,0,1
5,7,-2,0,0,0
-19,1,-20,0,0,0
-39,-20,-19,0,0,0
32,26,6,1,0,1
19,3,16,1,0,1
25,19,6,1,0,1
14,7,7,1,0,1
16,15,1,1,0,1
-27,-9,-18,0,0,0
-32,-26,-6,0,1,1
0,10,-10,0,1,1
44,38,6,1,1,0
20,11,9,1,1,0
-10,-2,-8,0,1,1
43,36,7,1,1,0
-12,-5,-7,0,1,1
9,28,-19,0,1,1
-47,-34,-13,0,0,0
-12,-12,0,0,0,0
16,10,6,1,0,1
8,-7,15,1,0,1
11,3,8,1,0,1
-23,-37,14,1,0,1
33,17,16,1,0,1
-28,-41,13,1,0,1
-3,-22,19,1,0,1
2,9,-7,0,0,0
45,37,8,1,0,1
26,27,-1,0,0,0
3,1,2,1,0,1
-38,-22,-16,0,0,0
-30,-28,-2,0,0,0
-13,7,-20,0,0,0
-15,-13,-2,0,0,0
3,-4,7,1,0,1
-32,-25,-7,0,0,0
18,17,1,1,0,1
34,22,12,1,1,0
-55,-38,-17,0,1,1
-59,-45,-14,0,1,1
-31,-15,-16,0,1,1
14,19,-5,0,1,1
8,0,8,1,1,0
-12,-17,5,1,1,0
50,31,19,1,1,0
-43,-31,-12,0,1,1
27,37,-10,0,1,1
54,34,20,1,1,0
58,43,15,1,1,0
9,-5,14,1,1,0
-23,-13,-10,0,0,0
-1,17,-18,0,0,0
-8,7,-15,0,0,0
-8,-15,7,1,0,1
20,33,-13,0,0,0
-25,-35,10,1,0,1
-24,-40,16,1,0,1
-37,-32,-5,0,0,0
-14,-25,11,1,0,1
-21,-34,13,1,0,1
43,26,17,1,0,1
48,35,13,1,0,1
7,-6,13,1,0,1
25,7,18,1,0,1
8,-8,16,1,0,1
-48,-28,-20,0,0,0
23,36,-13,0,1,1
16,16,0,0,1,1
2,12,-10,0,1,1
18,6,12,1,1,0
34,36,-2,0,1,1
-19,-7,-12,0,1,1
57,43,14,1,1,0
-20,-24,4,1,1,0
31,40,-9,0,0,0
-54,-38,-16,0,0,0
13,28,-15,0,0,0
22,33,-11,0,0,0
-29,-23,-6,0,0,0
-24,-4,-20,0,0,0
-17,-30,13,1,0,1
15,-4,19,1,0,1
8,-9,17,1,0,1
38,21,17,1,0,1
-8,-25,17,1,0,1
9,0,9,1,0,1
38,31,7,1,0,1
-11,-22,11,1,0,1
17,27,-10,0,1,1
34,41,-7,0,1,1
-2,17,-19,0,1,1
34,27,7,1,1,0
0,13,-13,0,1,1
6,9,-3,0,1,1
25,7,18,1,1,0
49,37,12,1,1,0
-39,-40,1,1,1,0
-25,-29,4,1,1,0
4,-10,14,1,1,0
-52,-42,-10,0,1,1
-37,-38,1,1,1,0
47,30,17,1,1,0
42,24,18,1,0,1
-25,-20,-5,0,0,0
-23,-42,19,1,0,1
40,38,2,1,0,1
-39,-24,-15,0,0,0
11,1,10,1,0,1
7,25,-18,0,0,0
11,30,-19,0,0,0
-33,-39,6,1,0,1
29,18,11,1,0,1
24,43,-19,0,0,0
35,38,-3,0,0,0
19,36,-17,0,0,0
-10,5,-15,0,0,0
28,34,-6,0,1,1
9,3,6,1,1,0
-3,9,-12,0,1,1
-11,-23,12,1,1,0
32,41,-9,0,1,1
20,6,14,1,1,0
-32,-15,-17,0,1,1
-35,-45,10,1,1,0
-14,-2,-12,0,0,0
-15,-32,17,1,0,1
-7,-16,9,1,0,1
12,20,-8,0,0,0
3,-8,11,1,0,1
-42,-24,-18,0,0,0
-43,-23,-20,0,0,0
20,23,-3,0,0,0
10,8,2,1,0,1
-4,9,-13,0,0,0
16,18,-2,0,0,0
13,8,5,1,0,1
23,30,-7,0,0,0
18,31,-13,0,0,0
44,25,19,1,0,1
-5,4,-9,0,0,0
57,41,16,1,0,1
8,28,-20,0,0,0
-31,-15,-16,0,0,0
-1,-11,10,1,1,0
-35,-18,-17,0,1,1
-33,-27,-6,0,1,1
46,36,10,1,1,0
50,38,12,1,1,0
-9,-19,10,1,1,0
51,37,14,1,1,0
-21,-3,-18,0,1,1
-49,-41,-8,0,1,1
-41,-22,-19,0,1,1
21,5,16,1,1,0
0,17,-17,0,1,1
-31,-28,-3,0,1,1
-24,-29,5,1,1,0
50,44,6,1,1,0
36,39,-3,0,1,1
26,36,-10,0,1,1
-10,-17,7,1,1,0
-22,-31,9,1,1,0
-23,-12,-11,0,1,1
47,35,12,1,1,0
-10,-3,-7,0,0,0
27,43,-16,0,0,0
-38,-30,-8,0,0,0
-13,-25,12,1,0,1
-39,-43,4,1,0,1
-19,-33,14,1,0,1
25,15,10,1,0,1
-13,-11,-2,0,0,0
-17,-22,5,1,0,1
32,36,-4,0,1,1
-23,-10,-13,0,1,1
45,42,3,1,1,0
55,43,12,1,1,0
-38,-18,-20,0,1,1
-19,-28,9,1,1,0
-26,-24,-2,0,1,1
-14,-22,8,1,1,0
-47,-29,-18,0,1,1
0,9,-9,0,1,1
19,19,0,0,1,1
30,37,-7,0,1,1
37,32,5,1,1,0
14,23,-9,0,1,1
-12,-2,-10,0,1,1
-32,-39,7,1,1,0
12,1,11,1,1,0
-20,-9,-11,0,0,0
46,38,8,1,0,1
1,-17,18,1,0,1
33,44,-11,0,0,0
11,5,6,1,0,1
-8,0,-8,0,0,0
19,7,12,1,0,1
12,32,-20,0,0,0
-32,-35,3,1,0,1
25,39,-14,0,0,0
-32,-23,-9,0,0,0
40,33,7,1,0,1
-52,-40,-12,0,0,0
-19,-8,-11,0,0,0
6,2,4,1,1,0
-13,-21,8,1,1,0
-22,-33,11,1,1,0
-15,-34,19,1,1,0
39,41,-2,0,1,1
-10,-20,10,1,1,0
27,8,19,1,1,0
-31,-38,7,1,1,0
17,9,8,1,1,0
7,17,-10,0,1,1
30,10,20,1,1,0
52,38,14,1,1,0
42,31,11,1,1,0
3,-1,4,1,1,0
-16,-8,-8,0,1,1
0,-2,2,1,1,0
-2,4,-6,0,1,1
-18,-4,-14,0,1,1
-17,-30,13,1,1,0
-27,-11,-16,0,1,1
25,38,-13,0,1,1
14,4,10,1,0,1
10,16,-6,0,0,0
42,23,19,1,0,1
1,-13,14,1,0,1
3,-3,6,1,0,1
-5,-19,14,1,0,1
20,17,3,1,0,1
26,42,-16,0,0,0
-37,-20,-17,0,0,0
28,11,17,1,0,1
34,42,-8,0,0,0
-29,-30,1,1,0,1
-31,-40,9,1,0,1
-11,-7,-4,0,1,1
36,42,-6,0,1,1
-13,-20,7,1,1,0
8,12,-4,0,1,1
44,40,4,1,1,0
-20,-6,-14,0,1,1
5,-12,17,1,1,0
-43,-29,-14,0,1,1
60,42,18,1,1,0
29,39,-10,0,0,0
-7,5,-12,0,0,0
27,33,-6,0,0,0
24,26,-2,0,0,0
-39,-34,-5,0,0,0
10,-6,16,1,0,1
41,39,2,1,0,1
-6,-22,16,1,0,1
55,40,15,1,0,1
-3,15,-18,0,1,1
-61,-45,-16,0,1,1
-11,7,-18,0,1,1
51,37,14,1,1,0
-43,-44,1,1,1,0
-32,-24,-8,0,1,1
23,3,20,1,1,0
40,21,19,1,1,0
-11,-18,7,1,1,0
51,38,13,1,1,0
26,27,-1,0,1,1
-33,-17,-16,0,1,1
42,31,11,1,1,0
29,43,-14,0,1,1
-33,-20,-13,0,1,1
-15,0,-15,0,0,0
-38,-43,5,1,0,1
53,39,14,1,0,1
16,24,-8,0,0,0
23,33,-10,0,0,0
57,37,20,1,0,1
-22,-34,12,1,0,1
-36,-17,-19,0,0,0
-27,-24,-3,0,0,0
-10,-5,-5,0,0,0
0,-19,19,1,0,1
-53,-38,-15,0,0,0
-15,-17,2,1,0,1
37,34,3,1,0,1
-43,-35,-8,0,0,0
14,21,-7,0,0,0
-30,-26,-4,0,0,0
5,4,1,1,0,1
32,39,-7,0,0,0
33,43,-10,0,0,0
32,20,12,1,0,1
-7,-15,8,1,1,0
44,25,19,1,1,0
-11,-1,-10,0,1,1
-40,-29,-11,0,1,1
26,16,10,1,1,0
-30,-34,4,1,1,0
33,20,13,1,1,0
-1,-9,8,1,1,0
38,23,15,1,1,0
11,8,3,1,1,0
-23,-34,11,1,1,0
-9,2,-11,0,1,1
-49,-30,-19,0,1,1
20,7,13,1,1,0
-16,-21,5,1,1,0
-29,-10,-19,0,1,1
-36,-27,-9,0,1,1
-52,-45,-7,0,1,1
-31,-36,5,1,1,0
2,12,-10,0,1,1
59,40,19,1,1,0
-6,5,-11,0,0,0
39,40,-1,0,0,0
27,44,-17,0,0,0
-11,-17,6,1,0,1
44,24,20,1,0,1
10,26,-16,0,0,0
25,20,5,1,0,1
-41,-39,-2,0,0,0
7,-7,14,1,0,1
43,44,-1,0,0,0
43,33,10,1,0,1
35,33,2,1,0,1
-20,-22,2,1,0,1
14,-2,16,1,0,1
-40,-42,2,1,0,1
51,32,19,1,0,1
6,-8,14,1,0,1
-37,-39,2,1,0,1
40,20,20,1,0,1
47,43,4,1,0,1
-23,-41,18,1,1,0
-7,-25,18,1,1,0
-43,-43,0,0,1,1
1,-6,7,1,1,0
-9,10,-19,0,1,1
-9,-10,1,1,1,0
-39,-35,-4,0,1,1
7,-12,19,1,1,0
-34,-39,5,1,1,0
-25,-11,-14,0,1,1
21,37,-16,0,1,1
13,25,-12,0,1,1
38,20,18,1,1,0
-13,-17,4,1,1,0
33,38,-5,0,1,1
56,44,12,1,1,0
39,19,20,1,1,0
-6,-18,12,1,1,0
-29,-33,4,1,1,0
-26,-26,0,0,1,1
-21,-18,-3,0,1,1
23,35,-12,0,0,0
11,2,9,1,0,1
29,16,13,1,0,1
5,18,-13,0,0,0
35,29,6,1,0,1
25,42,-17,0,0,0
43,33,10,1,0,1
-21,-6,-15,0,0,0
-28,-31,3,1,0,1
6,24,-18,0,0,0
12,12,0,0,0,0
-53,-40,-13,0,0,0
-57,-42,-15,0,0,0
19,20,-1,0,0,0
12,30,-18,0,1,1
28,37,-9,0,1,1
-26,-37,11,1,1,0
36,32,4,1,1,0
5,-11,16,1,1,0
-54,-40,-14,0,1,1
48,28,20,1,1,0
13,11,2,1,1,0
36,36,0,0,1,1
13,5,8,1,1,0
-5,-13,8,1,1,0
5,17,-12,0,1,1
-53,-40,-13,0,1,1
31,14,17,1,1,0
10,9,1,1,1,0
-23,-36,13,1,1,0
33,40,-7,0,1,1
55,44,11,1,1,0
-3,11,-14,0,1,1
-45,-27,-18,0,1,1
-7,-17,10,1,0,1
18,33,-15,0,0,0
-5,-20,15,1,0,1
-5,-24,19,1,0,1
23,16,7,1,0,1
26,18,8,1,0,1
23,39,-16,0,0,0
25,10,15,1,0,1
-8,12,-20,0,0,0
54,42,12,1,0,1
-15,-24,9,1,0,1
-22,-9,-13,0,0,0
42,40,2,1,0,1
-23,-34,11,1,0,1
30,41,-11,0,0,0
48,29,19,1,0,1
-12,-13,1,1,0,1
34,31,3,1,0,1
-47,-45,-2,0,0,0
7,17,-10,0,0,0
27,32,-5,0,0,0
11,4,7,1,1,0
-26,-32,6,1,1,0
-31,-42,11,1,1,0
29,34,-5,0,1,1
-3,-9,6,1,1,0
47,35,12,1,1,0
-4,-12,8,1,1,0
25,20,5,1,1,0
5,20,-15,0,1,1
-3,15,-18,0,1,1
15,2,13,1,1,0
9,12,-3,0,1,1
38,20,18,1,1,0
-50,-34,-16,0,0,0
-35,-20,-15,0,0,0
21,27,-6,0,0,0
28,32,-4,0,0,0
-5,-1,-4,0,0,0
-28,-24,-4,0,0,0
20,23,-3,0,0,0
-31,-35,4,1,0,1
-3,0,-3,0,0,0
-36,-32,-4,0,0,0
25,43,-18,0,0,0
49,34,15,1,0,1
29,15,14,1,1,0
-17,-27,10,1,1,0
-30,-15,-15,0,1,1
6,19,-13,0,1,1
-46,-44,-2,0,1,1
-40,-34,-6,0,1,1
-31,-28,-3,0,1,1
51,38,13,1,1,0
-26,-37,11,1,1,0
57,44,13,1,1,0
-21,-25,4,1,1,0
-45,-38,-7,0,1,1
-46,-43,-3,0,1,1
-12,2,-14,0,0,0
-10,10,-20,0,0,0
-1,19,-20,0,0,0
10,1,9,1,0,1
-31,-34,3,1,0,1
-54,-35,-19,0,0,0
-20,-8,-12,0,0,0
14,15,-1,0,0,0
12,32,-20,0,1,1
1,2,-1,0,1,1
-10,-14,4,1,1,0
19,32,-13,0,1,1
-8,-22,14,1,1,0
-19,-22,3,1,1,0
20,17,3,1,1,0
30,37,-7,0,1,1
49,42,7,1,1,0
15,4,11,1,1,0
-28,-24,-4,0,1,1
-8,-7,-1,0,1,1
-2,11,-13,0,1,1
-8,-7,-1,0,1,1
-14,-14,0,0,1,1
35,15,20,1,1,0
6,16,-10,0,1,1
4,20,-16,0,0,0
9,26,-17,0,0,0
-24,-28,4,1,0,1
30,30,0,0,0,0
-12,-26,14,1,0,1
-13,-12,-1,0,0,0
-18,-31,13,1,0,1
-49,-43,-6,0,0,0
-7,-1,-6,0,0,0
1,-13,14,1,0,1
-9,-14,5,1,0,1
-40,-44,4,1,0,1
8,28,-20,0,0,0
-15,-24,9,1,0,1
-11,-7,-4,0,0,0
11,27,-16,0,0,0
4,-16,20,1,0,1
-30,-34,4,1,0,1
34,32,2,1,0,1
-45,-26,-19,0,0,0
-19,-24,5,1,0,1
-2,8,-10,0,1,1
-16,-20,4,1,1,0
36,38,-2,0,1,1
7,16,-9,0,1,1
-26,-41,15,1,1,0
-13,-19,6,1,1,0
-10,-20,10,1,1,0
10,14,-4,0,1,1
-5,13,-18,0,1,1
-16,3,-19,0,0,0
-5,-11,6,1,0,1
-23,-11,-12,0,0,0
-6,-22,16,1,0,1
53,35,18,1,0,1
2,22,-20,0,0,0
-12,-21,9,1,0,1
-26,-39,13,1,0,1
-35,-41,6,1,0,1
-5,-22,17,1,0,1
25,22,3,1,0,1
40,32,8,1,0,1
-50,-35,-15,0,0,0
1,-12,13,1,1,0
16,2,14,1,1,0
4,-8,12,1,1,0
-13,0,-13,0,1,1
25,31,-6,0,1,1
16,36,-20,0,1,1
-56,-38,-18,0,1,1
1,-1,2,1,1,0
-19,-15,-4,0,1,1
-31,-21,-10,0,0,0
13,30,-17,0,0,0
-21,-11,-10,0,0,0
-21,-25,4,1,0,1
-15,-23,8,1,0,1
-50,-32,-18,0,0,0
-11,7,-18,0,0,0
-14,-26,12,1,0,1
37,27,10,1,0,1
-62,-44,-18,0,0,0
-30,-27,-3,0,0,0
-25,-38,13,1,0,1
57,43,14,1,0,1
-24,-14,-10,0,0,0
30,37,-7,0,1,1
10,27,-17,0,1,1
47,36,11,1,1,0
22,40,-18,0,1,1
-35,-38,3,1,1,0
-44,-26,-18,0,1,1
15,35,-20,0,1,1
17,35,-18,0,1,1
-56,-40,-16,0,1,1
-35,-31,-4,0,1,1
-20,-16,-4,0,1,1
45,34,11,1,1,0
-46,-39,-7,0,1,1
-49,-36,-13,0,1,1
-5,12,-17,0,1,1
44,37,7,1,1,0
-6,8,-14,0,0,0
-34,-30,-4,0,0,0
-14,-23,9,1,0,1
50,37,13,1,0,1
-32,-33,1,1,0,1
-27,-10,-17,0,0,0
10,7,3,1,0,1
9,1,8,1,0,1
4,-3,7,1,0,1
8,20,-12,0,0,0
-8,0,-8,0,0,0
53,34,19,1,0,1
-25,-8,-17,0,0,0
13,1,12,1,0,1
27,31,-4,0,0,0
-8,-14,6,1,0,1
-13,-17,4,1,0,1
-22,-7,-15,0,0,0
7,15,-8,0,1,1
13,12,1,1,1,0
-4,-4,0,0,1,1
-20,-29,9,1,1,0
11,15,-4,0,1,1
32,34,-2,0,1,1
47,31,16,1,1,0
-17,-34,17,1,1,0
43,28,15,1,1,0
43,33,10,1,1,0
5,2,3,1,0,1
44,30,14,1,0,1
-17,0,-17,0,0,0
-29,-9,-20,0,0,0
7,23,-16,0,0,0
-1,7,-8,0,0,0
46,33,13,1,0,1
9,26,-17,0,0,0
-6,-11,5,1,0,1
13,30,-17,0,0,0
31,44,-13,0,0,0
-13,-5,-8,0,0,0
20,13,7,1,0,1
26,24,2,1,0,1
-24,-40,16,1,0,1
-59,-43,-16,0,0,0
-30,-35,5,1,0,1
28,14,14,1,0,1
61,41,20,1,1,0
-22,-24,2,1,1,0
7,-3,10,1,1,0
-17,-12,-5,0,1,1
-19,-21,2,1,1,0
10,27,-17,0,1,1
30,12,18,1,1,0
-50,-40,-10,0,1,1
25,43,-18,0,1,1
-34,-28,-6,0,1,1
-13,3,-16,0,1,1
-23,-8,-15,0,1,1
17,23,-6,0,0,0
-20,-24,4,1,0,1
-10,10,-20,0,0,0
-42,-45,3,1,0,1
-51,-40,-11,0,0,0
58,42,16,1,0,1
-3,3,-6,0,0,0
-7,-21,14,1,0,1
35,19,16,1,0,1
-36,-35,-1,0,1,1
5,-1,6,1,1,0
-11,7,-18,0,1,1
-6,-2,-4,0,1,1
-29,-20,-9,0,1,1
47,39,8,1,1,0
-22,-28,6,1,1,0
-38,-27,-11,0,1,1
38,43,-5,0,1,1
16,10,6,1,1,0
-2,9,-11,0,0,0
28,39,-11,0,0,0
-8,10,-18,0,0,0
1,1,0,0,0,0
8,11,-3,0,0,0
54,34,20,1,0,1
40,26,14,1,0,1
54,41,13,1,0,1
-10,-29,19,1,1,0
12,13,-1,0,1,1
-27,-33,6,1,1,0
-36,-26,-10,0,1,1
38,25,13,1,1,0
-13,-3,-10,0,1,1
-17,-18,1,1,1,0
35,25,10,1,1,0
-48,-35,-13,0,1,1
-16,-2,-14,0,1,1
30,32,-2,0,1,1
-39,-33,-6,0,1,1
6,-14,20,1,1,0
9,12,-3,0,1,1
-34,-32,-2,0,0,0
38,43,-5,0,0,0
-28,-21,-7,0,0,0
-12,-22,10,1,0,1
0,14,-14,0,0,0
10,24,-14,0,0,0
-26,-18,-8,0,0,0
-47,-35,-12,0,0,0
49,41,8,1,0,1
24,33,-9,0,0,0
24,33,-9,0,0,0
47,29,18,1,0,1
-17,-22,5,1,0,1
33,15,18,1,0,1
42,40,2,1,0,1
-46,-37,-9,0,0,0
-12,6,-18,0,0,0
-29,-26,-3,0,0,0
33,24,9,1,0,1
-28,-13,-15,0,0,0
-15,-24,9,1,0,1
22,8,14,1,1,0
15,11,4,1,1,0
-52,-34,-18,0,1,1
31,28,3,1,1,0
-36,-23,-13,0,1,1
23,34,-11,0,1,1
-8,-20,12,1,1,0
-23,-23,0,0,1,1
-10,7,-17,0,1,1
55,42,13,1,0,1
35,27,8,1,0,1
-50,-42,-8,0,0,0
16,15,1,1,0,1
30,30,0,0,0,0
-9,-24,15,1,0,1
19,24,-5,0,0,0
-28,-13,-15,0,0,0
2,-15,17,1,0,1
4,6,-2,0,0,0
2,1,1,1,0,1
23,23,0,0,0,0
13,25,-12,0,0,0
36,35,1,1,0,1
29,24,5,1,0,1
25,16,9,1,0,1
48,29,19,1,0,1
-10,-29,19,1,0,1
2,0,2,1,0,1
20,32,-12,0,0,0
-29,-11,-18,0,0,0
-27,-30,3,1,1,0
6,8,-2,0,1,1
60,42,18,1,1,0
33,44,-11,0,1,1
33,23,10,1,1,0
45,41,4,1,1,0
24,39,-15,0,1,1
-41,-43,2,1,1,0
25,17,8,1,1,0
18,27,-9,0,1,1
-25,-22,-3,0,0,0
-28,-40,12,1,0,1
37,28,9,1,0,1
-42,-40,-2,0,0,0
10,16,-6,0,0,0
-21,-20,-1,0,0,0
20,14,6,1,0,1
10,30,-20,0,0,0
1,15,-14,0,0,0
45,27,18,1,0,1
34,36,-2,0,0,0
6,2,4,1,1,0
23,43,-20,0,1,1
27,39,-12,0,1,1
17,25,-8,0,1,1
22,23,-1,0,1,1
-12,-17,5,1,1,0
16,33,-17,0,1,1
6,-10,16,1,1,0
-7,-15,8,1,1,0
-53,-38,-15,0,1,1
-26,-16,-10,0,1,1
28,21,7,1,1,0
-29,-9,-20,0,1,1
-1,15,-16,0,1,1
-29,-42,13,1,1,0
9,16,-7,0,1,1
-15,-27,12,1,1,0
13,21,-8,0,0,0
38,31,7,1,0,1
51,39,12,1,0,1
49,44,5,1,0,1
-20,-33,13,1,0,1
15,-2,17,1,0,1
-42,-22,-20,0,0,0
-45,-41,-4,0,0,0
-39,-32,-7,0,0,0
-14,-13,-1,0,1,1
28,13,15,1,1,0
-17,-12,-5,0,1,1
-36,-42,6,1,1,0
-12,-13,1,1,1,0
0,-2,2,1,1,0
-18,-31,13,1,1,0
-28,-34,6,1,1,0
1,-10,11,1,1,0
-39,-24,-15,0,1,1
53,37,16,1,1,0
53,39,14,1,1,0
23,30,-7,0,1,1
0,-8,8,1,1,0
44,29,15,1,1,0
29,21,8,1,1,0
18,17,1,1,1,0
29,14,15,1,1,0
-22,-13,-9,0,1,1
-44,-29,-15,0,1,1
-38,-45,7,1,1,0
0,17,-17,0,0,0
-16,-4,-12,0,0,0
35,30,5,1,0,1
-11,-27,16,1,0,1
19,7,12,1,0,1
-16,-24,8,1,0,1
33,19,14,1,0,1
-20,-38,18,1,0,1
30,21,9,1,0,1
16,-3,19,1,0,1
4,16,-12,0,1,1
-8,-21,13,1,1,0
16,24,-8,0,1,1
11,1,10,1,1,0
-45,-34,-11,0,1,1
-38,-38,0,0,1,1
-22,-7,-15,0,1,1
-17,-2,-15,0,1,1
34,40,-6,0,1,1
16,11,5,1,1,0
-30,-36,6,1,1,0
14,17,-3,0,1,1
40,24,16,1,1,0
49,43,6,1,1,0
-27,-38,11,1,1,0
-10,3,-13,0,1,1
37,27,10,1,1,0
42,40,2,1,1,0
-24,-37,13,1,1,0
-20,-27,7,1,1,0
0,18,-18,0,1,1
-19,-35,16,1,0,1
-40,-31,-9,0,0,0
53,37,16,1,0,1
18,30,-12,0,0,0
-39,-21,-18,0,0,0
-13,-7,-6,0,0,0
18,11,7,1,0,1
-20,-15,-5,0,0,0
-2,-16,14,1,1,0
-28,-40,12,1,1,0
-5,15,-20,0,1,1
-19,-10,-9,0,1,1
-15,2,-17,0,1,1
19,31,-12,0,1,1
-35,-42,7,1,1,0
-7,4,-11,0,1,1
-31,-35,4,1,0,1
29,39,-10,0,0,0
13,-1,14,1,0,1
-24,-15,-9,0,0,0
-34,-29,-5,0,0,0
-12,-27,15,1,0,1
-34,-44,10,1,0,1
-30,-38,8,1,0,1
3,-16,19,1,0,1
-23,-11,-12,0,0,0
-5,-11,6,1,0,1
22,19,3,1,0,1
29,38,-9,0,0,0
7,2,5,1,0,1
28,42,-14,0,0,0
-8,1,-9,0,0,0
51,32,19,1,0,1
42,43,-1,0,0,0
-11,7,-18,0,0,0
-34,-18,-16,0,0,0
30,22,8,1,0,1
-20,-35,15,1,1,0
-14,-17,3,1,1,0
14,24,-10,0,1,1
12,30,-18,0,1,1
6,-2,8,1,1,0
41,30,11,1,1,0
1,-7,8,1,1,0
-5,-3,-2,0,1,1
-5,8,-13,0,1,1
24,24,0,0,1,1
-5,-11,6,1,1,0
-13,-23,10,1,0,1
30,40,-10,0,0,0
-65,-45,-20,0,0,0
-29,-17,-12,0,0,0
49,37,12,1,0,1
-7,3,-10,0,0,0
-21,-31,10,1,0,1
30,36,-6,0,0,0
-27,-33,6,1,0,1
38,26,12,1,0,1
-34,-24,-10,0,0,0
-44,-30,-14,0,0,0
46,30,16,1,0,1
38,34,4,1,1,0
16,35,-19,0,1,1
50,31,19,1,1,0
28,29,-1,0,1,1
36,39,-3,0,1,1
25,13,12,1,1,0
-1,-13,12,1,1,0
-13,-4,-9,0,1,1
-30,-36,6,1,1,0
-6,-14,8,1,1,0
11,-7,18,1,1,0
-32,-27,-5,0,1,1
-1,-5,4,1,1,0
-24,-35,11,1,1,0
10,8,2,1,1,0
-35,-40,5,1,1,0
16,-1,17,1,1,0
15,13,2,1,1,0
-50,-36,-14,0,1,1
0,-16,16,1,1,0
-13,2,-15,0,1,1
34,32,2,1,0,1
-44,-43,-1,0,0,0
-42,-39,-3,0,0,0
17,22,-5,0,0,0
-27,-34,7,1,0,1
-1,3,-4,0,0,0
-54,-43,-11,0,0,0
-27,-35,8,1,0,1
-24,-8,-16,0,0,0
10,28,-18,0,0,0
14,14,0,0,0,0
33,17,16,1,1,0
-21,-32,11,1,1,0
-24,-8,-16,0,1,1
25,43,-18,0,1,1
-10,-7,-3,0,1,1
-17,-26,9,1,1,0
30,39,-9,0,1,1
40,34,6,1,1,0
3,3,0,0,1,1
-13,-27,14,1,1,0
11,12,-1,0,1,1
52,37,15,1,1,0
-11,-24,13,1,0,1
-10,-1,-9,0,0,0
-5,4,-9,0,0,0
39,24,15,1,0,1
-24,-12,-12,0,0,0
4,16,-12,0,0,0
-17,-26,9,1,0,1
-40,-20,-20,0,0,0
18,22,-4,0,0,0
-43,-31,-12,0,0,0
-27,-11,-16,0,0,0
-22,-29,7,1,0,1
-18,-16,-2,0,0,0
-48,-32,-16,0,0,0
-5,5,-10,0,0,0
-62,-43,-19,0,0,0
6,-4,10,1,0,1
53,43,10,1,0,1
-18,-23,5,1,0,1
55,42,13,1,0,1
-13,-19,6,1,0,1
-51,-37,-14,0,1,1
-27,-39,12,1,1,0
-2,10,-12,0,1,1
-17,-30,13,1,1,0
6,-2,8,1,1,0
-31,-21,-10,0,1,1
52,37,15,1,1,0
-5,6,-11,0,1,1
-58,-39,-19,0,0,0
10,19,-9,0,0,0
18,25,-7,0,0,0
22,13,9,1,0,1
-10,-13,3,1,0,1
-30,-21,-9,0,0,0
25,43,-18,0,0,0
15,15,0,0,0,0
22,16,6,1,0,1
13,9,4,1,0,1
-19,-20,1,1,0,1
26,36,-10,0,0,0
9,-4,13,1,0,1
-18,-17,-1,0,0,0
-42,-45,3,1,0,1
34,34,0,0,0,0
0,13,-13,0,0,0
54,36,18,1,0,1
-44,-24,-20,0,0,0
-16,-35,19,1,0,1
20,27,-7,0,0,0
8,13,-5,0,1,1
-28,-42,14,1,1,0
-39,-32,-7,0,1,1
-60,-41,-19,0,1,1
21,36,-15,0,1,1
40,22,18,1,1,0
-16,-17,1,1,1,0
-7,-5,-2,0,1,1
1,12,-11,0,1,1
-42,-43,1,1,1,0
-2,-8,6,1,1,0
51,34,17,1,1,0
-48,-35,-13,0,1,1
33,20,13,1,1,0
-26,-29,3,1,1,0
-15,-25,10,1,1,0
-32,-19,-13,0,1,1
7,19,-12,0,1,1
-31,-41,10,1,1,0
39,32,7,1,0,1
-41,-44,3,1,0,1
-43,-44,1,1,0,1
-38,-44,6,1,0,1
-19,-25,6,1,0,1
47,36,11,1,0,1
9,23,-14,0,0,0
14,7,7,1,0,1
13,-7,20,1,0,1
4,-6,10,1,0,1
30,39,-9,0,0,0
48,34,14,1,0,1
-11,5,-16,0,0,0
-30,-40,10,1,0,1
-26,-19,-7,0,0,0
-31,-16,-15,0,0,0
-10,-12,2,1,0,1
42,31,11,1,0,1
45,39,6,1,1,0
25,29,-4,0,1,1
48,28,20,1,1,0
19,4,15,1,1,0
-31,-45,14,1,1,0
-44,-42,-2,0,1,1
-33,-29,-4,0,1,1
-11,-2,-9,0,1,1
-21,-41,20,1,1,0
-40,-37,-3,0,1,1
-22,-23,1,1,0,1
-32,-31,-1,0,0,0
-9,-21,12,1,0,1
-12,0,-12,0,0,0
-9,-6,-3,0,0,0
46,26,20,1,0,1
25,9,16,1,0,1
-41,-36,-5,0,0,0
-21,-14,-7,0,0,0
-20,-36,16,1,0,1
-7,-1,-6,0,0,0
23,33,-10,0,0,0
3,0,3,1,0,1
-19,-25,6,1,0,1
-27,-20,-7,0,0,0
22,31,-9,0,0,0
-3,10,-13,0,1,1
28,39,-11,0,1,1
36,31,5,1,1,0
-57,-39,-18,0,1,1
-35,-25,-10,0,1,1
-45,-43,-2,0,1,1
-23,-6,-17,0,1,1
37,32,5,1,1,0
-4,-6,2,1,0,1
21,38,-17,0,0,0
25,16,9,1,0,1
-24,-30,6,1,0,1
-12,-15,3,1,0,1
15,33,-18,0,0,0
-51,-45,-6,0,0,0
-17,-1,-16,0,0,0
-19,-33,14,1,0,1
43,26,17,1,0,1
15,27,-12,0,0,0
18,3,15,1,0,1
7,4,3,1,0,1
-11,5,-16,0,0,0
-6,14,-20,0,1,1
-52,-42,-10,0,1,1
-29,-35,6,1,1,0
-19,-25,6,1,1,0
-21,-5,-16,0,1,1
-24,-40,16,1,1,0
-56,-39,-17,0,1,1
-36,-39,3,1,1,0
-3,16,-19,0,1,1
16,5,11,1,0,1
-24,-44,20,1,0,1
43,32,11,1,0,1
50,32,18,1,0,1
-1,-20,19,1,0,1
-24,-32,8,1,0,1
-14,-9,-5,0,0,0
-12,3,-15,0,0,0
-12,-22,10,1,0,1
50,30,20,1,0,1
-30,-43,13,1,0,1
-57,-41,-16,0,0,0
16,10,6,1,1,0
-22,-3,-19,0,1,1
43,25,18,1,1,0
-10,-24,14,1,1,0
-27,-42,15,1,1,0
-11,1,-12,0,1,1
-34,-22,-12,0,1,1
48,41,7,1,1,0
-10,-15,5,1,1,0
-15,4,-19,0,1,1
2,5,-3,0,1,1
1,-11,12,1,1,0
-33,-14,-19,0,1,1
11,-4,15,1,1,0
38,25,13,1,1,0
34,33,1,1,1,0
-25,-25,0,0,1,1
-14,-30,16,1,1,0
23,29,-6,0,1,1
7,6,1,1,1,0
31,11,20,1,1,0
12,20,-8,0,0,0
6,7,-1,0,0,0
26,17,9,1,0,1
-22,-30,8,1,0,1
-31,-36,5,1,0,1
-13,-7,-6,0,0,0
0,-13,13,1,0,1
14,24,-10,0,0,0
14,-2,16,1,1,0
29,28,1,1,1,0
30,39,-9,0,1,1
9,1,8,1,1,0
5,24,-19,0,1,1
19,2,17,1,1,0
-8,12,-20,0,1,1
-8,9,-17,0,1,1
-15,-8,-7,0,1,1
38,40,-2,0,1,1
-8,-4,-4,0,1,1
-13,-17,4,1,1,0
-18,-11,-7,0,1,1
1,8,-7,0,1,1
56,38,18,1,1,0
-20,-40,20,1,1,0
45,30,15,1,1,0
27,24,3,1,1,0
-44,-42,-2,0,1,1
17,21,-4,0,1,1
42,33,9,1,1,0
41,29,12,1,0,1
21,16,5,1,0,1
19,30,-11,0,0,0
-45,-27,-18,0,0,0
7,18,-11,0,0,0
20,2,18,1,0,1
3,3,0,0,0,0
11,-5,16,1,0,1
-6,1,-7,0,0,0
10,21,-11,0,0,0
32,22,10,1,0,1
15,31,-16,0,0,0
58,38,20,1,0,1
-3,-19,16,1,1,0
24,27,-3,0,1,1
19,10,9,1,1,0
-14,-33,19,1,1,0
5,24,-19,0,1,1
-19,-1,-18,0,1,1
-22,-21,-1,0,1,1
-27,-44,17,1,1,0
-18,-35,17,1,1,0
31,15,16,1,1,0
40,41,-1,0,1,1
-52,-39,-13,0,1,1
-22,-8,-14,0,1,1
35,17,18,1,1,0
-15,-6,-9,0,1,1
2,-5,7,1,1,0
5,0,5,1,1,0
37,30,7,1,1,0
31,27,4,1,1,0
9,-7,16,1,0,1
14,8,6,1,0,1
17,13,4,1,0,1
22,26,-4,0,0,0
7,-8,15,1,0,1
53,34,19,1,0,1
-6,-13,7,1,0,1
2,9,-7,0,0,0
-12,-25,13,1,0,1
-28,-45,17,1,0,1
-22,-4,-18,0,0,0
-12,-6,-6,0,0,0
-21,-32,11,1,0,1
28,38,-10,0,0,0
22,29,-7,0,0,0
9,1,8,1,0,1
-28,-40,12,1,0,1
49,34,15,1,0,1
-49,-39,-10,0,0,0
-42,-26,-16,0,0,0
10,3,7,1,0,1
33,23,10,1,1,0
22,2,20,1,1,0
50,35,15,1,1,0
37,35,2,1,1,0
48,43,5,1,1,0
-41,-35,-6,0,1,1
22,21,1,1,1,0
14,-2,16,1,1,0
-53,-45,-8,0,1,1
37,26,11,1,1,0
-16,0,-16,0,1,1
32,17,15,1,0,1
-48,-29,-19,0,0,0
-36,-36,0,0,0,0
-14,-4,-10,0,0,0
-47,-42,-5,0,0,0
-44,-44,0,0,0,0
1,-1,2,1,0,1
-12,-15,3,1,0,1
-34,-14,-20,0,0,0
32,20,12,1,0,1
-32,-17,-15,0,0,0
-7,-8,1,1,0,1
-1,-9,8,1,1,0
27,27,0,0,1,1
34,31,3,1,1,0
-4,-10,6,1,1,0
11,19,-8,0,1,1
-3,2,-5,0,1,1
-12,-3,-9,0,1,1
0,13,-13,0,1,1
10,18,-8,0,1,1
-17,-20,3,1,1,0
-54,-45,-9,0,1,1
-10,-5,-5,0,1,1
60,43,17,1,1,0
58,40,18,1,1,0
-15,-19,4,1,1,0
9,-7,16,1,1,0
-37,-37,0,0,1,1
33,17,16,1,1,0
26,16,10,1,1,0
-37,-34,-3,0,1,1
0,-17,17,1,1,0
26,23,3,1,0,1
4,24,-20,0,0,0
48,31,17,1,0,1
38,33,5,1,0,1
-43,-24,-19,0,0,0
8,25,-17,0,0,0
-5,9,-14,0,0,0
-5,14,-19,0,0,0
16,12,4,1,0,1
7,0,7,1,0,1
-45,-34,-11,0,0,0
-17,2,-19,0,0,0
-24,-25,1,1,0,1
-52,-43,-9,0,0,0
53,33,20,1,0,1
14,13,1,1,0,1
-31,-28,-3,0,0,0
30,22,8,1,1,0
25,37,-12,0,1,1
-40,-33,-7,0,1,1
9,26,-17,0,1,1
-18,-24,6,1,1,0
-40,-41,1,1,1,0
14,4,10,1,1,0
-24,-26,2,1,1,0
45,33,12,1,1,0
-22,-9,-13,0,1,1
17,23,-6,0,0,0
-40,-24,-16,0,0,0
33,29,4,1,0,1
-46,-27,-19,0,0,0
-30,-34,4,1,0,1
-33,-23,-10,0,0,0
-23,-7,-16,0,0,0
2,-3,5,1,0,1
-27,-35,8,1,0,1
38,33,5,1,0,1
41,24,17,1,0,1
18,15,3,1,0,1
45,35,10,1,0,1
10,30,-20,0,0,0
-4,-7,3,1,0,1
-18,-23,5,1,0,1
35,27,8,1,0,1
-41,-26,-15,0,0,0
25,12,13,1,0,1
41,35,6,1,0,1
-28,-29,1,1,0,1
-3,2,-5,0,1,1
-11,-7,-4,0,1,1
-45,-38,-7,0,1,1
3,-10,13,1,1,0
31,13,18,1,1,0
-63,-43,-20,0,1,1
38,21,17,1,1,0
9,-5,14,1,1,0
-30,-22,-8,0,1,1
-26,-27,1,1,1,0
38,22,16,1,1,0
38,24,14,1,1,0
45,34,11,1,1,0
37,22,15,1,1,0
55,36,19,1,1,0
-2,16,-18,0,1,1
36,25,11,1,1,0
-19,-6,-13,0,1,1
-33,-16,-17,0,0,0
-24,-14,-10,0,0,0
-8,8,-16,0,0,0
-43,-27,-16,0,0,0
28,17,11,1,0,1
-8,-20,12,1,0,1
-57,-40,-17,0,0,0
40,34,6,1,0,1
-41,-21,-20,0,0,0
6,13,-7,0,0,0
-50,-38,-12,0,0,0
42,24,18,1,0,1
26,25,1,1,0,1
12,10,2,1,0,1
5,10,-5,0,0,0
46,30,16,1,0,1
-31,-11,-20,0,0,0
20,17,3,1,0,1
31,16,15,1,0,1
-18,-8,-10,0,0,0
-19,-12,-7,0,0,0
-36,-34,-2,0,1,1
-36,-27,-9,0,1,1
-42,-22,-20,0,1,1
42,22,20,1,1,0
-26,-15,-11,0,1,1
-7,-18,11,1,1,0
-15,-1,-14,0,1,1
1,-19,20,1,1,0
-27,-30,3,1,1,0
-24,-38,14,1,1,0
-33,-45,12,1,1,0
-7,6,-13,0,1,1
25,40,-15,0,1,1
27,25,2,1,1,0
4,-4,8,1,1,0
-40,-22,-18,0,1,1
11,13,-2,0,1,1
33,42,-9,0,1,1
46,29,17,1,1,0
19,18,1,1,0,1
-58,-42,-16,0,0,0
17,10,7,1,0,1
-56,-42,-14,0,0,0
40,40,0,0,0,0
-28,-41,13,1,0,1
6,15,-9,0,0,0
20,11,9,1,0,1
-1,9,-10,0,1,1
38,25,13,1,1,0
-24,-10,-14,0,1,1
25,17,8,1,1,0
-47,-32,-15,0,1,1
41,27,14,1,1,0
16,1,15,1,1,0
16,9,7,1,1,0
36,17,19,1,1,0
42,44,-2,0,1,1
-9,-21,12,1,1,0
8,19,-11,0,1,1
24,29,-5,0,1,1
21,28,-7,0,1,1
53,40,13,1,0,1
-25,-15,-10,0,0,0
7,-12,19,1,0,1
-2,-14,12,1,0,1
0,5,-5,0,0,0
20,8,12,1,0,1
18,23,-5,0,0,0
16,7,9,1,0,1
-64,-44,-20,0,0,0
18,21,-3,0,0,0
26,36,-10,0,0,0
53,42,11,1,0,1
-61,-45,-16,0,0,0
-18,-26,8,1,0,1
17,1,16,1,0,1
-8,-13,5,1,0,1
3,-5,8,1,0,1
-45,-44,-1,0,0,0
-36,-37,1,1,0,1
19,15,4,1,0,1
23,14,9,1,0,1
9,23,-14,0,1,1
-38,-41,3,1,1,0
-31,-37,6,1,1,0
27,37,-10,0,1,1
-32,-39,7,1,1,0
-12,-2,-10,0,1,1
27,10,17,1,1,0
-41,-42,1,1,1,0
25,40,-15,0,1,1
-20,-21,1,1,1,0
-23,-14,-9,0,1,1
39,30,9,1,1,0
25,10,15,1,1,0
-18,-21,3,1,0,1
-6,6,-12,0,0,0
-2,13,-15,0,0,0
-29,-41,12,1,0,1
3,9,-6,0,0,0
-15,3,-18,0,0,0
-43,-34,-9,0,0,0
5,11,-6,0,0,0
6,2,4,1,0,1
56,40,16,1,0,1
-37,-17,-20,0,0,0
-40,-21,-19,0,0,0
-47,-35,-12,0,0,0
-28,-14,-14,0,0,0
7,-10,17,1,0,1
-13,2,-15,0,0,0
8,9,-1,0,0,0
-17,-15,-2,0,0,0
-11,8,-19,0,1,1
6,-5,11,1,1,0
-38,-28,-10,0,1,1
28,38,-10,0,1,1
12,-4,16,1,1,0
-54,-37,-17,0,1,1
-13,7,-20,0,1,1
-38,-33,-5,0,1,1
22,14,8,1,1,0
-23,-3,-20,0,1,1
41,40,1,1,1,0
-19,-12,-7,0,1,1
29,14,15,1,1,0
33,19,14,1,1,0
32,14,18,1,1,0
0,5,-5,0,1,1
9,-5,14,1,0,1
-4,16,-20,0,0,0
-19,-25,6,1,0,1
17,0,17,1,0,1
32,37,-5,0,0,0
11,27,-16,0,0,0
-25,-29,4,1,0,1
32,24,8,1,0,1
-6,-16,10,1,0,1
6,-5,11,1,0,1
-22,-40,18,1,0,1
-52,-40,-12,0,0,0
-5,-21,16,1,0,1
18,32,-14,0,1,1
13,17,-4,0,1,1
58,39,19,1,1,0
-45,-29,-16,0,1,1
-28,-41,13,1,1,0
27,7,20,1,1,0
-41,-25,-16,0,1,1
-21,-41,20,1,1,0
25,42,-17,0,1,1
-2,-22,20,1,1,0
-22,-39,17,1,1,0
-9,-21,12,1,1,0
3,-1,4,1,0,1
-58,-39,-19,0,0,0
-21,-2,-19,0,0,0
20,13,7,1,0,1
-28,-27,-1,0,0,0
2,-3,5,1,0,1
-15,-18,3,1,0,1
-36,-17,-19,0,0,0
33,18,15,1,0,1
-12,-10,-2,0,0,0
-1,13,-14,0,0,0
30,31,-1,0,1,1
-42,-31,-11,0,1,1
58,40,18,1,1,0
-59,-43,-16,0,1,1
-11,-25,14,1,1,0
-20,-19,-1,0,1,1
-50,-30,-20,0,1,1
46,31,15,1,1,0
3,10,-7,0,1,1
-25,-20,-5,0,1,1
19,8,11,1,1,0
-38,-34,-4,0,1,1
9,-4,13,1,1,0
-8,2,-10,0,1,1
-3,3,-6,0,0,0
-17,-10,-7,0,0,0
-6,-8,2,1,0,1
-30,-22,-8,0,0,0
-34,-33,-1,0,0,0
-37,-41,4,1,0,1
-23,-10,-13,0,0,0
-11,-1,-10,0,0,0
35,43,-8,0,0,0
-39,-20,-19,0,0,0
46,28,18,1,0,1
19,14,5,1,0,1
-15,4,-19,0,0,0
-6,-8,2,1,0,1
0,-16,16,1,0,1
25,27,-2,0,0,0
13,16,-3,0,0,0
-25,-36,11,1,0,1
-54,-34,-20,0,0,0
38,23,15,1,0,1
8,15,-7,0,0,0
-7,0,-7,0,1,1
30,20,10,1,1,0
35,41,-6,0,1,1
16,15,1,1,1,0
11,16,-5,0,1,1
25,29,-4,0,1,1
14,33,-19,0,1,1
-37,-33,-4,0,1,1
37,17,20,1,1,0
-35,-45,10,1,1,0
22,37,-15,0,1,1
-35,-26,-9,0,1,1
39,41,-2,0,1,1
-32,-39,7,1,0,1
14,-1,15,1,0,1
-2,17,-19,0,0,0
18,28,-10,0,0,0
-23,-23,0,0,0,0
1,-5,6,1,0,1
-27,-14,-13,0,0,0
6,-8,14,1,0,1
34,37,-3,0,0,0
9,16,-7,0,0,0
-39,-25,-14,0,0,0
-38,-31,-7,0,0,0
-24,-5,-19,0,0,0
3,-17,20,1,0,1
0,4,-4,0,0,0
16,16,0,0,0,0
-24,-24,0,0,0,0
30,40,-10,0,0,0
-5,8,-13,0,0,0
12,21,-9,0,0,0
50,42,8,1,1,0
13,21,-8,0,1,1
40,40,0,0,1,1
-9,-1,-8,0,1,1
23,30,-7,0,1,1
8,8,0,0,1,1
39,28,11,1,1,0
20,38,-18,0,1,1
16,15,1,1,1,0
14,14,0,0,0,0
8,7,1,1,0,1
-31,-29,-2,0,0,0
-26,-36,10,1,0,1
5,19,-14,0,0,0
17,-1,18,1,0,1
-2,-6,4,1,0,1
-10,-25,15,1,0,1
38,19,19,1,0,1
-20,-35,15,1,0,1
-4,-23,19,1,0,1
6,10,-4,0,0,0
40,34,6,1,0,1
-18,-14,-4,0,0,0
-54,-41,-13,0,0,0
46,36,10,1,0,1
27,28,-1,0,0,0
5,18,-13,0,0,0
-25,-22,-3,0,0,0
57,44,13,1,0,1
1,-18,19,1,0,1
-39,-25,-14,0,1,1
11,20,-9,0,1,1
-49,-34,-15,0,1,1
-51,-36,-15,0,1,1
63,43,20,1,1,0
27,28,-1,0,1,1
6,4,2,1,1,0
40,40,0,0,1,1
-11,-13,2,1,1,0
-17,-25,8,1,1,0
8,6,2,1,1,0
-30,-20,-10,0,1,1
-7,2,-9,0,1,1
-34,-21,-13,0,1,1
27,40,-13,0,1,1
42,41,1,1,0,1
-43,-24,-19,0,0,0
8,17,-9,0,0,0
-58,-41,-17,0,0,0
-8,-16,8,1,0,1
-33,-41,8,1,0,1
-18,-29,11,1,0,1
1,-14,15,1,0,1
3,-15,18,1,0,1
-28,-24,-4,0,0,0
-23,-32,9,1,0,1
-6,-23,17,1,0,1
-55,-35,-20,0,0,0
-42,-27,-15,0,0,0
-10,-19,9,1,0,1
-42,-27,-15,0,0,0
-37,-45,8,1,0,1
-44,-26,-18,0,0,0
16,13,3,1,0,1
-26,-28,2,1,0,1
2,-2,4,1,0,1
31,13,18,1,1,0
-3,-14,11,1,1,0
-50,-32,-18,0,1,1
11,11,0,0,1,1
-23,-23,0,0,1,1
-51,-31,-20,0,1,1
1,5,-4,0,1,1
-12,-17,5,1,1,0
52,43,9,1,1,0
-2,-17,15,1,1,0
-61,-45,-16,0,1,1
42,38,4,1,1,0
6,18,-12,0,1,1
-30,-20,-10,0,1,1
-45,-36,-9,0,0,0
-17,-20,3,1,0,1
-16,-18,2,1,0,1
5,13,-8,0,0,0
-12,-21,9,1,0,1
-61,-44,-17,0,0,0
7,-10,17,1,0,1
-18,-19,1,1,0,1
-34,-14,-20,0,0,0
-25,-38,13,1,0,1
-7,3,-10,0,0,0
12,2,10,1,0,1
32,24,8,1,0,1
16,19,-3,0,0,0
-18,-38,20,1,0,1
2,-5,7,1,0,1
-12,-16,4,1,0,1
-7,-27,20,1,0,1
-8,-15,7,1,0,1
-37,-21,-16,0,0,0
-31,-17,-14,0,0,0
-18,-16,-2,0,1,1
-18,-36,18,1,1,0
-11,-6,-5,0,1,1
-15,-28,13,1,1,0
26,9,17,1,1,0
3,13,-10,0,1,1
-24,-40,16,1,1,0
13,10,3,1,1,0
-46,-40,-6,0,1,1
-12,-3,-9,0,1,1
-13,-1,-12,0,1,1
45,36,9,1,1,0
-17,-5,-12,0,1,1
-7,-9,2,1,1,0
38,29,9,1,1,0
-34,-15,-19,0,1,1
-5,-15,10,1,1,0
4,-1,5,1,1,0
44,36,8,1,1,0
38,37,1,1,1,0
33,36,-3,0,1,1
38,34,4,1,0,1
-9,-28,19,1,0,1
41,28,13,1,0,1
-24,-22,-2,0,0,0
4,13,-9,0,0,0
29,13,16,1,0,1
32,43,-11,0,0,0
-54,-45,-9,0,0,0
20,24,-4,0,0,0
52,35,17,1,1,0
-44,-35,-9,0,1,1
0,-13,13,1,1,0
-39,-41,2,1,1,0
43,29,14,1,1,0
-32,-30,-2,0,1,1
-17,-11,-6,0,1,1
-8,7,-15,0,1,1
-15,-23,8,1,1,0
-29,-14,-15,0,1,1
-43,-36,-7,0,1,1
-15,-6,-9,0,1,1
-12,-4,-8,0,0,0
13,19,-6,0,0,0
19,30,-11,0,0,0
6,10,-4,0,0,0
39,22,17,1,0,1
-34,-28,-6,0,0,0
-11,7,-18,0,0,0
51,36,15,1,0,1
-16,-23,7,1,0,1
17,1,16,1,0,1
55,35,20,1,1,0
7,6,1,1,1,0
-45,-44,-1,0,1,1
-16,-30,14,1,1,0
-34,-41,7,1,1,0
-11,-4,-7,0,1,1
-12,-28,16,1,1,0
-24,-40,16,1,1,0
-7,-21,14,1,1,0
-53,-34,-19,0,1,1
18,0,18,1,0,1
3,23,-20,0,0,0
15,24,-9,0,0,0
-9,7,-16,0,0,0
5,-11,16,1,0,1
-35,-23,-12,0,0,0
-34,-35,1,1,0,1
51,33,18,1,0,1
1,1,0,0,0,0
-54,-45,-9,0,0,0
52,33,19,1,0,1
-19,-8,-11,0,1,1
33,20,13,1,1,0
-47,-32,-15,0,1,1
-26,-44,18,1,1,0
28,35,-7,0,1,1
-25,-21,-4,0,1,1
20,32,-12,0,1,1
-59,-42,-17,0,1,1
-6,10,-16,0,1,1
-3,-6,3,1,1,0
33,29,4,1,0,1
-60,-42,-18,0,0,0
-5,11,-16,0,0,0
-48,-30,-18,0,0,0
-13,6,-19,0,0,0
-11,-16,5,1,0,1
5,-3,8,1,0,1
-5,-16,11,1,0,1
-8,8,-16,0,0,0
55,42,13,1,0,1
-9,-20,11,1,0,1
-61,-45,-16,0,0,0
-14,-25,11,1,0,1
44,40,4,1,1,0
-13,0,-13,0,1,1
3,12,-9,0,1,1
-40,-45,5,1,1,0
-20,-10,-10,0,1,1
10,3,7,1,1,0
-54,-38,-16,0,1,1
-29,-12,-17,0,1,1
24,22,2,1,0,1
-26,-40,14,1,0,1
-8,-4,-4,0,0,0
-64,-45,-19,0,0,0
30,42,-12,0,0,0
16,12,4,1,0,1
-40,-26,-14,0,0,0
-38,-36,-2,0,0,0
-39,-35,-4,0,0,0
-21,-15,-6,0,0,0
-48,-39,-9,0,1,1
15,29,-14,0,1,1
30,37,-7,0,1,1
-33,-29,-4,0,1,1
13,6,7,1,1,0
9,4,5,1,1,0
10,10,0,0,1,1
57,37,20,1,1,0
36,44,-8,0,1,1
-12,3,-15,0,1,1
31,26,5,1,1,0
-41,-21,-20,0,1,1
15,14,1,1,0,1
33,21,12,1,0,1
-38,-33,-5,0,0,0
10,12,-2,0,0,0
36,22,14,1,0,1
11,-5,16,1,0,1
35,19,16,1,0,1
10,15,-5,0,0,0
-11,-26,15,1,1,0
-41,-39,-2,0,1,1
25,31,-6,0,1,1
-9,11,-20,0,1,1
-14,-17,3,1,1,0
1,21,-20,0,1,1
-16,-23,7,1,1,0
23,6,17,1,1,0
-7,4,-11,0,1,1
-17,2,-19,0,1,1
-10,-27,17,1,1,0
44,28,16,1,1,0
9,-11,20,1,1,0
-33,-17,-16,0,1,1
44,28,16,1,1,0
-9,1,-10,0,1,1
-20,-3,-17,0,1,1
-16,-9,-7,0,0,0
-3,-2,-1,0,0,0
8,2,6,1,0,1
-3,-20,17,1,0,1
18,13,5,1,0,1
-46,-29,-17,0,0,0
-15,-9,-6,0,0,0
-7,0,-7,0,0,0
-32,-40,8,1,0,1
-28,-32,4,1,0,1
3,-13,16,1,0,1
12,18,-6,0,0,0
49,31,18,1,0,1
-31,-44,13,1,0,1
23,37,-14,0,0,0
-6,13,-19,0,0,0
24,43,-19,0,0,0
-23,-17,-6,0,0,0
11,24,-13,0,1,1
9,19,-10,0,1,1
-12,-29,17,1,1,0
15,23,-8,0,1,1
15,9,6,1,1,0
-13,-11,-2,0,1,1
34,20,14,1,1,0
13,20,-7,0,1,1
-27,-21,-6,0,1,1
36,17,19,1,1,0
34,20,14,1,1,0
-12,-24,12,1,1,0
-3,9,-12,0,1,1
-12,7,-19,0,1,1
-3,10,-13,0,1,1
50,42,8,1,1,0
-7,7,-14,0,1,1
9,24,-15,0,0,0
2,-18,20,1,0,1
-53,-34,-19,0,0,0
36,25,11,1,0,1
-5,-25,20,1,0,1
-39,-21,-18,0,0,0
12,26,-14,0,0,0
4,13,-9,0,0,0
-10,-20,10,1,0,1
-37,-35,-2,0,1,1
-21,-40,19,1,1,0
-39,-31,-8,0,1,1
-30,-31,1,1,1,0
32,15,17,1,1,0
6,17,-11,0,1,1
26,24,2,1,1,0
1,19,-18,0,1,1
40,37,3,1,1,0
-55,-41,-14,0,1,1
9,22,-13,0,1,1
17,8,9,1,1,0
-19,-25,6,1,1,0
-23,-27,4,1,1,0
-18,-4,-14,0,1,1
-7,-19,12,1,1,0
8,6,2,1,1,0
13,-5,18,1,1,0
-8,-2,-6,0,1,1
-11,-31,20,1,1,0
-48,-39,-9,0,0,0
44,33,11,1,0,1
-32,-15,-17,0,0,0
-18,-21,3,1,0,1
-22,-29,7,1,0,1
-19,-23,4,1,0,1
40,25,15,1,0,1
11,15,-4,0,0,0
1,-17,18,1,0,1
-30,-37,7,1,0,1
-53,-41,-12,0,0,0
-20,-16,-4,0,0,0
9,4,5,1,1,0
3,-8,11,1,1,0
28,37,-9,0,1,1
26,34,-8,0,1,1
0,-2,2,1,1,0
2,-17,19,1,1,0
-28,-13,-15,0,1,1
11,8,3,1,1,0
42,32,10,1,1,0
-8,-8,0,0,1,1
9,2,7,1,1,0
-21,-9,-12,0,1,1
-55,-40,-15,0,1,1
-23,-14,-9,0,1,1
-5,-10,5,1,1,0
-7,4,-11,0,1,1
16,4,12,1,1,0
-24,-10,-14,0,1,1
-35,-42,7,1,0,1
-21,-18,-3,0,0,0
18,33,-15,0,0,0
-16,-8,-8,0,0,0
55,42,13,1,0,1
-22,-9,-13,0,0,0
-10,-30,20,1,0,1
-59,-44,-15,0,0,0
-18,-25,7,1,0,1
5,-1,6,1,1,0
-37,-17,-20,0,1,1
45,39,6,1,1,0
29,28,1,1,1,0
9,0,9,1,1,0
-29,-36,7,1,1,0
-30,-34,4,1,1,0
13,5,8,1,1,0
-10,-17,7,1,1,0
9,-6,15,1,1,0
-4,3,-7,0,1,1
50,30,20,1,1,0
36,35,1,1,0,1
15,22,-7,0,0,0
20,16,4,1,0,1
30,35,-5,0,0,0
27,44,-17,0,0,0
-10,0,-10,0,0,0
-48,-42,-6,0,0,0
-20,-27,7,1,0,1
8,12,-4,0,0,0
35,39,-4,0,0,0
-59,-40,-19,0,0,0
30,39,-9,0,0,0
17,33,-16,0,0,0
-36,-44,8,1,0,1
9,-6,15,1,0,1
-3,6,-9,0,0,0
-39,-29,-10,0,0,0
-22,-29,7,1,0,1
16,19,-3,0,0,0
-6,-18,12,1,0,1
-50,-34,-16,0,0,0
-57,-45,-12,0,1,1
41,42,-1,0,1,1
-7,-1,-6,0,1,1
56,38,18,1,1,0
31,18,13,1,1,0
-2,-6,4,1,1,0
36,27,9,1,1,0
-11,-13,2,1,1,0
0,-6,6,1,1,0
-19,-11,-8,0,1,1
-14,-27,13,1,1,0
-29,-26,-3,0,1,1
0,-12,12,1,0,1
22,22,0,0,0,0
-5,9,-14,0,0,0
46,28,18,1,0,1
15,20,-5,0,0,0
-31,-45,14,1,0,1
-38,-20,-18,0,0,0
-9,-4,-5,0,0,0
4,15,-11,0,0,0
-23,-39,16,1,0,1
2,20,-18,0,0,0
20,24,-4,0,0,0
-45,-36,-9,0,0,0
14,7,7,1,1,0
-1,-15,14,1,1,0
-29,-12,-17,0,1,1
-11,-17,6,1,1,0
35,22,13,1,1,0
-11,-28,17,1,1,0
25,6,19,1,1,0
41,39,2,1,1,0
-21,-1,-20,0,1,1
53,37,16,1,0,1
3,17,-14,0,0,0
-12,-24,12,1,0,1
19,8,11,1,0,1
-15,-33,18,1,0,1
-37,-23,-14,0,0,0
-36,-30,-6,0,0,0
-21,-13,-8,0,0,0
27,32,-5,0,0,0
33,36,-3,0,0,0
21,23,-2,0,0,0
26,14,12,1,0,1
-7,-7,0,0,0,0
10,-4,14,1,0,1
-14,-28,14,1,1,0
11,-1,12,1,1,0
-26,-34,8,1,1,0
18,-2,20,1,1,0
19,2,17,1,1,0
3,5,-2,0,1,1
-21,-33,12,1,1,0
-4,-8,4,1,1,0
-11,-24,13,1,1,0
-19,-35,16,1,1,0
36,25,11,1,0,1
-22,-39,17,1,0,1
-24,-12,-12,0,0,0
-17,-29,12,1,0,1
37,21,16,1,0,1
-5,10,-15,0,0,0
27,38,-11,0,0,0
-15,-29,14,1,0,1
-2,5,-7,0,0,0
-2,-8,6,1,0,1
53,43,10,1,0,1
-22,-36,14,1,0,1
37,24,13,1,0,1
-18,1,-19,0,0,0
-40,-41,1,1,0,1
31,14,17,1,0,1
5,-4,9,1,0,1
40,39,1,1,0,1
30,29,1,1,1,0
44,40,4,1,1,0
2,-17,19,1,1,0
-29,-12,-17,0,1,1
47,38,9,1,1,0
-20,-9,-11,0,1,1
26,6,20,1,1,0
45,25,20,1,1,0
-10,-6,-4,0,1,1
-11,-7,-4,0,1,1
-7,-17,10,1,1,0
1,-1,2,1,1,0
-17,-15,-2,0,1,1
-31,-30,-1,0,1,1
-20,-29,9,1,1,0
46,41,5,1,1,0
-33,-37,4,1,1,0
-36,-26,-10,0,1,1
7,-2,9,1,1,0
-52,-39,-13,0,1,1
8,-7,15,1,1,0
15,32,-17,0,0,0
-25,-43,18,1,0,1
35,28,7,1,0,1
-30,-43,13,1,0,1
-31,-33,2,1,0,1
0,-13,13,1,0,1
-42,-22,-20,0,0,0
-2,13,-15,0,0,0
-5,-11,6,1,0,1
-8,-1,-7,0,0,0
0,-19,19,1,0,1
33,42,-9,0,0,0
-21,-3,-18,0,0,0
-14,-2,-12,0,0,0
-12,-24,12,1,0,1
-46,-31,-15,0,1,1
-14,2,-16,0,1,1
-19,-26,7,1,1,0
16,31,-15,0,1,1
-49,-41,-8,0,1,1
-11,-19,8,1,1,0
-27,-37,10,1,1,0
-15,-23,8,1,1,0
-33,-43,10,1,1,0
-7,3,-10,0,1,1
10,12,-2,0,1,1
22,8,14,1,1,0
25,24,1,1,1,0
7,13,-6,0,1,1
-32,-36,4,1,1,0
17,10,7,1,1,0
23,37,-14,0,1,1
-2,-11,9,1,1,0
3,21,-18,0,1,1
-26,-10,-16,0,1,1
-16,-28,12,1,0,1
5,7,-2,0,0,0
3,4,-1,0,0,0
-18,-17,-1,0,0,0
4,-10,14,1,0,1
11,19,-8,0,0,0
-37,-17,-20,0,0,0
-18,-29,11,1,0,1
-19,-7,-12,0,0,0
-37,-34,-3,0,1,1
34,32,2,1,1,0
-5,-18,13,1,1,0
-33,-43,10,1,1,0
-48,-38,-10,0,1,1
57,42,15,1,1,0
-61,-45,-16,0,1,1
23,29,-6,0,1,1
44,43,1,1,1,0
-24,-23,-1,0,1,1
11,23,-12,0,1,1
-18,-16,-2,0,0,0
-24,-44,20,1,0,1
3,-12,15,1,0,1
-30,-34,4,1,0,1
21,18,3,1,0,1
11,-5,16,1,0,1
-19,-38,19,1,0,1
-38,-29,-9,0,0,0
-10,1,-11,0,0,0
10,18,-8,0,0,0
35,36,-1,0,0,0
-11,-24,13,1,0,1
-44,-24,-20,0,0,0
-34,-36,2,1,0,1
18,35,-17,0,0,0
-15,-28,13,1,0,1
-15,-23,8,1,0,1
31,13,18,1,0,1
-40,-38,-2,0,0,0
-40,-31,-9,0,0,0
-20,-39,19,1,0,1
51,38,13,1,1,0
-37,-37,0,0,1,1
32,32,0,0,1,1
-34,-18,-16,0,1,1
4,-15,19,1,1,0
-23,-37,14,1,1,0
-31,-13,-18,0,1,1
36,23,13,1,1,0
-36,-19,-17,0,1,1
16,35,-19,0,1,1
16,14,2,1,1,0
2,4,-2,0,1,1
-17,-6,-11,0,1,1
-19,-18,-1,0,1,1
1,-19,20,1,0,1
5,3,2,1,0,1
-12,8,-20,0,0,0
-30,-16,-14,0,0,0
42,39,3,1,0,1
20,5,15,1,0,1
20,35,-15,0,0,0
-23,-34,11,1,0,1
-8,-10,2,1,0,1
-4,-22,18,1,0,1
-44,-38,-6,0,0,0
-41,-44,3,1,0,1
-20,-24,4,1,0,1
0,-20,20,1,1,0
40,30,10,1,1,0
28,36,-8,0,1,1
43,25,18,1,1,0
13,3,10,1,1,0
-1,-8,7,1,1,0
-42,-24,-18,0,1,1
-28,-8,-20,0,1,1
0,6,-6,0,1,1
5,10,-5,0,1,1
35,35,0,0,1,1
20,34,-14,0,1,1
-12,0,-12,0,1,1
-14,-29,15,1,1,0
-27,-15,-12,0,1,1
-8,-1,-7,0,1,1
18,1,17,1,1,0
-14,-25,11,1,1,0
10,26,-16,0,1,1
-50,-45,-5,0,1,1
36,38,-2,0,1,1
-49,-34,-15,0,0,0
-16,-10,-6,0,0,0
-38,-39,1,1,0,1
14,10,4,1,0,1
21,13,8,1,0,1
-40,-26,-14,0,0,0
43,43,0,0,0,0
37,22,15,1,0,1
-10,3,-13,0,0,0
12,5,7,1,0,1
52,34,18,1,0,1
-49,-44,-5,0,1,1
-31,-38,7,1,1,0
-24,-30,6,1,1,0
45,26,19,1,1,0
-56,-37,-19,0,1,1
2,10,-8,0,1,1
-24,-16,-8,0,1,1
-5,-16,11,1,1,0
-49,-32,-17,0,1,1
25,10,15,1,1,0
-2,18,-20,0,1,1
-30,-34,4,1,1,0
-30,-41,11,1,1,0
21,37,-16,0,1,1
-19,-24,5,1,1,0
-16,-34,18,1,1,0
51,32,19,1,1,0
21,14,7,1,1,0
-21,-39,18,1,1,0
37,28,9,1,1,0
4,9,-5,0,1,1
22,28,-6,0,0,0
-15,3,-18,0,0,0
-10,2,-12,0,0,0
-34,-33,-1,0,0,0
-30,-19,-11,0,0,0
48,28,20,1,0,1
28,33,-5,0,0,0
-50,-42,-8,0,0,0
1,13,-12,0,0,0
38,30,8,1,0,1
11,15,-4,0,0,0
35,29,6,1,0,1
-27,-11,-16,0,0,0
-23,-40,17,1,0,1
-36,-34,-2,0,0,0
-24,-24,0,0,0,0
-38,-19,-19,0,0,0
15,8,7,1,0,1
-34,-36,2,1,0,1
9,-8,17,1,0,1
-50,-36,-14,0,0,0
19,32,-13,0,1,1
-57,-44,-13,0,1,1
-33,-29,-4,0,1,1
-7,-14,7,1,1,0
59,39,20,1,1,0
26,21,5,1,1,0
10,19,-9,0,1,1
14,25,-11,0,1,1
-6,-25,19,1,0,1
16,33,-17,0,0,0
12,29,-17,0,0,0
-37,-31,-6,0,0,0
35,41,-6,0,0,0
-8,-13,5,1,0,1
-52,-38,-14,0,0,0
-5,-6,1,1,0,1
15,35,-20,0,0,0
-27,-27,0,0,0,0
-9,-6,-3,0,0,0
-16,-3,-13,0,0,0
16,19,-3,0,0,0
-23,-29,6,1,0,1
-39,-19,-20,0,0,0
-10,-21,11,1,0,1
5,8,-3,0,0,0
-39,-31,-8,0,0,0
17,5,12,1,1,0
16,10,6,1,1,0
14,30,-16,0,1,1
-26,-29,3,1,1,0
10,-8,18,1,1,0
29,15,14,1,1,0
-18,-33,15,1,1,0
24,9,15,1,1,0
40,40,0,0,1,1
29,33,-4,0,1,1
-7,11,-18,0,1,1
-26,-15,-11,0,1,1
6,18,-12,0,1,1
54,38,16,1,1,0
-37,-38,1,1,0,1
42,26,16,1,0,1
38,37,1,1,0,1
27,19,8,1,0,1
36,38,-2,0,0,0
-36,-34,-2,0,0,0
-51,-41,-10,0,0,0
23,18,5,1,0,1
29,25,4,1,1,0
41,29,12,1,1,0
23,10,13,1,1,0
-18,-28,10,1,1,0
-20,-37,17,1,1,0
34,15,19,1,1,0
12,14,-2,0,1,1
-5,-17,12,1,1,0
-5,0,-5,0,0,0
48,33,15,1,0,1
-27,-41,14,1,0,1
19,39,-20,0,0,0
15,0,15,1,0,1
-35,-19,-16,0,0,0
43,36,7,1,0,1
19,13,6,1,0,1
-4,-21,17,1,0,1
-37,-19,-18,0,0,0
29,33,-4,0,0,0
-2,-21,19,1,0,1
15,19,-4,0,0,0
51,36,15,1,0,1
-12,-5,-7,0,0,0
20,23,-3,0,1,1
13,11,2,1,1,0
23,28,-5,0,1,1
60,40,20,1,1,0
-6,-11,5,1,1,0
-32,-17,-15,0,1,1
6,1,5,1,1,0
4,-3,7,1,1,0
-26,-28,2,1,1,0
33,37,-4,0,0,0
12,32,-20,0,0,0
-4,-15,11,1,0,1
23,15,8,1,0,1
2,-18,20,1,0,1
52,39,13,1,0,1
9,2,7,1,0,1
31,40,-9,0,0,0
-26,-31,5,1,0,1
29,40,-11,0,1,1
56,43,13,1,1,0
7,-5,12,1,1,0
51,43,8,1,1,0
-35,-25,-10,0,1,1
11,-2,13,1,1,0
-37,-32,-5,0,1,1
-41,-42,1,1,1,0
25,13,12,1,1,0
34,25,9,1,1,0
10,13,-3,0,0,0
53,43,10,1,0,1
-37,-39,2,1,0,1
-15,-4,-11,0,0,0
-22,-39,17,1,0,1
-24,-15,-9,0,0,0
7,-3,10,1,0,1
-42,-29,-13,0,0,0
-38,-26,-12,0,0,0
-2,12,-14,0,0,0
35,25,10,1,0,1
-8,-11,3,1,0,1
15,21,-6,0,0,0
-38,-21,-17,0,0,0
37,22,15,1,0,1
-11,-28,17,1,0,1
29,27,2,1,0,1
-24,-31,7,1,1,0
24,44,-20,0,1,1
-8,-5,-3,0,1,1
-1,13,-14,0,1,1
11,-1,12,1,1,0
29,32,-3,0,1,1
14,28,-14,0,1,1
-9,-18,9,1,1,0
-39,-27,-12,0,1,1
-15,-20,5,1,1,0
0,18,-18,0,1,1
42,29,13,1,1,0
-28,-22,-6,0,1,1
4,-11,15,1,1,0
16,-1,17,1,1,0
14,15,-1,0,1,1
9,-8,17,1,1,0
-24,-27,3,1,1,0
-15,-1,-14,0,1,1
22,41,-19,0,1,1
37,43,-6,0,1,1
61,42,19,1,0,1
-15,-31,16,1,0,1
31,16,15,1,0,1
27,9,18,1,0,1
53,36,17,1,0,1
-64,-45,-19,0,0,0
-2,-20,18,1,0,1
-37,-26,-11,0,0,0
0,14,-14,0,0,0
4,1,3,1,0,1
9,-8,17,1,0,1
-29,-41,12,1,0,1
19,36,-17,0,0,0
-4,12,-16,0,0,0
-35,-40,5,1,1,0
-19,-8,-11,0,1,1
14,-4,18,1,1,0
-41,-34,-7,0,1,1
-5,-22,17,1,1,0
-9,2,-11,0,1,1
-36,-33,-3,0,1,1
50,32,18,1,1,0
-24,-17,-7,0,1,1
5,-14,19,1,0,1
23,11,12,1,0,1
42,43,-1,0,0,0
-6,1,-7,0,0,0
-40,-37,-3,0,0,0
-47,-27,-20,0,0,0
-2,10,-12,0,0,0
-49,-36,-13,0,0,0
-5,3,-8,0,0,0
8,-4,12,1,0,1
28,10,18,1,1,0
39,21,18,1,1,0
-11,-17,6,1,1,0
43,26,17,1,1,0
42,27,15,1,1,0
-26,-39,13,1,1,0
-8,-3,-5,0,1,1
-9,-22,13,1,1,0
9,25,-16,0,1,1
-4,-9,5,1,1,0
19,38,-19,0,1,1
12,-7,19,1,1,0
13,-4,17,1,1,0
-10,8,-18,0,1,1
7,-8,15,1,1,0
7,-13,20,1,1,0
39,43,-4,0,1,1
-26,-45,19,1,1,0
39,28,11,1,1,0
49,32,17,1,1,0
6,-7,13,1,1,0
-23,-8,-15,0,0,0
24,17,7,1,0,1
-39,-29,-10,0,0,0
27,38,-11,0,0,0
-40,-35,-5,0,0,0
-44,-30,-14,0,0,0
-40,-40,0,0,0,0
-34,-21,-13,0,0,0
17,34,-17,0,0,0
39,33,6,1,1,0
24,17,7,1,1,0
3,-13,16,1,1,0
-43,-42,-1,0,1,1
-27,-30,3,1,1,0
-49,-40,-9,0,1,1
-47,-38,-9,0,1,1
47,43,4,1,1,0
-49,-29,-20,0,1,1
-5,-18,13,1,1,0
8,11,-3,0,1,1
28,10,18,1,1,0
27,15,12,1,1,0
-49,-44,-5,0,1,1
12,23,-11,0,1,1
14,20,-6,0,1,1
-27,-30,3,1,1,0
-10,-19,9,1,1,0
18,26,-8,0,1,1
-18,-21,3,1,1,0
14,31,-17,0,1,1
11,26,-15,0,0,0
-17,3,-20,0,0,0
-1,-18,17,1,0,1
6,15,-9,0,0,0
-37,-43,6,1,0,1
-37,-24,-13,0,0,0
4,2,2,1,0,1
39,42,-3,0,0,0
-24,-18,-6,0,0,0
49,31,18,1,0,1
21,34,-13,0,0,0
18,14,4,1,0,1
-47,-32,-15,0,0,0
19,6,13,1,0,1
-21,-26,5,1,0,1
1,-16,17,1,0,1
-12,-23,11,1,1,0
17,19,-2,0,1,1
37,39,-2,0,1,1
-8,-7,-1,0,1,1
-45,-30,-15,0,1,1
11,24,-13,0,1,1
-1,-14,13,1,1,0
50,43,7,1,1,0
-20,-38,18,1,0,1
12,14,-2,0,0,0
-40,-25,-15,0,0,0
8,6,2,1,0,1
21,4,17,1,0,1
-18,-29,11,1,0,1
-34,-38,4,1,0,1
-10,-13,3,1,0,1
-15,-7,-8,0,0,0
46,42,4,1,0,1
-25,-22,-3,0,0,0
-26,-32,6,1,0,1
20,39,-19,0,0,0
-24,-24,0,0,0,0
-34,-31,-3,0,0,0
-34,-22,-12,0,0,0
11,31,-20,0,0,0
27,27,0,0,0,0
10,9,1,1,0,1
-2,13,-15,0,0,0
-55,-39,-16,0,0,0
-22,-4,-18,0,1,1
56,40,16,1,1,0
-48,-37,-11,0,1,1
58,43,15,1,1,0
-28,-21,-7,0,1,1
-9,-26,17,1,1,0
-60,-44,-16,0,1,1
45,35,10,1,1,0
-5,-2,-3,0,1,1
4,-10,14,1,1,0
35,17,18,1,1,0
-10,-1,-9,0,1,1
-50,-31,-19,0,1,1
5,-8,13,1,0,1
42,25,17,1,0,1
-50,-38,-12,0,0,0
-21,-18,-3,0,0,0
-44,-36,-8,0,0,0
35,24,11,1,0,1
-32,-20,-12,0,0,0
-39,-35,-4,0,0,0
-32,-24,-8,0,0,0
-36,-19,-17,0,0,0
15,10,5,1,0,1
7,10,-3,0,0,0
-30,-30,0,0,0,0
-3,8,-11,0,0,0
-11,7,-18,0,0,0
-15,-27,12,1,0,1
-54,-37,-17,0,0,0
22,13,9,1,1,0
14,-6,20,1,1,0
1,-6,7,1,1,0
-25,-23,-2,0,1,1
6,21,-15,0,1,1
-36,-24,-12,0,1,1
-16,-22,6,1,1,0
63,44,19,1,1,0
15,-2,17,1,1,0
18,7,11,1,1,0
30,36,-6,0,1,1
35,40,-5,0,1,1
-10,-9,-1,0,1,1
27,28,-1,0,1,1
8,26,-18,0,1,1
31,36,-5,0,1,1
30,26,4,1,1,0
-30,-11,-19,0,1,1
39,38,1,1,1,0
-33,-24,-9,0,0,0
32,41,-9,0,0,0
18,32,-14,0,0,0
-36,-24,-12,0,0,0
-19,-14,-5,0,0,0
8,15,-7,0,0,0
25,31,-6,0,0,0
19,38,-19,0,0,0
46,38,8,1,0,1
44,44,0,0,0,0
-7,-1,-6,0,0,0
-41,-32,-9,0,0,0
-47,-39,-8,0,0,0
5,17,-12,0,1,1
46,26,20,1,1,0
22,42,-20,0,1,1
-54,-45,-9,0,1,1
-41,-42,1,1,1,0
-51,-32,-19,0,1,1
-31,-23,-8,0,1,1
24,41,-17,0,1,1
-30,-22,-8,0,1,1
31,20,11,1,1,0
28,44,-16,0,1,1
-3,-11,8,1,1,0
-14,-18,4,1,1,0
-17,-8,-9,0,1,1
-35,-25,-10,0,1,1
13,7,6,1,1,0
2,-16,18,1,1,0
-44,-45,1,1,1,0
-24,-23,-1,0,1,1
-3,-3,0,0,0,0
47,40,7,1,0,1
-8,-15,7,1,0,1
37,34,3,1,0,1
-15,-35,20,1,0,1
36,21,15,1,0,1
7,4,3,1,0,1
-36,-32,-4,0,0,0
-7,-25,18,1,0,1
-8,-23,15,1,0,1
22,13,9,1,1,0
-40,-45,5,1,1,0
30,24,6,1,1,0
11,-5,16,1,1,0
19,39,-20,0,1,1
29,43,-14,0,1,1
-12,-21,9,1,1,0
-52,-37,-15,0,1,1
31,11,20,1,1,0
-25,-23,-2,0,1,1
-3,-14,11,1,1,0
-1,-15,14,1,1,0
-4,-6,2,1,1,0
17,28,-11,0,1,1
32,28,4,1,1,0
-32,-14,-18,0,1,1
29,10,19,1,0,1
-5,1,-6,0,0,0
-40,-35,-5,0,0,0
19,28,-9,0,0,0
-22,-13,-9,0,0,0
12,28,-16,0,0,0
16,30,-14,0,0,0
28,26,2,1,0,1
-6,-1,-5,0,0,0
-2,4,-6,0,0,0
2,-9,11,1,0,1
19,11,8,1,0,1
-24,-13,-11,0,0,0
61,41,20,1,0,1
-22,-7,-15,0,0,0
-23,-30,7,1,0,1
-15,-9,-6,0,0,0
-12,8,-20,0,0,0
-17,-4,-13,0,0,0
16,11,5,1,0,1
16,20,-4,0,0,0
-27,-36,9,1,1,0
10,1,9,1,1,0
26,41,-15,0,1,1
14,-2,16,1,1,0
26,33,-7,0,1,1
14,16,-2,0,1,1
-26,-29,3,1,1,0
-40,-23,-17,0,1,1
16,26,-10,0,1,1
5,5,0,0,1,1
1,1,0,0,1,1
32,41,-9,0,1,1
-20,-29,9,1,1,0
31,42,-11,0,0,0
5,23,-18,0,0,0
-20,-4,-16,0,0,0
1,7,-6,0,0,0
40,21,19,1,0,1
54,37,17,1,0,1
-25,-20,-5,0,0,0
10,25,-15,0,0,0
9,21,-12,0,0,0
-15,-8,-7,0,1,1
-13,-14,1,1,1,0
-17,-9,-8,0,1,1
-29,-15,-14,0,1,1
16,-1,17,1,1,0
-12,-22,10,1,1,0
-37,-39,2,1,1,0
50,44,6,1,1,0
8,14,-6,0,1,1
-47,-36,-11,0,1,1
-16,-28,12,1,1,0
20,28,-8,0,1,1
-20,-5,-15,0,1,1
22,18,4,1,1,0
-33,-17,-16,0,1,1
19,18,1,1,1,0
-50,-32,-18,0,1,1
-5,-24,19,1,1,0
42,31,11,1,1,0
-37,-45,8,1,1,0
14,23,-9,0,1,1
-25,-20,-5,0,0,0
26,29,-3,0,0,0
-47,-30,-17,0,0,0
-49,-37,-12,0,0,0
25,29,-4,0,0,0
-15,-35,20,1,0,1
14,34,-20,0,0,0
-47,-35,-12,0,0,0
10,-6,16,1,0,1
33,29,4,1,0,1
-16,-1,-15,0,0,0
-33,-13,-20,0,0,0
21,5,16,1,0,1
-20,-16,-4,0,0,0
13,15,-2,0,0,0
40,37,3,1,0,1
-16,-2,-14,0,0,0
18,5,13,1,0,1
24,44,-20,0,0,0
-33,-20,-13,0,0,0
-35,-23,-12,0,0,0
13,29,-16,0,1,1
-18,-2,-16,0,1,1
26,42,-16,0,1,1
18,13,5,1,1,0
15,34,-19,0,1,1
48,40,8,1,1,0
26,25,1,1,1,0
-10,-1,-9,0,1,1
20,23,-3,0,1,1
-8,12,-20,0,1,1
45,35,10,1,1,0
34,36,-2,0,1,1
32,27,5,1,1,0
45,29,16,1,1,0
16,16,0,0,1,1
13,29,-16,0,0,0
-22,-26,4,1,0,1
-37,-32,-5,0,0,0
4,23,-19,0,0,0
45,30,15,1,0,1
-27,-17,-10,0,0,0
-17,-4,-13,0,0,0
-10,-2,-8,0,0,0
-21,-19,-2,0,0,0
10,-10,20,1,0,1
-32,-20,-12,0,0,0
-16,-28,12,1,0,1
-9,-4,-5,0,0,0
-31,-16,-15,0,0,0
0,10,-10,0,0,0
-34,-14,-20,0,0,0
-11,-27,16,1,0,1
40,36,4,1,0,1
46,28,18,1,1,0
33,23,10,1,1,0
17,22,-5,0,1,1
23,13,10,1,1,0
-41,-37,-4,0,1,1
-49,-41,-8,0,1,1
15,15,0,0,1,1
-23,-25,2,1,1,0
-13,-23,10,1,1,0
-13,-19,6,1,1,0
-21,-16,-5,0,1,1
-6,-8,2,1,1,0
40,28,12,1,1,0
9,22,-13,0,1,1
-22,-36,14,1,1,0
-16,-18,2,1,1,0
-13,-26,13,1,1,0
39,40,-1,0,1,1
-42,-36,-6,0,0,0
10,8,2,1,0,1
7,9,-2,0,0,0
54,38,16,1,0,1
-30,-11,-19,0,0,0
14,15,-1,0,0,0
-22,-27,5,1,0,1
23,18,5,1,0,1
-31,-25,-6,0,0,0
32,22,10,1,0,1
40,25,15,1,0,1
-7,8,-15,0,0,0
-24,-18,-6,0,0,0
-54,-37,-17,0,0,0
2,-16,18,1,0,1
6,-3,9,1,0,1
-18,-11,-7,0,0,0
-25,-23,-2,0,1,1
48,29,19,1,1,0
7,-9,16,1,1,0
12,3,9,1,1,0
-35,-28,-7,0,1,1
9,6,3,1,1,0
6,4,2,1,1,0
-30,-18,-12,0,1,1
-32,-18,-14,0,1,1
-42,-27,-15,0,1,1
3,-7,10,1,1,0
-17,-35,18,1,1,0
45,37,8,1,1,0
39,29,10,1,1,0
13,21,-8,0,0,0
-26,-24,-2,0,0,0
-3,1,-4,0,0,0
51,33,18,1,0,1
-1,-13,12,1,0,1
38,28,10,1,0,1
-19,-23,4,1,0,1
16,35,-19,0,0,0
35,20,15,1,0,1
-36,-36,0,0,0,0
-13,5,-18,0,0,0
14,26,-12,0,0,0
-23,-17,-6,0,0,0
13,9,4,1,0,1
12,21,-9,0,0,0
47,44,3,1,0,1
17,33,-16,0,0,0
22,4,18,1,0,1
36,20,16,1,0,1
-30,-15,-15,0,0,0
5,-14,19,1,0,1
5,-8,13,1,1,0
13,14,-1,0,1,1
6,0,6,1,1,0
-14,-22,8,1,1,0
-50,-32,-18,0,1,1
-29,-26,-3,0,1,1
4,6,-2,0,1,1
19,4,15,1,1,0
37,23,14,1,1,0
-18,-9,-9,0,1,1
31,18,13,1,1,0
-30,-23,-7,0,1,1
12,15,-3,0,1,1
9,-8,17,1,1,0
35,32,3,1,1,0
-27,-24,-3,0,1,1
50,31,19,1,1,0
13,10,3,1,1,0
22,39,-17,0,1,1
-3,14,-17,0,1,1
-6,-2,-4,0,1,1
6,17,-11,0,0,0
11,23,-12,0,0,0
-19,-23,4,1,0,1
-20,-24,4,1,0,1
-48,-42,-6,0,0,0
-10,-29,19,1,0,1
21,12,9,1,0,1
-11,-23,12,1,0,1
13,11,2,1,0,1
30,35,-5,0,0,0
36,28,8,1,0,1
-24,-4,-20,0,1,1
47,27,20,1,1,0
16,11,5,1,1,0
32,42,-10,0,1,1
-31,-23,-8,0,1,1
-19,-5,-14,0,1,1
48,35,13,1,1,0
6,-1,7,1,1,0
-36,-23,-13,0,1,1
33,27,6,1,1,0
0,18,-18,0,1,1
-8,2,-10,0,0,0
-37,-40,3,1,0,1
-12,8,-20,0,0,0
-6,-5,-1,0,0,0
26,21,5,1,0,1
38,37,1,1,0,1
-54,-37,-17,0,0,0
23,15,8,1,0,1
-13,-22,9,1,0,1
-15,-22,7,1,0,1
-15,-27,12,1,0,1
-38,-41,3,1,0,1
29,42,-13,0,0,0
53,42,11,1,0,1
-29,-36,7,1,0,1
44,39,5,1,0,1
-19,-1,-18,0,0,0
-19,-26,7,1,0,1
32,16,16,1,1,0
-6,1,-7,0,1,1
14,2,12,1,1,0
31,25,6,1,1,0
-7,-27,20,1,1,0
0,6,-6,0,1,1
32,36,-4,0,1,1
-44,-26,-18,0,1,1
-1,18,-19,0,1,1
5,-6,11,1,1,0
-27,-31,4,1,1,0
-30,-41,11,1,0,1
56,42,14,1,0,1
17,35,-18,0,0,0
8,21,-13,0,0,0
-45,-39,-6,0,0,0
-32,-28,-4,0,0,0
-37,-28,-9,0,0,0
7,27,-20,0,0,0
-11,-11,0,0,0,0
-18,-4,-14,0,0,0
-38,-45,7,1,0,1
62,43,19,1,0,1
-61,-43,-18,0,0,0
36,16,20,1,0,1
25,23,2,1,1,0
8,-3,11,1,1,0
33,25,8,1,1,0
-18,-18,0,0,1,1
22,34,-12,0,1,1
-37,-40,3,1,1,0
40,25,15,1,1,0
49,44,5,1,1,0
16,34,-18,0,1,1
29,27,2,1,1,0
36,22,14,1,1,0
-58,-41,-17,0,1,1
-3,3,-6,0,1,1
-31,-44,13,1,1,0
-29,-36,7,1,1,0
-29,-33,4,1,1,0
23,5,18,1,1,0
35,17,18,1,1,0
30,25,5,1,1,0
-35,-17,-18,0,1,1
17,35,-18,0,1,1
-55,-40,-15,0,0,0
55,43,12,1,0,1
28,25,3,1,0,1
-44,-30,-14,0,0,0
-25,-17,-8,0,0,0
-30,-18,-12,0,0,0
-22,-19,-3,0,0,0
52,34,18,1,0,1
39,30,9,1,0,1
31,13,18,1,0,1
14,7,7,1,0,1
-38,-23,-15,0,0,0
32,28,4,1,0,1
-23,-35,12,1,1,0
-20,-19,-1,0,1,1
5,23,-18,0,1,1
26,14,12,1,1,0
-10,-4,-6,0,1,1
41,26,15,1,1,0
37,43,-6,0,1,1
-28,-28,0,0,1,1
32,14,18,1,1,0
-33,-21,-12,0,1,1
17,24,-7,0,1,1
16,31,-15,0,1,1
-11,-21,10,1,1,0
-26,-14,-12,0,1,1
21,34,-13,0,1,1
-31,-44,13,1,1,0
27,42,-15,0,1,1
-37,-37,0,0,1,1
22,17,5,1,1,0
25,5,20,1,1,0
-26,-22,-4,0,1,1
19,35,-16,0,0,0
-6,-14,8,1,0,1
15,29,-14,0,0,0
-41,-27,-14,0,0,0
-41,-29,-12,0,0,0
6,16,-10,0,0,0
1,-4,5,1,0,1
-30,-28,-2,0,0,0
3,13,-10,0,0,0
0,-14,14,1,0,1
-1,-19,18,1,0,1
-9,9,-18,0,0,0
-29,-14,-15,0,1,1
-21,-5,-16,0,1,1
-51,-37,-14,0,1,1
-21,-28,7,1,1,0
56,36,20,1,1,0
32,26,6,1,1,0
-12,-11,-1,0,1,1
-36,-28,-8,0,1,1
-30,-40,10,1,1,0
25,14,11,1,1,0
22,20,2,1,1,0
3,-14,17,1,1,0
37,37,0,0,1,1
3,21,-18,0,1,1
-25,-44,19,1,1,0
31,23,8,1,1,0
40,27,13,1,1,0
38,25,13,1,1,0
10,-2,12,1,1,0
29,30,-1,0,1,1
-60,-42,-18,0,1,1
22,22,0,0,0,0
27,43,-16,0,0,0
-12,-32,20,1,0,1
-42,-25,-17,0,0,0
13,4,9,1,0,1
-3,14,-17,0,0,0
-12,-13,1,1,0,1
-10,-4,-6,0,0,0
-39,-37,-2,0,0,0
-51,-37,-14,0,0,0
41,31,10,1,0,1
35,39,-4,0,0,0
-32,-24,-8,0,0,0
61,41,20,1,0,1
-25,-13,-12,0,0,0
-9,-20,11,1,0,1
3,21,-18,0,0,0
30,16,14,1,0,1
55,43,12,1,0,1
24,23,1,1,0,1
-3,2,-5,0,0,0
-9,9,-18,0,1,1
57,44,13,1,1,0
-36,-42,6,1,1,0
-51,-39,-12,0,1,1
1,3,-2,0,1,1
-18,-16,-2,0,1,1
38,27,11,1,1,0
-6,-20,14,1,1,0
-11,-20,9,1,1,0
-21,-7,-14,0,1,1
31,37,-6,0,1,1
5,13,-8,0,1,1
-24,-23,-1,0,1,1
-2,9,-11,0,1,1
-21,-34,13,1,1,0
27,11,16,1,1,0
-19,-28,9,1,1,0
-25,-5,-20,0,1,1
-12,-16,4,1,1,0
45,32,13,1,1,0
-25,-39,14,1,1,0
-55,-44,-11,0,0,0
-20,-24,4,1,0,1
10,6,4,1,0,1
25,16,9,1,0,1
-14,2,-16,0,0,0
47,31,16,1,0,1
-13,-22,9,1,0,1
-17,-27,10,1,0,1
-6,-3,-3,0,0,0
12,-5,17,1,0,1
-55,-38,-17,0,0,0
19,30,-11,0,0,0
14,27,-13,0,1,1
45,31,14,1,1,0
33,44,-11,0,1,1
32,16,16,1,1,0
26,43,-17,0,1,1
13,-1,14,1,1,0
-3,0,-3,0,1,1
16,12,4,1,1,0
1,10,-9,0,0,0
12,-4,16,1,0,1
22,38,-16,0,0,0
26,21,5,1,0,1
-16,-16,0,0,0,0
-1,16,-17,0,0,0
-27,-38,11,1,0,1
-7,-4,-3,0,0,0
-30,-18,-12,0,0,0
3,-10,13,1,0,1
-54,-35,-19,0,1,1
29,42,-13,0,1,1
2,-15,17,1,1,0
-27,-40,13,1,1,0
41,24,17,1,1,0
23,37,-14,0,1,1
-7,-27,20,1,1,0
21,33,-12,0,1,1
30,21,9,1,1,0
-21,-18,-3,0,1,1
11,-1,12,1,0,1
-20,-8,-12,0,0,0
38,18,20,1,0,1
43,28,15,1,0,1
47,37,10,1,0,1
-8,9,-17,0,0,0
-19,-33,14,1,0,1
21,40,-19,0,0,0
-18,-34,16,1,0,1
15,29,-14,0,0,0
4,6,-2,0,0,0
22,21,1,1,0,1
30,37,-7,0,0,0
13,33,-20,0,0,0
54,44,10,1,0,1
2,10,-8,0,0,0
-21,-39,18,1,0,1
-42,-41,-1,0,0,0
-64,-44,-20,0,0,0
-19,-31,12,1,0,1
-31,-39,8,1,0,1
-1,-1,0,0,1,1
-1,17,-18,0,1,1
32,33,-1,0,1,1
-20,-37,17,1,1,0
28,18,10,1,1,0
-48,-34,-14,0,1,1
-46,-30,-16,0,1,1
20,36,-16,0,1,1
-26,-34,8,1,1,0
16,3,13,1,1,0
-11,-7,-4,0,0,0
-5,-14,9,1,0,1
-6,-15,9,1,0,1
16,32,-16,0,0,0
33,29,4,1,0,1
-1,6,-7,0,0,0
-18,-27,9,1,0,1
-37,-34,-3,0,0,0
40,36,4,1,0,1
34,27,7,1,0,1
53,38,15,1,0,1
45,37,8,1,0,1
0,19,-19,0,0,0
35,27,8,1,0,1
-25,-34,9,1,0,1
-14,-11,-3,0,0,0
-14,-10,-4,0,0,0
-5,-11,6,1,0,1
42,41,1,1,0,1
11,13,-2,0,0,0
49,39,10,1,0,1
12,0,12,1,1,0
19,29,-10,0,1,1
10,21,-11,0,1,1
-5,-13,8,1,1,0
30,12,18,1,1,0
-11,-15,4,1,1,0
6,3,3,1,1,0
-13,-27,14,1,1,0
-6,-18,12,1,1,0
-33,-30,-3,0,1,1
14,4,10,1,1,0
57,41,16,1,1,0
48,33,15,1,1,0
41,35,6,1,0,1
-5,-15,10,1,0,1
-24,-21,-3,0,0,0
-21,-41,20,1,0,1
-43,-41,-2,0,0,0
25,26,-1,0,0,0
-23,-8,-15,0,0,0
0,13,-13,0,0,0
-5,-8,3,1,0,1
-37,-44,7,1,0,1
54,35,19,1,0,1
21,4,17,1,0,1
46,37,9,1,0,1
-52,-35,-17,0,0,0
-45,-39,-6,0,0,0
-35,-21,-14,0,0,0
54,40,14,1,0,1
-31,-42,11,1,1,0
12,12,0,0,1,1
-23,-18,-5,0,1,1
-16,-28,12,1,1,0
13,24,-11,0,1,1
16,36,-20,0,1,1
-37,-24,-13,0,1,1
-40,-29,-11,0,1,1
3,-9,12,1,1,0
8,24,-16,0,1,1
23,6,17,1,1,0
-34,-45,11,1,1,0
17,13,4,1,1,0
24,25,-1,0,1,1
-30,-27,-3,0,1,1
12,14,-2,0,0,0
18,34,-16,0,0,0
1,8,-7,0,0,0
-27,-8,-19,0,0,0
17,30,-13,0,0,0
-2,-17,15,1,0,1
-19,-38,19,1,0,1
55,42,13,1,0,1
34,14,20,1,0,1
-5,-18,13,1,0,1
16,26,-10,0,0,0
-22,-8,-14,0,0,0
-10,-8,-2,0,0,0
-16,-4,-12,0,0,0
-7,-13,6,1,0,1
-24,-22,-2,0,0,0
-14,-14,0,0,0,0
25,5,20,1,0,1
36,28,8,1,0,1
0,9,-9,0,0,0
17,4,13,1,0,1
11,26,-15,0,1,1
15,27,-12,0,1,1
9,22,-13,0,1,1
10,-10,20,1,1,0
-5,2,-7,0,1,1
-50,-45,-5,0,1,1
3,-17,20,1,1,0
24,34,-10,0,1,1
-7,12,-19,0,1,1
30,23,7,1,1,0
44,44,0,0,1,1
34,35,-1,0,1,1
11,30,-19,0,1,1
1,-18,19,1,1,0
-12,-26,14,1,1,0
32,21,11,1,1,0
-27,-26,-1,0,1,1
15,18,-3,0,1,1
22,15,7,1,1,0
-37,-38,1,1,1,0
-5,14,-19,0,1,1
-4,-1,-3,0,0,0
33,33,0,0,0,0
-22,-32,10,1,0,1
21,7,14,1,0,1
15,9,6,1,0,1
39,39,0,0,0,0
-22,-32,10,1,0,1
-30,-31,1,1,0,1
1,21,-20,0,0,0
-6,-17,11,1,0,1
9,9,0,0,0,0
-13,-11,-2,0,1,1
-29,-17,-12,0,1,1
16,32,-16,0,1,1
-30,-20,-10,0,1,1
-2,-16,14,1,1,0
-12,-3,-9,0,1,1
40,21,19,1,1,0
-33,-31,-2,0,1,1
-44,-32,-12,0,1,1
21,12,9,1,1,0
6,-4,10,1,1,0
-1,-8,7,1,0,1
-35,-32,-3,0,0,0
22,30,-8,0,0,0
2,4,-2,0,0,0
-21,-40,19,1,0,1
-8,-21,13,1,0,1
-5,7,-12,0,0,0
6,1,5,1,0,1
-6,-10,4,1,0,1
-12,-13,1,1,0,1
21,29,-8,0,1,1
22,20,2,1,1,0
27,30,-3,0,1,1
-11,1,-12,0,1,1
-57,-38,-19,0,1,1
-1,-4,3,1,1,0
48,41,7,1,1,0
-18,-20,2,1,1,0
-37,-18,-19,0,1,1
-47,-33,-14,0,1,1
-20,-19,-1,0,1,1
-48,-45,-3,0,1,1
-11,-23,12,1,0,1
-11,-26,15,1,0,1
38,26,12,1,0,1
23,25,-2,0,0,0
-7,0,-7,0,0,0
-36,-22,-14,0,0,0
-27,-16,-11,0,0,0
2,17,-15,0,0,0
-15,-29,14,1,0,1
-12,-12,0,0,0,0
21,19,2,1,0,1
-27,-7,-20,0,0,0
-4,-8,4,1,0,1
-25,-42,17,1,0,1
-23,-8,-15,0,0,0
14,10,4,1,0,1
-24,-42,18,1,0,1
-16,-35,19,1,0,1
-24,-40,16,1,0,1
32,26,6,1,0,1
-16,-1,-15,0,0,0
-18,-22,4,1,1,0
0,6,-6,0,1,1
36,39,-3,0,1,1
34,38,-4,0,1,1
19,10,9,1,1,0
-13,-20,7,1,1,0
-18,-15,-3,0,1,1
-26,-44,18,1,1,0
-33,-40,7,1,1,0
47,44,3,1,1,0
21,30,-9,0,1,1
42,44,-2,0,1,1
36,36,0,0,1,1
-17,-22,5,1,1,0
29,44,-15,0,1,1
-28,-8,-20,0,1,1
-4,11,-15,0,1,1
-40,-33,-7,0,1,1
-39,-34,-5,0,1,1
36,42,-6,0,1,1
-29,-20,-9,0,1,1
24,24,0,0,0,0
21,35,-14,0,0,0
10,26,-16,0,0,0
4,-8,12,1,0,1
-37,-22,-15,0,0,0
44,44,0,0,0,0
-15,-8,-7,0,0,0
1,21,-20,0,0,0
-8,-3,-5,0,0,0
-26,-43,17,1,0,1
30,39,-9,0,0,0
-22,-4,-18,0,0,0
18,-1,19,1,0,1
32,22,10,1,0,1
-40,-44,4,1,0,1
30,35,-5,0,0,0
-23,-22,-1,0,0,0
20,35,-15,0,0,0
27,40,-13,0,0,0
12,6,6,1,0,1
51,38,13,1,0,1
-18,-3,-15,0,1,1
0,4,-4,0,1,1
38,24,14,1,1,0
39,28,11,1,1,0
-18,-38,20,1,1,0
-39,-34,-5,0,1,1
3,9,-6,0,1,1
5,-15,20,1,1,0
18,6,12,1,1,0
23,23,0,0,1,1
-24,-31,7,1,1,0
5,11,-6,0,1,1
17,36,-19,0,1,1
-20,-3,-17,0,1,1
-49,-32,-17,0,1,1
26,28,-2,0,1,1
-33,-29,-4,0,1,1
21,7,14,1,1,0
-53,-41,-12,0,1,1
16,-2,18,1,1,0
-14,-26,12,1,1,0
-15,-20,5,1,0,1
32,16,16,1,0,1
-46,-27,-19,0,0,0
-26,-40,14,1,0,1
22,2,20,1,0,1
-30,-27,-3,0,0,0
14,15,-1,0,0,0
-10,-5,-5,0,0,0
30,32,-2,0,0,0
-7,8,-15,0,0,0
-53,-33,-20,0,1,1
10,13,-3,0,1,1
-13,-1,-12,0,1,1
27,27,0,0,1,1
36,28,8,1,1,0
-3,-6,3,1,1,0
12,-6,18,1,1,0
-18,-26,8,1,1,0
-46,-37,-9,0,1,1
-38,-25,-13,0,1,1
-14,-7,-7,0,1,1
-37,-30,-7,0,0,0
12,2,10,1,0,1
49,32,17,1,0,1
40,38,2,1,0,1
-45,-31,-14,0,0,0
4,1,3,1,0,1
47,32,15,1,0,1
24,27,-3,0,0,0
-21,-8,-13,0,0,0
-9,9,-18,0,0,0
-22,-40,18,1,0,1
-5,-24,19,1,0,1
-35,-36,1,1,0,1
35,41,-6,0,0,0
-23,-42,19,1,0,1
-32,-12,-20,0,0,0
36,18,18,1,0,1
1,-18,19,1,0,1
-23,-3,-20,0,1,1
16,19,-3,0,1,1
39,33,6,1,1,0
-16,-13,-3,0,1,1
-55,-39,-16,0,1,1
8,13,-5,0,1,1
-38,-44,6,1,1,0
-20,-34,14,1,1,0
-7,-9,2,1,1,0
-36,-31,-5,0,1,1
14,5,9,1,1,0
-19,-20,1,1,1,0
-10,-12,2,1,1,0
0,-9,9,1,1,0
43,40,3,1,1,0
20,5,15,1,1,0
8,11,-3,0,1,1
33,44,-11,0,1,1
38,23,15,1,1,0
-34,-40,6,1,1,0
-39,-21,-18,0,1,1
-3,-22,19,1,0,1
-46,-39,-7,0,0,0
-9,-25,16,1,0,1
45,43,2,1,0,1
31,18,13,1,0,1
-36,-20,-16,0,0,0
-3,-21,18,1,0,1
17,9,8,1,0,1
7,2,5,1,0,1
17,10,7,1,0,1
47,40,7,1,1,0
17,19,-2,0,1,1
8,16,-8,0,1,1
-16,-32,16,1,1,0
15,8,7,1,1,0
48,42,6,1,1,0
-48,-29,-19,0,1,1
-3,7,-10,0,1,1
9,3,6,1,1,0
-62,-43,-19,0,1,1
-22,-13,-9,0,1,1
33,27,6,1,1,0
-18,-35,17,1,1,0
14,30,-16,0,0,0
-4,-11,7,1,0,1
1,16,-15,0,0,0
-50,-44,-6,0,0,0
-10,-21,11,1,0,1
35,15,20,1,0,1
0,5,-5,0,0,0
41,34,7,1,0,1
-17,-19,2,1,0,1
-43,-45,2,1,0,1
19,20,-1,0,0,0
-8,9,-17,0,0,0
21,20,1,1,0,1
56,39,17,1,0,1
-3,-22,19,1,0,1
21,4,17,1,0,1
5,7,-2,0,0,0
22,2,20,1,0,1
33,14,19,1,0,1
-4,9,-13,0,1,1
-19,-19,0,0,1,1
38,25,13,1,1,0
8,13,-5,0,1,1
-9,6,-15,0,1,1
17,34,-17,0,1,1
15,25,-10,0,1,1
-22,-18,-4,0,1,1
45,26,19,1,1,0
12,7,5,1,1,0
-13,-7,-6,0,1,1
-28,-37,9,1,1,0
-8,-18,10,1,1,0
41,31,10,1,1,0
-45,-42,-3,0,1,1
-12,4,-16,0,1,1
27,12,15,1,1,0
-40,-34,-6,0,1,1
7,-11,18,1,1,0
-31,-32,1,1,1,0
29,36,-7,0,1,1
-16,-28,12,1,0,1
25,27,-2,0,0,0
-25,-17,-8,0,0,0
-11,-9,-2,0,0,0
-12,-30,18,1,0,1
48,30,18,1,0,1
-20,0,-20,0,0,0
7,24,-17,0,0,0
-1,8,-9,0,0,0
24,8,16,1,0,1
-31,-39,8,1,0,1
-19,-31,12,1,0,1
49,30,19,1,0,1
18,9,9,1,0,1
-27,-31,4,1,0,1
4,14,-10,0,0,0
-12,-32,20,1,0,1
-29,-13,-16,0,0,0
-64,-45,-19,0,0,0
-19,-15,-4,0,0,0
10,21,-11,0,0,0
31,18,13,1,1,0
33,28,5,1,1,0
28,35,-7,0,1,1
-22,-14,-8,0,1,1
41,25,16,1,1,0
-1,14,-15,0,1,1
9,28,-19,0,1,1
19,18,1,1,1,0
21,10,11,1,1,0
-24,-14,-10,0,0,0
36,22,14,1,0,1
55,36,19,1,0,1
18,32,-14,0,0,0
6,5,1,1,0,1
-7,10,-17,0,0,0
-50,-35,-15,0,0,0
-22,-11,-11,0,0,0
-20,-28,8,1,0,1
-42,-24,-18,0,0,0
-8,11,-19,0,0,0
-54,-39,-15,0,0,0
-33,-35,2,1,0,1
11,21,-10,0,0,0
-4,15,-19,0,0,0
-17,-13,-4,0,0,0
29,17,12,1,1,0
33,16,17,1,1,0
-5,12,-17,0,1,1
-45,-41,-4,0,1,1
-12,3,-15,0,1,1
-37,-23,-14,0,1,1
26,23,3,1,1,0
-30,-11,-19,0,1,1
-41,-32,-9,0,1,1
17,28,-11,0,1,1
13,10,3,1,0,1
33,20,13,1,0,1
14,29,-15,0,0,0
22,29,-7,0,0,0
-17,-14,-3,0,0,0
-8,-7,-1,0,0,0
47,32,15,1,0,1
16,33,-17,0,0,0
36,27,9,1,0,1
-30,-20,-10,0,1,1
-25,-16,-9,0,1,1
10,23,-13,0,1,1
-47,-39,-8,0,1,1
-12,-3,-9,0,1,1
-8,-21,13,1,1,0
26,6,20,1,1,0
36,31,5,1,1,0
3,19,-16,0,0,0
-52,-39,-13,0,0,0
17,10,7,1,0,1
7,17,-10,0,0,0
-58,-41,-17,0,0,0
26,43,-17,0,0,0
-24,-26,2,1,0,1
44,36,8,1,0,1
-31,-21,-10,0,0,0
12,12,0,0,0,0
-4,-23,19,1,0,1
12,6,6,1,0,1
25,34,-9,0,0,0
1,3,-2,0,0,0
-53,-34,-19,0,0,0
-26,-16,-10,0,0,0
40,29,11,1,0,1
-39,-33,-6,0,1,1
-40,-21,-19,0,1,1
16,7,9,1,1,0
18,28,-10,0,1,1
15,20,-5,0,1,1
32,16,16,1,1,0
-5,-9,4,1,1,0
23,43,-20,0,1,1
-7,-3,-4,0,0,0
16,30,-14,0,0,0
-30,-16,-14,0,0,0
-38,-41,3,1,0,1
-19,-25,6,1,0,1
-21,-10,-11,0,0,0
13,20,-7,0,0,0
-22,-40,18,1,0,1
-15,3,-18,0,0,0
-13,-16,3,1,0,1
9,17,-8,0,0,0
23,22,1,1,0,1
19,39,-20,0,0,0
41,37,4,1,0,1
-14,0,-14,0,0,0
-47,-31,-16,0,0,0
23,22,1,1,0,1
14,22,-8,0,0,0
-13,4,-17,0,1,1
-16,0,-16,0,1,1
7,9,-2,0,1,1
-54,-40,-14,0,1,1
38,33,5,1,1,0
-43,-31,-12,0,1,1
-1,8,-9,0,1,1
11,-3,14,1,1,0
41,28,13,1,1,0
10,16,-6,0,1,1
33,34,-1,0,1,1
-10,-13,3,1,1,0
4,6,-2,0,1,1
-52,-38,-14,0,1,1
34,40,-6,0,1,1
0,11,-11,0,1,1
29,40,-11,0,1,1
7,20,-13,0,1,1
-38,-34,-4,0,1,1
-1,-17,16,1,0,1
-34,-30,-4,0,0,0
-23,-5,-18,0,0,0
-10,-5,-5,0,0,0
-21,-21,0,0,0,0
-6,6,-12,0,0,0
-1,15,-16,0,0,0
18,9,9,1,0,1
61,44,17,1,0,1
29,32,-3,0,0,0
2,2,0,0,0,0
9,14,-5,0,0,0
26,19,7,1,0,1
6,2,4,1,0,1
15,22,-7,0,0,0
18,8,10,1,0,1
30,41,-11,0,0,0
4,2,2,1,0,1
32,17,15,1,0,1
5,-5,10,1,0,1
-30,-15,-15,0,0,0
-19,-4,-15,0,1,1
23,40,-17,0,1,1
22,15,7,1,1,0
-51,-38,-13,0,1,1
16,15,1,1,1,0
-30,-11,-19,0,1,1
18,10,8,1,1,0
44,29,15,1,1,0
36,16,20,1,1,0
-20,-28,8,1,1,0
7,25,-18,0,1,1
0,19,-19,0,1,1
14,-5,19,1,1,0
18,14,4,1,1,0
-12,-29,17,1,1,0
-22,-11,-11,0,1,1
-41,-29,-12,0,1,1
-5,-11,6,1,1,0
43,34,9,1,1,0
35,35,0,0,1,1
25,41,-16,0,1,1
-23,-21,-2,0,0,0
-23,-43,20,1,0,1
5,3,2,1,0,1
-17,-6,-11,0,0,0
25,13,12,1,0,1
23,14,9,1,0,1
8,24,-16,0,0,0
31,24,7,1,0,1
-30,-27,-3,0,0,0
15,5,10,1,0,1
-15,-14,-1,0,0,0
16,15,1,1,0,1
9,3,6,1,0,1
-10,-15,5,1,1,0
-14,-21,7,1,1,0
4,17,-13,0,1,1
-51,-33,-18,0,1,1
-27,-37,10,1,1,0
12,0,12,1,1,0
-13,7,-20,0,1,1
-32,-42,10,1,1,0
-9,-27,18,1,1,0
-14,3,-17,0,1,1
34,21,13,1,1,0
38,42,-4,0,1,1
25,38,-13,0,1,1
32,20,12,1,1,0
8,2,6,1,1,0
32,15,17,1,0,1
16,28,-12,0,0,0
20,20,0,0,0,0
-2,-15,13,1,0,1
-49,-29,-20,0,0,0
31,13,18,1,0,1
-24,-6,-18,0,0,0
15,11,4,1,0,1
32,44,-12,0,0,0
-25,-13,-12,0,1,1
-38,-45,7,1,1,0
2,18,-16,0,1,1
-34,-37,3,1,1,0
-23,-19,-4,0,1,1
-26,-19,-7,0,1,1
-38,-38,0,0,1,1
-14,-13,-1,0,1,1
-41,-23,-18,0,1,1
-46,-33,-13,0,1,1
7,4,3,1,1,0
-21,-10,-11,0,1,1
9,11,-2,0,0,0
-14,-26,12,1,0,1
4,-14,18,1,0,1
-36,-23,-13,0,0,0
-28,-9,-19,0,0,0
-37,-34,-3,0,0,0
-5,9,-14,0,0,0
-22,-6,-16,0,0,0
32,34,-2,0,0,0
-6,-25,19,1,0,1
36,17,19,1,0,1
-23,-15,-8,0,0,0
-8,9,-17,0,0,0
10,25,-15,0,1,1
7,-2,9,1,1,0
36,40,-4,0,1,1
-39,-40,1,1,1,0
-20,-9,-11,0,1,1
17,15,2,1,1,0
21,8,13,1,1,0
-2,15,-17,0,1,1
-15,-4,-11,0,1,1
8,15,-7,0,1,1
2,-9,11,1,0,1
38,40,-2,0,0,0
-31,-34,3,1,0,1
9,16,-7,0,0,0
47,28,19,1,0,1
-32,-26,-6,0,0,0
-13,-26,13,1,0,1
-23,-22,-1,0,0,0
35,29,6,1,0,1
41,24,17,1,0,1
24,13,11,1,0,1
-23,-32,9,1,0,1
4,12,-8,0,1,1
-33,-23,-10,0,1,1
39,19,20,1,1,0
-42,-38,-4,0,1,1
18,7,11,1,1,0
-9,7,-16,0,1,1
-12,-30,18,1,1,0
-1,-1,0,0,1,1
25,10,15,1,0,1
14,2,12,1,0,1
-4,11,-15,0,0,0
8,6,2,1,0,1
10,25,-15,0,0,0
3,15,-12,0,0,0
50,32,18,1,0,1
-16,-16,0,0,0,0
-30,-43,13,1,0,1
-19,-29,10,1,0,1
43,25,18,1,1,0
24,6,18,1,1,0
-36,-17,-19,0,1,1
-6,-13,7,1,1,0
-27,-12,-15,0,1,1
-61,-43,-18,0,1,1
-12,-2,-10,0,1,1
31,37,-6,0,1,1
30,10,20,1,1,0
-4,-8,4,1,1,0
-1,5,-6,0,1,1
-45,-39,-6,0,1,1
-32,-24,-8,0,1,1
-54,-35,-19,0,1,1
-24,-37,13,1,1,0
-20,-40,20,1,0,1
-59,-43,-16,0,0,0
-43,-41,-2,0,0,0
6,-5,11,1,0,1
-29,-44,15,1,0,1
14,29,-15,0,0,0
-22,-4,-18,0,0,0
-23,-29,6,1,0,1
14,24,-10,0,0,0
28,39,-11,0,0,0
-18,-35,17,1,0,1
-23,-17,-6,0,0,0
-34,-26,-8,0,1,1
25,28,-3,0,1,1
-4,1,-5,0,1,1
-35,-18,-17,0,1,1
18,34,-16,0,1,1
-13,-18,5,1,1,0
-4,7,-11,0,1,1
-5,11,-16,0,1,1
-14,-16,2,1,0,1
-33,-28,-5,0,0,0
1,16,-15,0,0,0
43,34,9,1,0,1
23,43,-20,0,0,0
29,38,-9,0,0,0
15,34,-19,0,0,0
-35,-20,-15,0,0,0
-6,-11,5,1,1,0
-10,4,-14,0,1,1
28,31,-3,0,1,1
-45,-33,-12,0,1,1
0,-13,13,1,1,0
31,27,4,1,1,0
-39,-21,-18,0,1,1
-60,-44,-16,0,1,1
12,10,2,1,0,1
-16,4,-20,0,0,0
-21,-9,-12,0,0,0
7,-5,12,1,0,1
41,33,8,1,0,1
23,12,11,1,0,1
0,-19,19,1,0,1
-8,-6,-2,0,0,0
-17,-2,-15,0,0,0
19,3,16,1,0,1
-11,6,-17,0,0,0
7,-1,8,1,0,1
-13,7,-20,0,0,0
24,27,-3,0,0,0
35,18,17,1,0,1
-29,-29,0,0,0,0
27,24,3,1,1,0
20,4,16,1,1,0
57,37,20,1,1,0
-17,-1,-16,0,1,1
-21,-9,-12,0,1,1
-13,-27,14,1,1,0
28,36,-8,0,1,1
2,5,-3,0,1,1
7,19,-12,0,1,1
0,-6,6,1,1,0
-58,-39,-19,0,1,1
30,43,-13,0,1,1
15,6,9,1,0,1
-50,-42,-8,0,0,0
-2,3,-5,0,0,0
19,6,13,1,0,1
-39,-32,-7,0,0,0
-27,-35,8,1,0,1
13,-2,15,1,0,1
-26,-41,15,1,0,1
4,-7,11,1,0,1
-28,-22,-6,0,0,0
-44,-39,-5,0,1,1
-9,-10,1,1,1,0
48,29,19,1,1,0
46,36,10,1,1,0
-52,-44,-8,0,1,1
22,4,18,1,1,0
-40,-45,5,1,1,0
9,0,9,1,1,0
16,36,-20,0,1,1
-26,-17,-9,0,1,1
-34,-20,-14,0,1,1
16,28,-12,0,1,1
-37,-19,-18,0,1,1
-19,-19,0,0,1,1
-52,-33,-19,0,1,1
-40,-31,-9,0,1,1
-30,-37,7,1,1,0
36,35,1,1,1,0
-7,8,-15,0,1,1
29,28,1,1,1,0
-25,-17,-8,0,1,1
0,14,-14,0,0,0
48,36,12,1,0,1
-43,-31,-12,0,0,0
22,33,-11,0,0,0
-28,-14,-14,0,0,0
57,40,17,1,0,1
-33,-20,-13,0,0,0
41,28,13,1,0,1
-10,-12,2,1,0,1
17,24,-7,0,0,0
-14,-21,7,1,0,1
-41,-21,-20,0,0,0
12,10,2,1,0,1
7,20,-13,0,0,0
-25,-16,-9,0,0,0
11,4,7,1,1,0
43,43,0,0,1,1
-21,-9,-12,0,1,1
-11,-4,-7,0,1,1
23,10,13,1,1,0
24,8,16,1,1,0
-47,-29,-18,0,1,1
-37,-29,-8,0,1,1
-25,-26,1,1,1,0
14,8,6,1,1,0
-16,-1,-15,0,1,1
50,39,11,1,1,0
50,35,15,1,1,0
-9,0,-9,0,0,0
46,28,18,1,0,1
-16,-29,13,1,0,1
-30,-15,-15,0,0,0
-1,18,-19,0,0,0
-41,-27,-14,0,0,0
28,17,11,1,0,1
16,15,1,1,0,1
-21,-28,7,1,0,1
-33,-23,-10,0,0,0
-36,-16,-20,0,0,0
-21,-33,12,1,0,1
26,32,-6,0,0,0
-40,-40,0,0,0,0
-16,4,-20,0,0,0
-2,-11,9,1,0,1
7,2,5,1,0,1
-6,-18,12,1,0,1
-36,-24,-12,0,0,0
-24,-34,10,1,0,1
44,39,5,1,0,1
37,27,10,1,1,0
-17,-30,13,1,1,0
-10,-13,3,1,1,0
16,0,16,1,1,0
-35,-37,2,1,1,0
56,36,20,1,1,0
8,13,-5,0,1,1
28,23,5,1,1,0
12,31,-19,0,1,1
-39,-44,5,1,1,0
10,10,0,0,0,0
-13,2,-15,0,0,0
20,29,-9,0,0,0
29,17,12,1,0,1
-47,-41,-6,0,0,0
-1,-10,9,1,0,1
-35,-40,5,1,0,1
52,42,10,1,0,1
-4,-2,-2,0,0,0
-22,-10,-12,0,0,0
36,40,-4,0,0,0
-14,-31,17,1,0,1
13,15,-2,0,0,0
30,41,-11,0,0,0
16,28,-12,0,0,0
25,23,2,1,0,1
6,21,-15,0,0,0
-4,-9,5,1,1,0
38,24,14,1,1,0
-35,-18,-17,0,1,1
3,-14,17,1,1,0
25,39,-14,0,1,1
40,33,7,1,1,0
-18,-11,-7,0,1,1
49,40,9,1,1,0
10,7,3,1,1,0
0,5,-5,0,1,1
-30,-18,-12,0,1,1
34,37,-3,0,0,0
-16,-28,12,1,0,1
-38,-25,-13,0,0,0
33,25,8,1,0,1
-13,-20,7,1,0,1
48,38,10,1,0,1
9,22,-13,0,0,0
45,38,7,1,0,1
-19,-9,-10,0,0,0
-34,-31,-3,0,0,0
47,40,7,1,0,1
-4,9,-13,0,0,0
43,28,15,1,0,1
42,28,14,1,0,1
42,23,19,1,0,1
8,-7,15,1,0,1
61,44,17,1,0,1
-17,-3,-14,0,0,0
-34,-18,-16,0,0,0
4,18,-14,0,0,0
23,17,6,1,0,1
-31,-38,7,1,1,0
-33,-45,12,1,1,0
-18,-33,15,1,1,0
-24,-22,-2,0,1,1
19,23,-4,0,1,1
22,28,-6,0,1,1
-13,0,-13,0,1,1
-10,-19,9,1,1,0
-27,-16,-11,0,1,1
14,14,0,0,1,1
-37,-32,-5,0,1,1
4,3,1,1,1,0
15,-5,20,1,1,0
-1,15,-16,0,1,1
-4,-6,2,1,1,0
36,32,4,1,1,0
24,16,8,1,1,0
16,28,-12,0,1,1
13,21,-8,0,1,1
55,43,12,1,1,0
32,25,7,1,1,0
-37,-30,-7,0,0,0
-40,-44,4,1,0,1
-25,-29,4,1,0,1
-17,-11,-6,0,0,0
-22,-12,-10,0,0,0
-10,-25,15,1,0,1
52,41,11,1,0,1
15,25,-10,0,0,0
12,21,-9,0,0,0
19,24,-5,0,0,0
-31,-45,14,1,0,1
-3,-5,2,1,0,1
17,37,-20,0,0,0
14,23,-9,0,0,0
-19,-30,11,1,0,1
-64,-44,-20,0,1,1
-14,-18,4,1,1,0
-2,-13,11,1,1,0
-15,-20,5,1,1,0
33,36,-3,0,1,1
-1,8,-9,0,1,1
9,27,-18,0,1,1
2,-6,8,1,1,0
10,5,5,1,1,0
7,-4,11,1,1,0
-12,8,-20,0,1,1
-9,-22,13,1,1,0
-37,-27,-10,0,1,1
-33,-19,-14,0,1,1
38,40,-2,0,0,0
3,8,-5,0,0,0
2,-14,16,1,0,1
-40,-29,-11,0,0,0
-20,-6,-14,0,0,0
28,11,17,1,0,1
13,23,-10,0,0,0
26,11,15,1,0,1
-50,-39,-11,0,0,0
-11,-31,20,1,0,1
-16,-33,17,1,0,1
-16,-1,-15,0,0,0
49,43,6,1,0,1
-14,-16,2,1,0,1
-27,-41,14,1,0,1
-23,-12,-11,0,1,1
14,12,2,1,1,0
-26,-32,6,1,1,0
-44,-34,-10,0,1,1
14,27,-13,0,1,1
-39,-43,4,1,1,0
20,35,-15,0,1,1
27,33,-6,0,1,1
-21,-41,20,1,0,1
-32,-29,-3,0,0,0
-26,-34,8,1,0,1
-40,-21,-19,0,0,0
31,22,9,1,0,1
-12,7,-19,0,0,0
28,37,-9,0,0,0
-26,-31,5,1,0,1
29,16,13,1,0,1
-45,-27,-18,0,0,0
-13,3,-16,0,0,0
44,35,9,1,0,1
-25,-20,-5,0,0,0
-25,-9,-16,0,1,1
33,34,-1,0,1,1
52,33,19,1,1,0
34,29,5,1,1,0
-14,-25,11,1,1,0
-34,-15,-19,0,1,1
-2,8,-10,0,1,1
9,-9,18,1,1,0
14,33,-19,0,1,1
-47,-33,-14,0,0,0
-15,-21,6,1,0,1
34,35,-1,0,0,0
-26,-43,17,1,0,1
-20,-7,-13,0,0,0
-6,6,-12,0,0,0
-1,-12,11,1,0,1
-17,-9,-8,0,0,0
5,0,5,1,0,1
-23,-38,15,1,0,1
-36,-19,-17,0,0,0
-12,-12,0,0,0,0
-23,-38,15,1,0,1
-12,-4,-8,0,0,0
19,10,9,1,0,1
14,3,11,1,0,1
47,36,11,1,1,0
36,33,3,1,1,0
-28,-17,-11,0,1,1
24,34,-10,0,1,1
45,41,4,1,1,0
53,33,20,1,1,0
20,24,-4,0,1,1
-25,-26,1,1,1,0
9,4,5,1,0,1
42,35,7,1,0,1
-32,-40,8,1,0,1
53,43,10,1,0,1
-61,-43,-18,0,0,0
-28,-22,-6,0,0,0
26,20,6,1,0,1
-6,-22,16,1,0,1
10,-4,14,1,0,1
-14,-26,12,1,0,1
17,-1,18,1,0,1
-23,-43,20,1,0,1
7,0,7,1,0,1
42,35,7,1,0,1
34,29,5,1,0,1
-18,-13,-5,0,0,0
-20,-15,-5,0,0,0
-4,12,-16,0,1,1
-18,-29,11,1,1,0
-7,7,-14,0,1,1
12,12,0,0,1,1
-8,-28,20,1,1,0
-9,-23,14,1,1,0
15,33,-18,0,1,1
-1,-20,19,1,1,0
19,24,-5,0,1,1
-14,-9,-5,0,1,1
-23,-42,19,1,1,0
16,31,-15,0,1,1
-5,-14,9,1,0,1
-10,-27,17,1,0,1
20,7,13,1,0,1
-48,-32,-16,0,0,0
-8,-16,8,1,0,1
5,-5,10,1,0,1
-2,5,-7,0,0,0
-12,2,-14,0,0,0
-17,-6,-11,0,0,0
25,8,17,1,0,1
35,30,5,1,0,1
-38,-38,0,0,0,0
25,21,4,1,0,1
22,28,-6,0,0,0
60,40,20,1,0,1
-45,-44,-1,0,0,0
-1,-2,1,1,0,1
-38,-43,5,1,0,1
-23,-4,-19,0,0,0
-45,-28,-17,0,0,0
47,32,15,1,0,1
4,-5,9,1,1,0
32,23,9,1,1,0
25,7,18,1,1,0
26,41,-15,0,1,1
55,40,15,1,1,0
14,5,9,1,1,0
-6,-7,1,1,1,0
-37,-26,-11,0,1,1
2,-16,18,1,1,0
-3,-8,5,1,1,0
-39,-37,-2,0,1,1
13,-3,16,1,1,0
-24,-7,-17,0,1,1
37,42,-5,0,1,1
12,4,8,1,1,0
-10,4,-14,0,1,1
5,-5,10,1,1,0
5,4,1,1,1,0
7,14,-7,0,1,1
-27,-35,8,1,1,0
21,41,-20,0,1,1
20,27,-7,0,0,0
-42,-27,-15,0,0,0
61,43,18,1,0,1
20,3,17,1,0,1
-16,0,-16,0,0,0
34,19,15,1,0,1
-11,-27,16,1,0,1
1,-3,4,1,0,1
12,32,-20,0,0,0
-6,-9,3,1,0,1
51,35,16,1,0,1
39,42,-3,0,0,0
5,16,-11,0,0,0
-26,-26,0,0,0,0
41,23,18,1,0,1
24,37,-13,0,0,0
27,12,15,1,0,1
37,28,9,1,0,1
16,33,-17,0,0,0
4,22,-18,0,0,0
10,-8,18,1,0,1
1,11,-10,0,1,1
30,42,-12,0,1,1
-33,-29,-4,0,1,1
22,16,6,1,1,0
40,36,4,1,1,0
3,-17,20,1,1,0
-2,3,-5,0,1,1
-10,-23,13,1,1,0
-13,-20,7,1,1,0
-26,-14,-12,0,1,1
1,17,-16,0,1,1
-26,-21,-5,0,1,1
-26,-19,-7,0,1,1
0,-11,11,1,1,0
42,29,13,1,1,0
49,32,17,1,1,0
13,-6,19,1,1,0
5,11,-6,0,0,0
-7,-11,4,1,0,1
50,30,20,1,0,1
52,41,11,1,0,1
-13,-26,13,1,0,1
-58,-42,-16,0,0,0
-32,-27,-5,0,0,0
-54,-44,-10,0,0,0
-6,5,-11,0,0,0
-22,-20,-2,0,0,0
-53,-33,-20,0,0,0
-17,-24,7,1,0,1
20,22,-2,0,0,0
4,-10,14,1,0,1
10,-9,19,1,0,1
-6,-7,1,1,1,0
-36,-20,-16,0,1,1
19,3,16,1,1,0
36,25,11,1,1,0
32,12,20,1,1,0
36,23,13,1,1,0
32,41,-9,0,1,1
43,37,6,1,1,0
53,40,13,1,1,0
10,-10,20,1,1,0
-43,-27,-16,0,0,0
2,8,-6,0,0,0
-25,-26,1,1,0,1
41,39,2,1,0,1
-13,2,-15,0,0,0
8,5,3,1,0,1
-1,-2,1,1,0,1
-23,-43,20,1,0,1
24,22,2,1,0,1
1,-7,8,1,0,1
4,-3,7,1,1,0
-23,-35,12,1,1,0
12,30,-18,0,1,1
16,25,-9,0,1,1
43,28,15,1,1,0
26,35,-9,0,1,1
52,43,9,1,1,0
-35,-28,-7,0,1,1
-46,-26,-20,0,1,1
-56,-42,-14,0,1,1
-56,-37,-19,0,1,1
30,10,20,1,1,0
-14,-33,19,1,1,0
14,27,-13,0,1,1
48,38,10,1,0,1
7,-10,17,1,0,1
20,10,10,1,0,1
-51,-45,-6,0,0,0
-37,-21,-16,0,0,0
-24,-7,-17,0,0,0
-25,-13,-12,0,0,0
-10,-13,3,1,0,1
-14,-4,-10,0,0,0
-39,-39,0,0,0,0
-25,-9,-16,0,0,0
-13,-5,-8,0,0,0
22,11,11,1,0,1
17,32,-15,0,0,0
-18,-36,18,1,0,1
-44,-25,-19,0,0,0
15,16,-1,0,0,0
-16,-5,-11,0,0,0
15,15,0,0,0,0
46,39,7,1,0,1
58,40,18,1,0,1
32,23,9,1,1,0
0,-4,4,1,1,0
-29,-45,16,1,1,0
4,-14,18,1,1,0
-25,-19,-6,0,1,1
-31,-27,-4,0,1,1
-3,-1,-2,0,1,1
-26,-32,6,1,1,0
-22,-5,-17,0,1,1
10,-8,18,1,1,0
-5,4,-9,0,0,0
-18,2,-20,0,0,0
-31,-34,3,1,0,1
-22,-7,-15,0,0,0
31,30,1,1,0,1
-19,-35,16,1,0,1
-35,-26,-9,0,0,0
-27,-33,6,1,0,1
-33,-34,1,1,0,1
-52,-45,-7,0,0,0
25,29,-4,0,0,0
-41,-38,-3,0,0,0
-21,-31,10,1,1,0
-32,-44,12,1,1,0
27,14,13,1,1,0
48,36,12,1,1,0
1,13,-12,0,1,1
16,29,-13,0,1,1
-20,-32,12,1,1,0
27,8,19,1,1,0
17,33,-16,0,0,0
-41,-21,-20,0,0,0
-26,-40,14,1,0,1
52,40,12,1,0,1
33,21,12,1,0,1
-34,-33,-1,0,0,0
-9,-3,-6,0,0,0
13,25,-12,0,0,0
35,29,6,1,1,0
-13,1,-14,0,1,1
-14,-2,-12,0,1,1
-12,-26,14,1,1,0
41,36,5,1,1,0
49,40,9,1,1,0
-17,-23,6,1,1,0
-31,-23,-8,0,1,1
37,31,6,1,1,0
-41,-42,1,1,0,1
24,33,-9,0,0,0
0,19,-19,0,0,0
-17,-10,-7,0,0,0
-34,-24,-10,0,0,0
-13,-1,-12,0,0,0
-28,-35,7,1,0,1
-4,-6,2,1,0,1
-20,-13,-7,0,0,0
-4,-24,20,1,0,1
-4,11,-15,0,0,0
-47,-33,-14,0,0,0
-23,-30,7,1,0,1
-48,-39,-9,0,0,0
-41,-28,-13,0,0,0
5,-9,14,1,0,1
1,-9,10,1,0,1
-19,-6,-13,0,0,0
37,24,13,1,1,0
-39,-39,0,0,1,1
8,-7,15,1,1,0
-18,-7,-11,0,1,1
-4,-14,10,1,1,0
15,-5,20,1,1,0
-35,-36,1,1,1,0
-60,-40,-20,0,1,1
2,20,-18,0,1,1
39,21,18,1,1,0
-3,-19,16,1,1,0
27,25,2,1,1,0
-54,-37,-17,0,1,1
-41,-41,0,0,0,0
1,-8,9,1,0,1
-14,-14,0,0,0,0
52,43,9,1,0,1
26,24,2,1,0,1
26,17,9,1,0,1
34,18,16,1,0,1
-16,-3,-13,0,0,0
7,-2,9,1,0,1
-15,4,-19,0,0,0
2,-9,11,1,0,1
-2,16,-18,0,1,1
-9,-1,-8,0,1,1
17,3,14,1,1,0
-23,-13,-10,0,1,1
45,30,15,1,1,0
1,13,-12,0,1,1
44,25,19,1,1,0
55,41,14,1,1,0
-49,-39,-10,0,1,1
39,40,-1,0,1,1
16,29,-13,0,1,1
-30,-21,-9,0,1,1
13,28,-15,0,1,1
8,17,-9,0,1,1
-12,-18,6,1,1,0
-18,-27,9,1,1,0
-20,-38,18,1,1,0
26,32,-6,0,0,0
43,41,2,1,0,1
-3,4,-7,0,0,0
22,33,-11,0,0,0
27,11,16,1,0,1
16,22,-6,0,0,0
51,40,11,1,0,1
-4,9,-13,0,0,0
18,11,7,1,0,1
-27,-21,-6,0,1,1
29,43,-14,0,1,1
-43,-30,-13,0,1,1
-9,-8,-1,0,1,1
61,41,20,1,1,0
-28,-17,-11,0,1,1
-6,-9,3,1,1,0
13,26,-13,0,1,1
4,21,-17,0,1,1
-42,-33,-9,0,1,1
0,20,-20,0,1,1
51,35,16,1,1,0
-32,-45,13,1,1,0
-16,-33,17,1,0,1
-53,-45,-8,0,0,0
-37,-30,-7,0,0,0
-57,-39,-18,0,0,0
-10,7,-17,0,0,0
-4,-14,10,1,0,1
-29,-19,-10,0,0,0
-1,3,-4,0,0,0
-13,-13,0,0,0,0
42,26,16,1,0,1
29,24,5,1,0,1
-24,-19,-5,0,0,0
-49,-38,-11,0,0,0
-24,-7,-17,0,0,0
-11,-30,19,1,0,1
23,28,-5,0,0,0
-10,-6,-4,0,1,1
42,25,17,1,1,0
27,20,7,1,1,0
-27,-31,4,1,1,0
6,17,-11,0,1,1
-1,-15,14,1,1,0
-25,-30,5,1,1,0
-17,-20,3,1,1,0
35,40,-5,0,1,1
-31,-20,-11,0,1,1
-40,-22,-18,0,1,1
-5,-10,5,1,1,0
14,15,-1,0,1,1
7,18,-11,0,1,1
-13,-8,-5,0,1,1
15,13,2,1,1,0
24,20,4,1,1,0
32,16,16,1,1,0
-27,-25,-2,0,1,1
-53,-39,-14,0,1,1
-32,-19,-13,0,1,1
-11,-8,-3,0,0,0
-64,-44,-20,0,0,0
25,20,5,1,0,1
24,13,11,1,0,1
3,18,-15,0,0,0
3,0,3,1,0,1
-39,-39,0,0,0,0
-4,-24,20,1,0,1
35,44,-9,0,0,0
33,39,-6,0,0,0
12,21,-9,0,0,0
-47,-36,-11,0,1,1
20,27,-7,0,1,1
-43,-30,-13,0,1,1
-52,-44,-8,0,1,1
-25,-8,-17,0,1,1
27,35,-8,0,1,1
-27,-16,-11,0,1,1
15,9,6,1,1,0
-33,-40,7,1,1,0
48,30,18,1,1,0
-29,-16,-13,0,1,1
-43,-25,-18,0,1,1
-22,-29,7,1,1,0
-20,-2,-18,0,1,1
19,31,-12,0,1,1
16,7,9,1,0,1
-34,-16,-18,0,0,0
29,38,-9,0,0,0
-27,-11,-16,0,0,0
-19,-36,17,1,0,1
22,32,-10,0,0,0
25,15,10,1,0,1
-13,-10,-3,0,0,0
-15,-31,16,1,0,1
-30,-17,-13,0,0,0
-8,-8,0,0,0,0
-22,-5,-17,0,1,1
-12,-9,-3,0,1,1
17,16,1,1,1,0
31,33,-2,0,1,1
-25,-27,2,1,1,0
42,28,14,1,1,0
21,11,10,1,1,0
35,15,20,1,1,0
29,23,6,1,1,0
47,39,8,1,1,0
30,43,-13,0,1,1
-16,-10,-6,0,1,1
44,28,16,1,1,0
43,33,10,1,1,0
31,35,-4,0,1,1
27,30,-3,0,1,1
45,41,4,1,1,0
16,30,-14,0,1,1
-5,-6,1,1,1,0
-12,-4,-8,0,1,1
-45,-39,-6,0,1,1
10,2,8,1,0,1
49,34,15,1,0,1
-7,-13,6,1,0,1
20,39,-19,0,0,0
1,-10,11,1,0,1
9,25,-16,0,0,0
-1,5,-6,0,0,0
-37,-43,6,1,0,1
10,23,-13,0,0,0
-22,-12,-10,0,0,0
11,28,-17,0,0,0
-22,-42,20,1,0,1
-35,-26,-9,0,0,0
-11,-16,5,1,0,1
-36,-42,6,1,0,1
47,36,11,1,0,1
-28,-24,-4,0,0,0
20,17,3,1,0,1
31,20,11,1,0,1
21,23,-2,0,0,0
46,26,20,1,0,1
13,5,8,1,1,0
17,37,-20,0,1,1
-3,0,-3,0,1,1
12,-7,19,1,1,0
16,36,-20,0,1,1
31,25,6,1,1,0
36,29,7,1,1,0
-19,-31,12,1,1,0
-36,-44,8,1,1,0
31,14,17,1,1,0
-2,15,-17,0,1,1
10,12,-2,0,1,1
-23,-13,-10,0,1,1
-1,-11,10,1,1,0
-18,-26,8,1,1,0
-15,-27,12,1,1,0
22,5,17,1,1,0
-23,-35,12,1,1,0
3,23,-20,0,0,0
-31,-40,9,1,0,1
29,19,10,1,0,1
-39,-45,6,1,0,1
16,8,8,1,0,1
44,25,19,1,0,1
-24,-34,10,1,0,1
30,43,-13,0,0,0
-58,-44,-14,0,1,1
26,42,-16,0,1,1
31,38,-7,0,1,1
-7,5,-12,0,1,1
8,10,-2,0,1,1
-18,-6,-12,0,1,1
-19,-22,3,1,1,0
19,15,4,1,1,0
36,38,-2,0,1,1
-55,-45,-10,0,0,0
1,10,-9,0,0,0
46,38,8,1,0,1
-3,-12,9,1,0,1
-10,-21,11,1,0,1
-31,-18,-13,0,0,0
18,6,12,1,0,1
-8,4,-12,0,0,0
9,1,8,1,0,1
-15,0,-15,0,0,0
-18,-36,18,1,0,1
2,10,-8,0,0,0
42,34,8,1,0,1
-29,-36,7,1,0,1
35,30,5,1,0,1
-40,-25,-15,0,0,0
-9,-26,17,1,0,1
-42,-28,-14,0,0,0
62,42,20,1,0,1
-28,-38,10,1,1,0
9,-2,11,1,1,0
-5,-19,14,1,1,0
-46,-43,-3,0,1,1
42,29,13,1,1,0
16,18,-2,0,1,1
11,21,-10,0,1,1
5,4,1,1,1,0
12,19,-7,0,1,1
44,25,19,1,1,0
4,17,-13,0,1,1
19,35,-16,0,1,1
10,-3,13,1,1,0
20,38,-18,0,1,1
10,-5,15,1,1,0
22,36,-14,0,1,1
-8,7,-15,0,1,1
-8,-27,19,1,1,0
-55,-41,-14,0,1,1
-13,-11,-2,0,1,1
-28,-15,-13,0,1,1
23,32,-9,0,0,0
-16,-6,-10,0,0,0
21,28,-7,0,0,0
4,24,-20,0,0,0
26,14,12,1,0,1
-6,5,-11,0,0,0
-43,-41,-2,0,0,0
5,0,5,1,0,1
15,2,13,1,0,1
-44,-34,-10,0,1,1
17,3,14,1,1,0
-11,4,-15,0,1,1
5,-3,8,1,1,0
-9,-28,19,1,1,0
-28,-9,-19,0,1,1
15,-1,16,1,1,0
14,-6,20,1,1,0
16,-1,17,1,1,0
31,38,-7,0,1,1
-26,-23,-3,0,1,1
17,12,5,1,1,0
-22,-28,6,1,1,0
8,1,7,1,1,0
13,33,-20,0,1,1
46,37,9,1,0,1
15,-1,16,1,0,1
29,24,5,1,0,1
24,31,-7,0,0,0
-50,-33,-17,0,0,0
14,31,-17,0,0,0
6,-4,10,1,0,1
11,-6,17,1,0,1
10,11,-1,0,0,0
22,4,18,1,0,1
-3,10,-13,0,0,0
4,20,-16,0,0,0
5,-13,18,1,0,1
0,7,-7,0,0,0
6,19,-13,0,1,1
-7,-5,-2,0,1,1
16,34,-18,0,1,1
5,7,-2,0,1,1
-24,-29,5,1,1,0
23,42,-19,0,1,1
-4,-22,18,1,1,0
8,-8,16,1,1,0
32,31,1,1,1,0
22,6,16,1,1,0
-41,-27,-14,0,1,1
-9,-10,1,1,1,0
-1,-8,7,1,1,0
0,20,-20,0,1,1
3,1,2,1,1,0
-45,-26,-19,0,1,1
-29,-9,-20,0,1,1
14,25,-11,0,0,0
7,26,-19,0,0,0
-44,-34,-10,0,0,0
-17,-37,20,1,0,1
51,41,10,1,0,1
12,0,12,1,0,1
24,12,12,1,0,1
-34,-21,-13,0,0,0
3,16,-13,0,1,1
36,21,15,1,1,0
4,0,4,1,1,0
-7,-4,-3,0,1,1
7,5,2,1,1,0
-25,-36,11,1,1,0
10,7,3,1,1,0
-17,-36,19,1,1,0
36,36,0,0,1,1
-15,-4,-11,0,1,1
18,25,-7,0,1,1
14,28,-14,0,1,1
-44,-41,-3,0,1,1
43,23,20,1,1,0
-11,8,-19,0,1,1
-4,1,-5,0,1,1
-35,-15,-20,0,1,1
3,12,-9,0,1,1
30,42,-12,0,1,1
8,-7,15,1,1,0
-5,-1,-4,0,1,1
30,21,9,1,0,1
20,8,12,1,0,1
-11,6,-17,0,0,0
-10,-29,19,1,0,1
-6,-24,18,1,0,1
-48,-31,-17,0,0,0
23,27,-4,0,0,0
2,6,-4,0,0,0
-15,-5,-10,0,0,0
-39,-35,-4,0,0,0
-10,9,-19,0,0,0
57,42,15,1,0,1
9,24,-15,0,0,0
-34,-27,-7,0,1,1
-33,-33,0,0,1,1
31,43,-12,0,1,1
-10,2,-12,0,1,1
33,19,14,1,1,0
33,16,17,1,1,0
-16,-12,-4,0,1,1
-35,-22,-13,0,1,1
-41,-38,-3,0,1,1
-17,-4,-13,0,1,1
19,17,2,1,1,0
2,1,1,1,1,0
7,-2,9,1,1,0
56,37,19,1,0,1
-44,-29,-15,0,0,0
-1,-12,11,1,0,1
30,18,12,1,0,1
22,41,-19,0,0,0
-1,17,-18,0,0,0
-5,-17,12,1,0,1
37,39,-2,0,0,0
-33,-34,1,1,1,0
8,14,-6,0,1,1
40,44,-4,0,1,1
10,-7,17,1,1,0
37,30,7,1,1,0
1,-18,19,1,1,0
22,38,-16,0,1,1
-52,-42,-10,0,1,1
35,18,17,1,1,0
6,-10,16,1,1,0
-12,0,-12,0,1,1
39,42,-3,0,1,1
-40,-43,3,1,1,0
4,6,-2,0,1,1
61,44,17,1,1,0
-5,6,-11,0,1,1
49,43,6,1,0,1
1,-5,6,1,0,1
-36,-35,-1,0,0,0
21,32,-11,0,0,0
-1,17,-18,0,0,0
-6,9,-15,0,0,0
36,44,-8,0,0,0
11,-4,15,1,0,1
-43,-28,-15,0,1,1
31,11,20,1,1,0
-15,-17,2,1,1,0
46,27,19,1,1,0
34,43,-9,0,1,1
20,6,14,1,1,0
-33,-39,6,1,1,0
8,-10,18,1,1,0
-38,-21,-17,0,1,1
11,12,-1,0,0,0
-26,-12,-14,0,0,0
18,10,8,1,0,1
-50,-42,-8,0,0,0
17,4,13,1,0,1
50,43,7,1,0,1
-53,-35,-18,0,0,0
52,39,13,1,0,1
-9,-15,6,1,0,1
24,42,-18,0,0,0
-32,-22,-10,0,0,0
44,39,5,1,0,1
24,40,-16,0,0,0
-17,-36,19,1,0,1
-42,-25,-17,0,0,0
14,1,13,1,0,1
9,-5,14,1,0,1
-36,-16,-20,0,0,0
-2,-14,12,1,0,1
27,13,14,1,1,0
29,42,-13,0,1,1
30,36,-6,0,1,1
21,31,-10,0,1,1
30,42,-12,0,1,1
-38,-22,-16,0,1,1
-1,15,-16,0,1,1
-47,-41,-6,0,1,1
36,17,19,1,1,0
3,2,1,1,1,0
-33,-40,7,1,1,0
18,24,-6,0,1,1
-52,-42,-10,0,1,1
14,23,-9,0,1,1
-28,-12,-16,0,1,1
33,20,13,1,1,0
-31,-29,-2,0,0,0
43,29,14,1,0,1
18,20,-2,0,0,0
-51,-31,-20,0,0,0
4,8,-4,0,0,0
32,22,10,1,0,1
8,25,-17,0,0,0
-29,-44,15,1,0,1
-12,-14,2,1,0,1
51,41,10,1,0,1
-24,-5,-19,0,0,0
-59,-42,-17,0,0,0
5,21,-16,0,0,0
18,13,5,1,0,1
-54,-44,-10,0,0,0
49,35,14,1,0,1
38,34,4,1,0,1
42,39,3,1,0,1
9,-10,19,1,0,1
-47,-38,-9,0,0,0
34,30,4,1,0,1
-37,-43,6,1,1,0
-25,-9,-16,0,1,1
42,42,0,0,1,1
10,2,8,1,1,0
-7,11,-18,0,1,1
-25,-41,16,1,1,0
-49,-29,-20,0,1,1
-8,-27,19,1,1,0
-1,8,-9,0,1,1
-31,-22,-9,0,1,1
-31,-20,-11,0,0,0
-55,-35,-20,0,0,0
7,2,5,1,0,1
2,7,-5,0,0,0
17,24,-7,0,0,0
-4,-13,9,1,0,1
13,24,-11,0,0,0
-37,-40,3,1,0,1
-18,-2,-16,0,0,0
18,7,11,1,1,0
18,15,3,1,1,0
0,5,-5,0,1,1
-10,9,-19,0,1,1
12,5,7,1,1,0
2,6,-4,0,1,1
-23,-5,-18,0,1,1
12,24,-12,0,1,1
-18,-18,0,0,1,1
5,3,2,1,1,0
16,17,-1,0,1,1
48,35,13,1,0,1
-8,-11,3,1,0,1
-13,4,-17,0,0,0
29,38,-9,0,0,0
5,5,0,0,0,0
34,29,5,1,0,1
6,-12,18,1,0,1
-21,-5,-16,0,0,0
12,21,-9,0,0,0
58,39,19,1,0,1
24,43,-19,0,0,0
-29,-16,-13,0,1,1
-22,-13,-9,0,1,1
29,43,-14,0,1,1
12,-2,14,1,1,0
11,-3,14,1,1,0
-32,-14,-18,0,1,1
-21,-11,-10,0,1,1
11,-7,18,1,1,0
-13,-26,13,1,1,0
26,34,-8,0,1,1
-9,2,-11,0,1,1
34,21,13,1,1,0
34,33,1,1,1,0
56,43,13,1,1,0
-56,-45,-11,0,1,1
-34,-33,-1,0,1,1
21,9,12,1,1,0
-29,-34,5,1,1,0
8,-9,17,1,1,0
-7,7,-14,0,1,1
36,28,8,1,1,0
36,31,5,1,0,1
12,25,-13,0,0,0
1,17,-16,0,0,0
-5,-1,-4,0,0,0
10,20,-10,0,0,0
3,13,-10,0,0,0
-17,-34,17,1,0,1
-25,-9,-16,0,0,0
9,22,-13,0,0,0
-6,-13,7,1,1,0
19,2,17,1,1,0
-26,-11,-15,0,1,1
44,30,14,1,1,0
-11,0,-11,0,1,1
38,44,-6,0,1,1
-45,-26,-19,0,1,1
-10,-15,5,1,1,0
14,10,4,1,1,0
-3,17,-20,0,1,1
33,24,9,1,1,0
20,40,-20,0,0,0
-9,-8,-1,0,0,0
26,24,2,1,0,1
-26,-44,18,1,0,1
42,33,9,1,0,1
-11,-17,6,1,0,1
16,27,-11,0,0,0
-37,-41,4,1,0,1
10,18,-8,0,0,0
18,37,-19,0,0,0
-29,-12,-17,0,0,0
-41,-27,-14,0,0,0
46,28,18,1,0,1
10,30,-20,0,0,0
-21,-37,16,1,0,1
15,8,7,1,0,1
-32,-40,8,1,0,1
8,-12,20,1,0,1
-19,-17,-2,0,0,0
-31,-41,10,1,0,1
-35,-35,0,0,0,0
22,2,20,1,1,0
19,15,4,1,1,0
-5,-1,-4,0,1,1
26,10,16,1,1,0
12,5,7,1,1,0
-51,-39,-12,0,1,1
43,27,16,1,1,0
28,14,14,1,1,0
-50,-36,-14,0,1,1
-19,-26,7,1,1,0
49,29,20,1,0,1
-44,-30,-14,0,0,0
55,44,11,1,0,1
-30,-33,3,1,0,1
-32,-33,1,1,0,1
23,36,-13,0,0,0
-15,-11,-4,0,0,0
-17,-14,-3,0,0,0
43,43,0,0,0,0
-17,-12,-5,0,0,0
19,-1,20,1,0,1
14,16,-2,0,0,0
28,28,0,0,0,0
-40,-38,-2,0,0,0
16,17,-1,0,0,0
-18,-35,17,1,0,1
-32,-37,5,1,0,1
-57,-42,-15,0,0,0
2,9,-7,0,0,0
-12,-13,1,1,0,1
24,7,17,1,0,1
29,22,7,1,1,0
29,11,18,1,1,0
-23,-19,-4,0,1,1
36,19,17,1,1,0
-42,-26,-16,0,1,1
15,19,-4,0,1,1
-12,-2,-10,0,1,1
1,16,-15,0,1,1
5,-4,9,1,1,0
-27,-23,-4,0,1,1
-28,-41,13,1,1,0
-7,-14,7,1,1,0
25,15,10,1,1,0
-7,-11,4,1,1,0
22,42,-20,0,1,1
53,33,20,1,1,0
29,32,-3,0,1,1
32,24,8,1,1,0
31,38,-7,0,1,1
12,29,-17,0,1,1
14,19,-5,0,1,1
41,41,0,0,0,0
25,19,6,1,0,1
-47,-29,-18,0,0,0
-51,-36,-15,0,0,0
28,40,-12,0,0,0
-42,-43,1,1,0,1
-38,-39,1,1,0,1
1,-4,5,1,0,1
26,6,20,1,1,0
-3,14,-17,0,1,1
34,23,11,1,1,0
34,22,12,1,1,0
-16,-36,20,1,1,0
-7,-7,0,0,1,1
38,39,-1,0,1,1
5,17,-12,0,1,1
32,28,4,1,1,0
23,16,7,1,1,0
-49,-31,-18,0,0,0
60,42,18,1,0,1
6,5,1,1,0,1
5,-2,7,1,0,1
-25,-27,2,1,0,1
52,44,8,1,0,1
-8,-26,18,1,0,1
39,30,9,1,0,1
-45,-27,-18,0,0,0
0,9,-9,0,0,0
-9,-10,1,1,0,1
-17,-15,-2,0,0,0
16,8,8,1,0,1
28,30,-2,0,0,0
7,6,1,1,0,1
-20,-39,19,1,0,1
-33,-14,-19,0,0,0
18,24,-6,0,0,0
36,24,12,1,1,0
-26,-11,-15,0,1,1
-44,-31,-13,0,1,1
-19,-2,-17,0,1,1
13,31,-18,0,1,1
-20,-4,-16,0,1,1
8,-12,20,1,1,0
12,20,-8,0,1,1
41,27,14,1,1,0
28,18,10,1,1,0
-46,-29,-17,0,0,0
-5,-5,0,0,0,0
-61,-41,-20,0,0,0
-10,-25,15,1,0,1
24,14,10,1,0,1
15,2,13,1,0,1
25,11,14,1,0,1
7,5,2,1,0,1
2,18,-16,0,0,0
53,42,11,1,0,1
34,33,1,1,0,1
17,9,8,1,0,1
12,4,8,1,0,1
20,28,-8,0,0,0
-33,-19,-14,0,0,0
0,1,-1,0,0,0
-10,-19,9,1,0,1
-34,-31,-3,0,0,0
-14,-23,9,1,1,0
-26,-10,-16,0,1,1
33,40,-7,0,1,1
40,29,11,1,1,0
6,10,-4,0,1,1
-21,-39,18,1,1,0
-36,-32,-4,0,1,1
-36,-17,-19,0,1,1
-42,-25,-17,0,1,1
16,1,15,1,1,0
-26,-44,18,1,1,0
31,11,20,1,1,0
13,13,0,0,1,1
-7,-5,-2,0,1,1
-33,-43,10,1,0,1
41,27,14,1,0,1
19,34,-15,0,0,0
-43,-30,-13,0,0,0
28,8,20,1,0,1
-27,-11,-16,0,0,0
-10,0,-10,0,0,0
-3,-2,-1,0,0,0
15,16,-1,0,0,0
-27,-24,-3,0,0,0
-27,-24,-3,0,0,0
-58,-45,-13,0,0,0
40,38,2,1,0,1
25,34,-9,0,0,0
24,32,-8,0,0,0
6,4,2,1,0,1
-8,-3,-5,0,1,1
-7,-4,-3,0,1,1
-56,-45,-11,0,1,1
3,4,-1,0,1,1
23,8,15,1,1,0
4,9,-5,0,1,1
-49,-40,-9,0,1,1
-33,-41,8,1,1,0
7,18,-11,0,1,1
-37,-19,-18,0,1,1
-3,15,-18,0,0,0
-32,-36,4,1,0,1
26,22,4,1,0,1
36,32,4,1,0,1
31,23,8,1,0,1
-39,-33,-6,0,0,0
-9,-2,-7,0,0,0
-21,-16,-5,0,0,0
-37,-42,5,1,0,1
11,0,11,1,0,1
-22,-4,-18,0,0,0
-25,-10,-15,0,1,1
5,12,-7,0,1,1
10,17,-7,0,1,1
18,10,8,1,1,0
5,-5,10,1,1,0
6,26,-20,0,1,1
32,25,7,1,1,0
1,-9,10,1,1,0
-2,-5,3,1,1,0
-21,-29,8,1,1,0
27,13,14,1,1,0
23,14,9,1,1,0
-17,-31,14,1,1,0
5,-13,18,1,1,0
-27,-22,-5,0,1,1
-42,-22,-20,0,1,1
60,41,19,1,1,0
7,-9,16,1,1,0
40,33,7,1,1,0
-9,-26,17,1,1,0
27,32,-5,0,1,1
27,20,7,1,0,1
-38,-37,-1,0,0,0
11,30,-19,0,0,0
29,43,-14,0,0,0
35,18,17,1,0,1
13,7,6,1,0,1
50,35,15,1,0,1
-33,-40,7,1,0,1
38,33,5,1,0,1
14,31,-17,0,0,0
-14,-2,-12,0,0,0
-31,-43,12,1,0,1
-23,-38,15,1,0,1
-18,-8,-10,0,0,0
33,17,16,1,0,1
7,-7,14,1,0,1
-32,-13,-19,0,0,0
-38,-37,-1,0,0,0
-16,-19,3,1,0,1
28,20,8,1,0,1
-58,-41,-17,0,0,0
-19,-3,-16,0,1,1
-52,-41,-11,0,1,1
7,14,-7,0,1,1
-48,-36,-12,0,1,1
11,-8,19,1,1,0
11,1,10,1,1,0
28,29,-1,0,1,1
-4,-5,1,1,1,0
1,4,-3,0,1,1
4,10,-6,0,1,1
-11,-10,-1,0,1,1
-5,-10,5,1,1,0
17,13,4,1,1,0
-20,-27,7,1,1,0
24,36,-12,0,0,0
18,6,12,1,0,1
24,41,-17,0,0,0
-24,-6,-18,0,0,0
54,36,18,1,0,1
11,22,-11,0,0,0
-37,-25,-12,0,0,0
-24,-39,15,1,0,1
12,-1,13,1,0,1
30,19,11,1,0,1
0,16,-16,0,0,0
-28,-15,-13,0,0,0
51,40,11,1,0,1
43,35,8,1,0,1
-21,-4,-17,0,1,1
3,-7,10,1,1,0
14,6,8,1,1,0
0,19,-19,0,1,1
-26,-37,11,1,1,0
-38,-26,-12,0,1,1
-25,-41,16,1,1,0
23,27,-4,0,1,1
26,39,-13,0,1,1
12,19,-7,0,1,1
24,37,-13,0,1,1
1,0,1,1,1,0
38,22,16,1,1,0
13,11,2,1,1,0
-2,-3,1,1,1,0
29,11,18,1,1,0
-16,1,-17,0,1,1
1,10,-9,0,1,1
23,28,-5,0,1,1
-4,-21,17,1,1,0
26,20,6,1,1,0
-8,-24,16,1,0,1
2,4,-2,0,0,0
32,33,-1,0,0,0
40,40,0,0,0,0
51,43,8,1,0,1
18,28,-10,0,0,0
-30,-32,2,1,0,1
-54,-39,-15,0,0,0
20,3,17,1,1,0
30,44,-14,0,1,1
-28,-16,-12,0,1,1
0,-15,15,1,1,0
38,34,4,1,1,0
-36,-18,-18,0,1,1
-8,-8,0,0,1,1
6,22,-16,0,1,1
3,-10,13,1,1,0
14,31,-17,0,1,1
5,-12,17,1,0,1
19,7,12,1,0,1
39,41,-2,0,0,0
0,8,-8,0,0,0
-49,-41,-8,0,0,0
-46,-37,-9,0,0,0
-16,-7,-9,0,0,0
1,8,-7,0,0,0
-41,-36,-5,0,0,0
-20,-16,-4,0,0,0
-9,-10,1,1,1,0
53,33,20,1,1,0
23,4,19,1,1,0
-22,-3,-19,0,1,1
5,14,-9,0,1,1
26,28,-2,0,1,1
34,14,20,1,1,0
50,32,18,1,1,0
32,34,-2,0,1,1
-58,-40,-18,0,1,1
-27,-13,-14,0,0,0
-26,-39,13,1,0,1
44,25,19,1,0,1
30,41,-11,0,0,0
-44,-41,-3,0,0,0
18,19,-1,0,0,0
20,21,-1,0,0,0
32,42,-10,0,0,0
-35,-15,-20,0,0,0
26,42,-16,0,0,0
11,16,-5,0,0,0
-3,-18,15,1,0,1
22,27,-5,0,0,0
18,23,-5,0,0,0
-45,-30,-15,0,1,1
17,24,-7,0,1,1
-36,-24,-12,0,1,1
-29,-12,-17,0,1,1
-18,-36,18,1,1,0
41,32,9,1,1,0
-8,-28,20,1,1,0
-31,-41,10,1,1,0
-3,-20,17,1,1,0
27,29,-2,0,1,1
54,34,20,1,1,0
1,-10,11,1,1,0
26,17,9,1,1,0
-26,-28,2,1,1,0
15,34,-19,0,1,1
-32,-17,-15,0,1,1
-31,-12,-19,0,1,1
-2,-7,5,1,1,0
-43,-43,0,0,1,1
-60,-44,-16,0,1,1
-16,-22,6,1,1,0
4,5,-1,0,0,0
-14,-8,-6,0,0,0
-60,-40,-20,0,0,0
26,18,8,1,0,1
-20,-38,18,1,0,1
-9,-21,12,1,0,1
33,32,1,1,0,1
-4,6,-10,0,0,0
-43,-33,-10,0,1,1
-23,-41,18,1,1,0
50,42,8,1,1,0
-57,-40,-17,0,1,1
-27,-25,-2,0,1,1
-25,-44,19,1,1,0
38,28,10,1,1,0
19,8,11,1,1,0
-12,-19,7,1,1,0
24,17,7,1,1,0
23,41,-18,0,1,1
34,35,-1,0,1,1
-32,-14,-18,0,1,1
-21,-31,10,1,0,1
5,-11,16,1,0,1
18,22,-4,0,0,0
8,-11,19,1,0,1
-26,-22,-4,0,0,0
10,-1,11,1,0,1
24,5,19,1,0,1
48,41,7,1,0,1
-8,-7,-1,0,0,0
18,30,-12,0,1,1
-14,-33,19,1,1,0
-37,-30,-7,0,1,1
-13,-25,12,1,1,0
40,31,9,1,1,0
-36,-27,-9,0,1,1
-14,-10,-4,0,1,1
16,-4,20,1,1,0
14,9,5,1,1,0
10,7,3,1,0,1
45,36,9,1,0,1
-24,-42,18,1,0,1
-9,2,-11,0,0,0
-40,-41,1,1,0,1
-45,-28,-17,0,0,0
-5,14,-19,0,0,0
-6,-15,9,1,0,1
-4,-13,9,1,0,1
-38,-43,5,1,0,1
-9,-23,14,1,0,1
10,23,-13,0,0,0
50,44,6,1,0,1
34,17,17,1,0,1
36,40,-4,0,0,0
-8,-26,18,1,0,1
23,19,4,1,0,1
20,29,-9,0,0,0
3,-17,20,1,1,0
15,22,-7,0,1,1
-3,-20,17,1,1,0
46,37,9,1,1,0
46,26,20,1,1,0
-24,-44,20,1,1,0
3,-11,14,1,1,0
11,12,-1,0,1,1
20,34,-14,0,1,1
49,34,15,1,1,0
-28,-39,11,1,1,0
-32,-25,-7,0,1,1
-26,-37,11,1,1,0
26,29,-3,0,1,1
-29,-16,-13,0,0,0
-6,-22,16,1,0,1
28,8,20,1,0,1
11,13,-2,0,0,0
-60,-41,-19,0,0,0
25,21,4,1,0,1
23,11,12,1,0,1
-11,-25,14,1,0,1
20,35,-15,0,0,0
58,38,20,1,0,1
21,1,20,1,0,1
-5,-20,15,1,1,0
21,18,3,1,1,0
22,18,4,1,1,0
13,12,1,1,1,0
-41,-30,-11,0,1,1
29,38,-9,0,1,1
48,36,12,1,1,0
26,44,-18,0,1,1
-24,-26,2,1,1,0
16,20,-4,0,1,1
41,24,17,1,1,0
-35,-38,3,1,1,0
4,11,-7,0,0,0
-36,-42,6,1,0,1
6,21,-15,0,0,0
-23,-4,-19,0,0,0
-12,3,-15,0,0,0
-19,-17,-2,0,0,0
12,-7,19,1,0,1
3,13,-10,0,0,0
40,35,5,1,0,1
-21,-29,8,1,0,1
-11,4,-15,0,0,0
16,20,-4,0,0,0
6,24,-18,0,0,0
10,1,9,1,0,1
-57,-45,-12,0,0,0
13,4,9,1,0,1
54,34,20,1,0,1
0,15,-15,0,0,0
-42,-34,-8,0,0,0
10,-4,14,1,0,1
26,11,15,1,0,1
19,39,-20,0,1,1
-55,-42,-13,0,1,1
-17,-33,16,1,1,0
23,39,-16,0,1,1
-3,-22,19,1,1,0
-16,-25,9,1,1,0
-5,15,-20,0,1,1
-4,-10,6,1,1,0
38,26,12,1,1,0
19,20,-1,0,1,1
26,26,0,0,1,1
-35,-23,-12,0,1,1
0,-4,4,1,1,0
-18,-18,0,0,1,1
-7,-16,9,1,1,0
33,33,0,0,1,1
-19,-7,-12,0,0,0
9,13,-4,0,0,0
-3,0,-3,0,0,0
-34,-35,1,1,0,1
-50,-36,-14,0,0,0
-26,-19,-7,0,0,0
0,-3,3,1,0,1
17,2,15,1,0,1
5,17,-12,0,0,0
-1,11,-12,0,0,0
52,39,13,1,0,1
36,21,15,1,0,1
-35,-37,2,1,0,1
29,19,10,1,0,1
-17,-4,-13,0,0,0
17,18,-1,0,0,0
-17,-25,8,1,0,1
29,28,1,1,0,1
-3,2,-5,0,0,0
-15,1,-16,0,0,0
-53,-37,-16,0,1,1
-5,-3,-2,0,1,1
46,27,19,1,1,0
-37,-19,-18,0,1,1
-24,-42,18,1,1,0
-28,-33,5,1,1,0
26,31,-5,0,1,1
48,30,18,1,1,0
-30,-45,15,1,1,0
-3,16,-19,0,0,0
-18,-32,14,1,0,1
-12,-26,14,1,0,1
-22,-38,16,1,0,1
24,9,15,1,0,1
-5,11,-16,0,0,0
29,9,20,1,0,1
-3,-21,18,1,0,1
-26,-44,18,1,1,0
57,42,15,1,1,0
-10,-14,4,1,1,0
27,20,7,1,1,0
-36,-27,-9,0,1,1
1,-8,9,1,1,0
-6,-14,8,1,1,0
-22,-33,11,1,1,0
-30,-18,-12,0,0,0
29,34,-5,0,0,0
-38,-37,-1,0,0,0
-15,-35,20,1,0,1
-25,-6,-19,0,0,0
11,6,5,1,0,1
-26,-44,18,1,0,1
2,-4,6,1,0,1
37,31,6,1,0,1
5,18,-13,0,0,0
-17,-25,8,1,0,1
-16,-8,-8,0,0,0
-12,-21,9,1,0,1
13,23,-10,0,0,0
5,4,1,1,0,1
8,-4,12,1,1,0
-4,2,-6,0,1,1
-4,-7,3,1,1,0
-24,-11,-13,0,1,1
22,11,11,1,1,0
-9,-22,13,1,1,0
5,20,-15,0,1,1
-52,-32,-20,0,1,1
21,22,-1,0,1,1
38,33,5,1,1,0
-42,-27,-15,0,1,1
-38,-23,-15,0,1,1
47,39,8,1,1,0
-49,-34,-15,0,1,1
-40,-33,-7,0,1,1
42,26,16,1,1,0
5,-8,13,1,1,0
32,13,19,1,1,0
58,41,17,1,1,0
30,42,-12,0,1,1
-36,-39,3,1,1,0
-17,-29,12,1,0,1
5,-1,6,1,0,1
6,0,6,1,0,1
34,17,17,1,0,1
1,-15,16,1,0,1
-12,-8,-4,0,0,0
38,26,12,1,0,1
-1,17,-18,0,0,0
1,3,-2,0,0,0
-52,-36,-16,0,0,0
29,43,-14,0,0,0
16,29,-13,0,0,0
-29,-22,-7,0,0,0
28,19,9,1,0,1
-3,-1,-2,0,0,0
42,28,14,1,0,1
49,42,7,1,1,0
6,9,-3,0,1,1
-12,-24,12,1,1,0
-31,-37,6,1,1,0
30,23,7,1,1,0
-5,-11,6,1,1,0
14,14,0,0,1,1
-8,-22,14,1,1,0
10,5,5,1,1,0
-18,-14,-4,0,1,1
-48,-31,-17,0,1,1
4,16,-12,0,1,1
57,38,19,1,1,0
-31,-42,11,1,1,0
19,8,11,1,1,0
-32,-21,-11,0,0,0
17,-2,19,1,0,1
19,2,17,1,0,1
-23,-23,0,0,0,0
-16,-17,1,1,0,1
3,16,-13,0,0,0
36,43,-7,0,0,0
8,18,-10,0,0,0
-13,2,-15,0,0,0
-18,-5,-13,0,0,0
4,20,-16,0,0,0
50,35,15,1,0,1
31,31,0,0,0,0
-58,-38,-20,0,0,0
-23,-40,17,1,0,1
45,37,8,1,1,0
-4,-16,12,1,1,0
-35,-31,-4,0,1,1
20,33,-13,0,1,1
20,27,-7,0,1,1
-39,-42,3,1,1,0
20,15,5,1,1,0
-21,-18,-3,0,1,1
15,6,9,1,1,0
43,37,6,1,1,0
-8,-17,9,1,0,1
61,41,20,1,0,1
17,4,13,1,0,1
-27,-22,-5,0,0,0
4,-16,20,1,0,1
14,-4,18,1,0,1
-41,-31,-10,0,0,0
-18,-34,16,1,0,1
2,10,-8,0,0,0
-18,-13,-5,0,0,0
-29,-29,0,0,0,0
17,28,-11,0,0,0
-45,-26,-19,0,0,0
20,12,8,1,1,0
-18,-35,17,1,1,0
0,-15,15,1,1,0
-34,-32,-2,0,1,1
6,-13,19,1,1,0
-11,-21,10,1,1,0
33,34,-1,0,1,1
-49,-42,-7,0,1,1
17,0,17,1,1,0
34,36,-2,0,1,1
8,26,-18,0,0,0
34,41,-7,0,0,0
8,10,-2,0,0,0
-21,-28,7,1,0,1
29,31,-2,0,0,0
-19,-9,-10,0,0,0
-9,-10,1,1,0,1
-10,-19,9,1,0,1
-44,-39,-5,0,0,0
54,43,11,1,1,0
-4,-5,1,1,1,0
47,38,9,1,1,0
15,27,-12,0,1,1
-53,-44,-9,0,1,1
52,44,8,1,1,0
-25,-45,20,1,1,0
-19,-19,0,0,1,1
-17,-24,7,1,0,1
-9,-9,0,0,0,0
18,26,-8,0,0,0
-4,5,-9,0,0,0
-13,-11,-2,0,0,0
27,12,15,1,0,1
35,20,15,1,0,1
27,26,1,1,0,1
11,-2,13,1,0,1
-26,-35,9,1,0,1
2,-11,13,1,0,1
29,26,3,1,1,0
44,38,6,1,1,0
9,23,-14,0,1,1
-20,-21,1,1,1,0
-49,-34,-15,0,1,1
-11,-21,10,1,1,0
25,35,-10,0,1,1
-19,-38,19,1,1,0
-57,-38,-19,0,0,0
-5,2,-7,0,0,0
-38,-27,-11,0,0,0
-43,-37,-6,0,0,0
16,12,4,1,0,1
-5,-3,-2,0,0,0
-45,-29,-16,0,0,0
-17,-19,2,1,0,1
44,33,11,1,0,1
30,40,-10,0,0,0
27,19,8,1,0,1
-26,-20,-6,0,0,0
24,10,14,1,0,1
32,27,5,1,0,1
-35,-20,-15,0,0,0
25,44,-19,0,0,0
22,4,18,1,0,1
-53,-39,-14,0,0,0
11,22,-11,0,0,0
-12,-7,-5,0,0,0
21,4,17,1,0,1
24,29,-5,0,1,1
-3,0,-3,0,1,1
-15,-2,-13,0,1,1
-14,5,-19,0,1,1
33,38,-5,0,1,1
25,31,-6,0,1,1
-9,-22,13,1,1,0
-34,-29,-5,0,1,1
2,21,-19,0,1,1
13,1,12,1,1,0
12,20,-8,0,1,1
-49,-31,-18,0,1,1
13,10,3,1,1,0
5,5,0,0,0,0
-14,6,-20,0,0,0
-42,-24,-18,0,0,0
-16,-23,7,1,0,1
-5,-23,18,1,0,1
61,43,18,1,0,1
-4,10,-14,0,0,0
-29,-44,15,1,0,1
18,6,12,1,1,0
-32,-14,-18,0,1,1
15,11,4,1,1,0
-33,-28,-5,0,1,1
20,22,-2,0,1,1
35,42,-7,0,1,1
-7,0,-7,0,1,1
-2,-15,13,1,1,0
19,1,18,1,1,0
2,2,0,0,1,1
13,-3,16,1,1,0
27,13,14,1,1,0
-46,-32,-14,0,1,1
31,35,-4,0,1,1
-1,-6,5,1,1,0
31,33,-2,0,0,0
42,29,13,1,0,1
-39,-28,-11,0,0,0
-27,-30,3,1,0,1
52,34,18,1,0,1
-28,-34,6,1,0,1
-39,-38,-1,0,0,0
-17,-37,20,1,0,1
-4,-1,-3,0,1,1
37,40,-3,0,1,1
26,24,2,1,1,0
23,22,1,1,1,0
-41,-44,3,1,1,0
36,18,18,1,1,0
8,23,-15,0,1,1
-7,9,-16,0,1,1
63,43,20,1,1,0
25,11,14,1,1,0
-7,-8,1,1,0,1
28,38,-10,0,0,0
-13,-5,-8,0,0,0
-50,-30,-20,0,0,0
7,27,-20,0,0,0
-25,-20,-5,0,0,0
29,10,19,1,0,1
13,32,-19,0,0,0
-21,-8,-13,0,0,0
35,23,12,1,0,1
-14,-9,-5,0,0,0
8,-8,16,1,0,1
-29,-25,-4,0,1,1
20,14,6,1,1,0
26,39,-13,0,1,1
22,30,-8,0,1,1
42,23,19,1,1,0
7,12,-5,0,1,1
38,30,8,1,1,0
-31,-27,-4,0,1,1
-48,-43,-5,0,1,1
-30,-32,2,1,1,0
-6,-19,13,1,1,0
1,0,1,1,1,0
26,11,15,1,1,0
-20,-29,9,1,1,0
41,42,-1,0,1,1
-15,5,-20,0,1,1
11,-9,20,1,1,0
7,2,5,1,1,0
22,35,-13,0,1,1
39,34,5,1,1,0
-17,-6,-11,0,1,1
19,10,9,1,0,1
32,38,-6,0,0,0
-48,-39,-9,0,0,0
-25,-20,-5,0,0,0
11,29,-18,0,0,0
20,40,-20,0,0,0
-11,8,-19,0,0,0
-42,-25,-17,0,0,0
0,14,-14,0,0,0
-36,-25,-11,0,0,0
-37,-35,-2,0,0,0
-12,-2,-10,0,0,0
8,-6,14,1,1,0
-31,-43,12,1,1,0
33,25,8,1,1,0
5,-7,12,1,1,0
19,34,-15,0,1,1
-27,-33,6,1,1,0
-29,-28,-1,0,1,1
-30,-10,-20,0,1,1
-13,0,-13,0,1,1
-52,-37,-15,0,1,1
13,23,-10,0,1,1
-38,-27,-11,0,1,1
45,42,3,1,1,0
-37,-24,-13,0,1,1
26,43,-17,0,1,1
18,34,-16,0,1,1
-1,19,-20,0,1,1
-5,1,-6,0,1,1
17,30,-13,0,1,1
31,35,-4,0,1,1
-35,-43,8,1,1,0
17,14,3,1,0,1
-49,-39,-10,0,0,0
-4,-9,5,1,0,1
-44,-32,-12,0,0,0
-21,-8,-13,0,0,0
-56,-36,-20,0,0,0
-17,-29,12,1,0,1
24,5,19,1,0,1
-28,-12,-16,0,0,0
-44,-34,-10,0,0,0
12,25,-13,0,0,0
-41,-31,-10,0,1,1
-17,-22,5,1,1,0
56,38,18,1,1,0
-35,-19,-16,0,1,1
-19,-6,-13,0,1,1
-8,-26,18,1,1,0
-25,-29,4,1,1,0
-2,-21,19,1,1,0
25,33,-8,0,1,1
-10,-30,20,1,1,0
-14,-25,11,1,1,0
-19,-1,-18,0,1,1
-5,-21,16,1,1,0
-33,-37,4,1,1,0
-28,-11,-17,0,1,1
-42,-23,-19,0,0,0
-49,-43,-6,0,0,0
10,-8,18,1,0,1
-39,-36,-3,0,0,0
-49,-43,-6,0,0,0
-13,-18,5,1,0,1
-29,-20,-9,0,0,0
-31,-14,-17,0,0,0
21,37,-16,0,0,0
-2,15,-17,0,0,0
-17,-12,-5,0,0,0
23,23,0,0,0,0
-4,-10,6,1,0,1
-10,-28,18,1,0,1
-56,-45,-11,0,0,0
50,34,16,1,0,1
57,44,13,1,0,1
-29,-18,-11,0,0,0
-24,-34,10,1,0,1
29,18,11,1,0,1
-24,-16,-8,0,0,0
-19,-22,3,1,1,0
-44,-25,-19,0,1,1
9,11,-2,0,1,1
-1,-15,14,1,1,0
-33,-29,-4,0,1,1
33,31,2,1,1,0
-12,-8,-4,0,1,1
-4,0,-4,0,1,1
-1,-17,16,1,1,0
-52,-43,-9,0,1,1
26,11,15,1,1,0
-4,-11,7,1,1,0
20,11,9,1,1,0
30,31,-1,0,1,1
24,36,-12,0,1,1
11,-6,17,1,0,1
37,40,-3,0,0,0
24,16,8,1,0,1
-20,-2,-18,0,0,0
14,32,-18,0,0,0
18,19,-1,0,0,0
-6,-14,8,1,0,1
-21,-35,14,1,0,1
-25,-29,4,1,0,1
-36,-38,2,1,0,1
18,21,-3,0,0,0
3,22,-19,0,0,0
29,26,3,1,0,1
-4,11,-15,0,0,0
-23,-42,19,1,0,1
43,27,16,1,0,1
25,10,15,1,0,1
15,5,10,1,0,1
3,-13,16,1,0,1
10,22,-12,0,0,0
-24,-16,-8,0,0,0
10,-7,17,1,1,0
-15,-24,9,1,1,0
-48,-36,-12,0,1,1
5,-15,20,1,1,0
1,-10,11,1,1,0
24,25,-1,0,1,1
17,17,0,0,1,1
14,24,-10,0,1,1
6,21,-15,0,1,1
-7,-5,-2,0,1,1
9,19,-10,0,1,1
-1,-12,11,1,1,0
-32,-22,-10,0,1,1
12,19,-7,0,1,1
0,10,-10,0,1,1
-35,-23,-12,0,1,1
19,21,-2,0,1,1
-33,-35,2,1,1,0
55,41,14,1,1,0
-17,-9,-8,0,1,1
33,21,12,1,1,0
-2,-16,14,1,0,1
-31,-44,13,1,0,1
22,20,2,1,0,1
25,8,17,1,0,1
-16,-31,15,1,0,1
-6,1,-7,0,0,0
54,43,11,1,0,1
-26,-36,10,1,0,1
-31,-31,0,0,0,0
-13,-13,0,0,0,0
-28,-45,17,1,0,1
-26,-8,-18,0,0,0
27,25,2,1,0,1
17,6,11,1,0,1
28,15,13,1,1,0
40,39,1,1,1,0
-7,-20,13,1,1,0
21,41,-20,0,1,1
51,35,16,1,1,0
7,25,-18,0,1,1
24,15,9,1,1,0
32,23,9,1,1,0
30,17,13,1,1,0
-4,11,-15,0,0,0
17,33,-16,0,0,0
17,24,-7,0,0,0
47,36,11,1,0,1
-52,-38,-14,0,0,0
-47,-43,-4,0,0,0
2,10,-8,0,0,0
-27,-17,-10,0,0,0
-53,-45,-8,0,1,1
-21,-21,0,0,1,1
-7,7,-14,0,1,1
-39,-24,-15,0,1,1
-9,8,-17,0,1,1
38,28,10,1,1,0
-10,-21,11,1,1,0
35,44,-9,0,1,1
-54,-36,-18,0,1,1
-6,4,-10,0,1,1
-13,-25,12,1,1,0
11,28,-17,0,1,1
-15,0,-15,0,1,1
25,39,-14,0,0,0
1,17,-16,0,0,0
23,27,-4,0,0,0
15,19,-4,0,0,0
-5,-9,4,1,0,1
-2,6,-8,0,0,0
-16,-16,0,0,0,0
7,-4,11,1,0,1
-4,12,-16,0,0,0
-28,-17,-11,0,0,0
15,21,-6,0,0,0
16,25,-9,0,0,0
15,34,-19,0,0,0
-37,-25,-12,0,0,0
-34,-21,-13,0,0,0
-31,-44,13,1,0,1
56,41,15,1,0,1
-7,3,-10,0,0,0
6,-13,19,1,1,0
1,-4,5,1,1,0
24,20,4,1,1,0
-34,-38,4,1,1,0
-49,-36,-13,0,1,1
8,-7,15,1,1,0
-18,-11,-7,0,1,1
-21,-3,-18,0,1,1
-8,7,-15,0,1,1
-15,0,-15,0,1,1
15,31,-16,0,1,1
-37,-39,2,1,1,0
22,38,-16,0,1,1
8,13,-5,0,1,1
-43,-32,-11,0,1,1
2,5,-3,0,1,1
-24,-15,-9,0,0,0
-20,-7,-13,0,0,0
24,10,14,1,0,1
26,26,0,0,0,0
-37,-35,-2,0,0,0
26,34,-8,0,0,0
47,37,10,1,0,1
22,40,-18,0,0,0
-26,-28,2,1,0,1
-41,-27,-14,0,0,0
9,23,-14,0,0,0
47,43,4,1,1,0
-24,-31,7,1,1,0
-36,-45,9,1,1,0
-24,-22,-2,0,1,1
-13,-9,-4,0,1,1
-52,-40,-12,0,1,1
-9,-7,-2,0,1,1
36,33,3,1,1,0
31,40,-9,0,1,1
-42,-30,-12,0,1,1
-31,-22,-9,0,1,1
4,7,-3,0,1,1
54,42,12,1,1,0
32,25,7,1,1,0
-24,-37,13,1,1,0
21,3,18,1,1,0
41,42,-1,0,1,1
41,28,13,1,1,0
11,23,-12,0,1,1
-51,-37,-14,0,1,1
11,4,7,1,0,1
6,-10,16,1,0,1
-5,-1,-4,0,0,0
-16,-1,-15,0,0,0
14,1,13,1,0,1
-36,-23,-13,0,0,0
-13,-10,-3,0,0,0
-28,-44,16,1,0,1
3,-2,5,1,0,1
52,41,11,1,0,1
-4,10,-14,0,0,0
-13,-22,9,1,1,0
4,0,4,1,1,0
-53,-38,-15,0,1,1
-14,-29,15,1,1,0
-51,-43,-8,0,1,1
-18,-9,-9,0,1,1
-32,-39,7,1,1,0
26,22,4,1,1,0
-25,-5,-20,0,1,1
8,10,-2,0,0,0
38,44,-6,0,0,0
36,40,-4,0,0,0
19,23,-4,0,0,0
27,18,9,1,0,1
-32,-22,-10,0,0,0
25,19,6,1,0,1
-28,-17,-11,0,0,0
31,13,18,1,1,0
4,22,-18,0,1,1
-10,-15,5,1,1,0
-5,-10,5,1,1,0
-6,7,-13,0,1,1
-58,-42,-16,0,1,1
-7,-20,13,1,1,0
0,-6,6,1,1,0
61,42,19,1,1,0
17,26,-9,0,0,0
17,31,-14,0,0,0
35,30,5,1,0,1
-10,1,-11,0,0,0
7,16,-9,0,0,0
-9,-26,17,1,0,1
-11,2,-13,0,0,0
-19,-29,10,1,0,1
-60,-41,-19,0,0,0
-2,4,-6,0,0,0
4,4,0,0,0,0
31,33,-2,0,0,0
32,15,17,1,0,1
-30,-30,0,0,0,0
-16,3,-19,0,0,0
26,19,7,1,1,0
42,35,7,1,1,0
-4,-12,8,1,1,0
61,41,20,1,1,0
59,44,15,1,1,0
-28,-42,14,1,1,0
10,-8,18,1,1,0
41,39,2,1,1,0
16,22,-6,0,1,1
-52,-41,-11,0,1,1
-4,14,-18,0,1,1
13,0,13,1,1,0
-38,-24,-14,0,1,1
-20,-38,18,1,1,0
-30,-14,-16,0,1,1
-23,-10,-13,0,1,1
-33,-42,9,1,1,0
-33,-31,-2,0,1,1
-15,-29,14,1,1,0
-45,-34,-11,0,1,1
-8,-7,-1,0,1,1
-19,1,-20,0,0,0
28,32,-4,0,0,0
-9,0,-9,0,0,0
-46,-43,-3,0,0,0
-9,-22,13,1,0,1
-22,-3,-19,0,0,0
20,24,-4,0,0,0
-51,-38,-13,0,0,0
-2,-18,16,1,0,1
17,3,14,1,0,1
41,25,16,1,0,1
36,21,15,1,0,1
15,9,6,1,0,1
49,40,9,1,0,1
-51,-40,-11,0,1,1
-44,-42,-2,0,1,1
44,39,5,1,1,0
-6,-7,1,1,1,0
-27,-44,17,1,1,0
-12,-5,-7,0,1,1
20,12,8,1,1,0
33,44,-11,0,1,1
-1,7,-8,0,1,1
31,13,18,1,1,0
12,32,-20,0,1,1
11,6,5,1,0,1
42,42,0,0,0,0
-41,-23,-18,0,0,0
40,27,13,1,0,1
-11,-14,3,1,0,1
-8,-2,-6,0,0,0
-14,-5,-9,0,0,0
-30,-11,-19,0,0,0
-31,-34,3,1,0,1
-47,-31,-16,0,0,0
27,26,1,1,0,1
-8,-23,15,1,0,1
-34,-45,11,1,0,1
18,6,12,1,0,1
1,7,-6,0,0,0
2,-3,5,1,0,1
19,6,13,1,0,1
-44,-29,-15,0,0,0
-18,-2,-16,0,0,0
14,31,-17,0,0,0
-10,-10,0,0,0,0
50,42,8,1,1,0
32,32,0,0,1,1
-10,-1,-9,0,1,1
-29,-32,3,1,1,0
15,16,-1,0,1,1
-24,-30,6,1,1,0
28,24,4,1,1,0
22,33,-11,0,1,1
-6,-14,8,1,1,0
1,4,-3,0,0,0
27,25,2,1,0,1
-2,13,-15,0,0,0
57,37,20,1,0,1
-25,-33,8,1,0,1
-44,-31,-13,0,0,0
39,31,8,1,0,1
9,-5,14,1,0,1
44,30,14,1,0,1
-37,-40,3,1,0,1
-24,-14,-10,0,0,0
-19,-31,12,1,0,1
-11,0,-11,0,0,0
-22,-30,8,1,0,1
-23,-11,-12,0,0,0
-34,-45,11,1,0,1
29,39,-10,0,1,1
-21,-10,-11,0,1,1
-20,-5,-15,0,1,1
7,-1,8,1,1,0
-22,-13,-9,0,1,1
-15,-29,14,1,1,0
-38,-20,-18,0,1,1
2,21,-19,0,1,1
14,-3,17,1,1,0
-34,-45,11,1,1,0
-61,-44,-17,0,1,1
52,33,19,1,1,0
-38,-25,-13,0,1,1
-53,-37,-16,0,1,1
-8,-20,12,1,1,0
-33,-43,10,1,0,1
-30,-36,6,1,0,1
-45,-41,-4,0,0,0
21,25,-4,0,0,0
-6,-12,6,1,0,1
41,31,10,1,0,1
27,35,-8,0,0,0
29,11,18,1,0,1
16,13,3,1,0,1
-34,-42,8,1,0,1
-43,-25,-18,0,0,0
-18,-7,-11,0,0,0
-36,-35,-1,0,0,0
24,43,-19,0,0,0
-22,-36,14,1,0,1
17,33,-16,0,0,0
29,33,-4,0,0,0
35,30,5,1,0,1
-13,-24,11,1,0,1
49,38,11,1,0,1
34,32,2,1,0,1
-65,-45,-20,0,1,1
-57,-45,-12,0,1,1
22,15,7,1,1,0
-11,-8,-3,0,1,1
-45,-41,-4,0,1,1
6,2,4,1,1,0
-19,-13,-6,0,1,1
-11,-16,5,1,1,0
-25,-5,-20,0,1,1
-38,-36,-2,0,1,1
-12,-22,10,1,1,0
22,15,7,1,1,0
-29,-42,13,1,1,0
31,11,20,1,1,0
19,11,8,1,1,0
5,-4,9,1,1,0
-47,-35,-12,0,1,1
0,17,-17,0,0,0
-27,-15,-12,0,0,0
25,22,3,1,0,1
-56,-38,-18,0,0,0
-43,-28,-15,0,0,0
37,43,-6,0,0,0
-1,7,-8,0,0,0
-12,-28,16,1,0,1
-15,-22,7,1,0,1
4,-1,5,1,0,1
38,21,17,1,0,1
42,39,3,1,0,1
-29,-30,1,1,0,1
36,30,6,1,0,1
-38,-35,-3,0,0,0
53,40,13,1,0,1
-31,-39,8,1,0,1
41,37,4,1,0,1
19,23,-4,0,0,0
13,32,-19,0,0,0
13,26,-13,0,0,0
45,27,18,1,1,0
20,6,14,1,1,0
19,10,9,1,1,0
22,35,-13,0,1,1
31,33,-2,0,1,1
21,19,2,1,1,0
-11,-26,15,1,1,0
20,33,-13,0,1,1
-7,-3,-4,0,1,1
-8,-4,-4,0,1,1
12,19,-7,0,0,0
18,24,-6,0,0,0
32,43,-11,0,0,0
35,15,20,1,0,1
-15,-12,-3,0,0,0
-37,-24,-13,0,0,0
30,25,5,1,0,1
-26,-6,-20,0,0,0
-53,-39,-14,0,0,0
-20,-5,-15,0,0,0
10,14,-4,0,0,0
-19,-34,15,1,0,1
-49,-37,-12,0,0,0
-21,-39,18,1,0,1
-27,-18,-9,0,0,0
-61,-44,-17,0,0,0
-59,-45,-14,0,0,0
44,32,12,1,0,1
-16,-3,-13,0,0,0
6,6,0,0,0,0
39,31,8,1,0,1
-19,-1,-18,0,1,1
-34,-19,-15,0,1,1
-18,-34,16,1,1,0
42,26,16,1,1,0
-28,-43,15,1,1,0
-5,-24,19,1,1,0
-28,-44,16,1,1,0
-64,-44,-20,0,1,1
18,15,3,1,1,0
33,31,2,1,1,0
-22,-31,9,1,1,0
46,27,19,1,1,0
37,25,12,1,0,1
45,33,12,1,0,1
32,24,8,1,0,1
5,4,1,1,0,1
63,43,20,1,0,1
23,6,17,1,0,1
-9,2,-11,0,0,0
30,28,2,1,0,1
-45,-40,-5,0,0,0
-34,-44,10,1,0,1
15,18,-3,0,0,0
-56,-41,-15,0,0,0
30,39,-9,0,1,1
51,38,13,1,1,0
-7,-6,-1,0,1,1
-2,15,-17,0,1,1
11,9,2,1,1,0
-16,-20,4,1,1,0
-11,-29,18,1,1,0
-54,-40,-14,0,1,1
-3,11,-14,0,1,1
45,31,14,1,1,0
9,11,-2,0,1,1
-39,-31,-8,0,1,1
-48,-35,-13,0,1,1
3,14,-11,0,1,1
-41,-44,3,1,1,0
-51,-35,-16,0,1,1
38,24,14,1,0,1
25,29,-4,0,0,0
-21,-15,-6,0,0,0
-20,-9,-11,0,0,0
-1,-16,15,1,0,1
19,25,-6,0,0,0
-31,-24,-7,0,0,0
-40,-28,-12,0,0,0
-7,-5,-2,0,0,0
12,4,8,1,0,1
39,44,-5,0,0,0
23,23,0,0,0,0
-22,-40,18,1,0,1
-38,-34,-4,0,0,0
3,-11,14,1,0,1
-10,-3,-7,0,0,0
-46,-33,-13,0,0,0
35,28,7,1,0,1
-6,10,-16,0,1,1
-37,-38,1,1,1,0
-36,-44,8,1,1,0
-13,-17,4,1,1,0
-20,-38,18,1,1,0
-21,-37,16,1,1,0
21,41,-20,0,1,1
-7,-4,-3,0,1,1
-25,-9,-16,0,1,1
0,13,-13,0,1,1
-29,-34,5,1,1,0
-42,-22,-20,0,1,1
-13,-31,18,1,1,0
-43,-25,-18,0,0,0
-19,-6,-13,0,0,0
28,41,-13,0,0,0
-58,-40,-18,0,0,0
53,40,13,1,0,1
37,24,13,1,0,1
-48,-37,-11,0,0,0
-10,-30,20,1,0,1
35,37,-2,0,0,0
-16,-20,4,1,0,1
57,44,13,1,0,1
-8,7,-15,0,0,0
-20,-8,-12,0,0,0
7,-12,19,1,0,1
-20,-40,20,1,0,1
31,25,6,1,0,1
30,21,9,1,0,1
18,7,11,1,0,1
8,7,1,1,0,1
22,4,18,1,1,0
7,7,0,0,1,1
10,8,2,1,1,0
42,25,17,1,1,0
-24,-44,20,1,1,0
-56,-43,-13,0,1,1
-11,-30,19,1,1,0
16,18,-2,0,1,1
-45,-28,-17,0,1,1
8,5,3,1,0,1
-28,-9,-19,0,0,0
-46,-45,-1,0,0,0
-22,-17,-5,0,0,0
21,40,-19,0,0,0
-32,-44,12,1,0,1
-23,-22,-1,0,0,0
48,43,5,1,0,1
-13,-11,-2,0,0,0
19,32,-13,0,0,0
-43,-28,-15,0,0,0
-32,-45,13,1,0,1
-21,-6,-15,0,0,0
26,12,14,1,0,1
1,2,-1,0,0,0
8,-6,14,1,0,1
-11,4,-15,0,0,0
27,8,19,1,1,0
0,18,-18,0,1,1
-39,-26,-13,0,1,1
6,26,-20,0,1,1
-44,-28,-16,0,1,1
-9,-22,13,1,1,0
41,41,0,0,1,1
20,25,-5,0,1,1
37,39,-2,0,1,1
29,30,-1,0,1,1
-25,-28,3,1,1,0
36,29,7,1,1,0
-1,-13,12,1,1,0
25,25,0,0,1,1
20,15,5,1,1,0
6,-12,18,1,1,0
49,42,7,1,1,0
20,1,19,1,1,0
-1,-3,2,1,1,0
-48,-39,-9,0,1,1
-48,-28,-20,0,0,0
-22,-33,11,1,0,1
59,44,15,1,0,1
-3,0,-3,0,0,0
-28,-33,5,1,0,1
50,36,14,1,0,1
44,40,4,1,0,1
7,26,-19,0,0,0
15,22,-7,0,0,0
-8,-11,3,1,0,1
48,40,8,1,1,0
-17,-24,7,1,1,0
-14,2,-16,0,1,1
9,21,-12,0,1,1
-38,-30,-8,0,1,1
-31,-36,5,1,1,0
-37,-31,-6,0,1,1
39,24,15,1,1,0
-10,-30,20,1,0,1
-41,-34,-7,0,0,0
44,29,15,1,0,1
54,43,11,1,0,1
48,33,15,1,0,1
-46,-27,-19,0,0,0
59,41,18,1,0,1
-24,-41,17,1,0,1
50,35,15,1,0,1
28,41,-13,0,0,0
-36,-37,1,1,0,1
-30,-13,-17,0,0,0
-12,1,-13,0,1,1
-9,-29,20,1,1,0
-36,-42,6,1,1,0
48,30,18,1,1,0
-59,-44,-15,0,1,1
35,17,18,1,1,0
-19,-13,-6,0,1,1
-25,-20,-5,0,1,1
37,27,10,1,1,0
-28,-27,-1,0,1,1
29,38,-9,0,1,1
-7,-10,3,1,1,0
-7,-3,-4,0,1,1
22,6,16,1,1,0
-22,-10,-12,0,1,1
5,6,-1,0,1,1
-3,-15,12,1,1,0
-19,-5,-14,0,1,1
-50,-40,-10,0,1,1
-16,1,-17,0,1,1
47,33,14,1,1,0
-29,-20,-9,0,0,0
11,19,-8,0,0,0
-20,-24,4,1,0,1
-12,6,-18,0,0,0
-27,-42,15,1,0,1
-14,-30,16,1,0,1
-7,9,-16,0,0,0
-7,-15,8,1,0,1
-2,4,-6,0,0,0
-20,-19,-1,0,1,1
41,36,5,1,1,0
9,16,-7,0,1,1
-10,-25,15,1,1,0
-37,-44,7,1,1,0
51,37,14,1,1,0
-34,-29,-5,0,1,1
4,-16,20,1,1,0
16,19,-3,0,1,1
-45,-36,-9,0,1,1
49,38,11,1,1,0
38,42,-4,0,1,1
17,35,-18,0,1,1
-16,3,-19,0,1,1
-43,-41,-2,0,1,1
-36,-32,-4,0,1,1
31,22,9,1,1,0
-7,6,-13,0,1,1
1,21,-20,0,1,1
-6,-2,-4,0,1,1
-39,-45,6,1,0,1
-32,-43,11,1,0,1
14,7,7,1,0,1
-9,-26,17,1,0,1
54,41,13,1,0,1
-18,2,-20,0,0,0
10,-3,13,1,0,1
-12,3,-15,0,0,0
21,8,13,1,0,1
2,-14,16,1,0,1
-30,-36,6,1,0,1
21,29,-8,0,0,0
-2,-17,15,1,0,1
23,11,12,1,0,1
-12,-24,12,1,0,1
-6,14,-20,0,0,0
-15,-8,-7,0,0,0
-41,-26,-15,0,0,0
-12,-14,2,1,0,1
12,-8,20,1,0,1
9,24,-15,0,0,0
18,15,3,1,1,0
-21,-36,15,1,1,0
30,34,-4,0,1,1
-16,-17,1,1,1,0
23,33,-10,0,1,1
-41,-29,-12,0,1,1
-19,0,-19,0,1,1
-43,-38,-5,0,1,1
-6,9,-15,0,1,1
11,23,-12,0,1,1
-20,-18,-2,0,1,1
21,5,16,1,1,0
-21,-26,5,1,0,1
21,12,9,1,0,1
6,11,-5,0,0,0
-30,-45,15,1,0,1
-29,-17,-12,0,0,0
1,18,-17,0,0,0
26,41,-15,0,0,0
63,44,19,1,0,1
9,21,-12,0,0,0
-26,-22,-4,0,0,0
4,6,-2,0,0,0
-21,-5,-16,0,0,0
-22,-31,9,1,0,1
20,29,-9,0,0,0
29,18,11,1,0,1
29,25,4,1,0,1
11,29,-18,0,0,0
-46,-39,-7,0,0,0
-14,-19,5,1,0,1
39,29,10,1,0,1
-20,-12,-8,0,0,0
-55,-35,-20,0,1,1
-29,-24,-5,0,1,1
39,33,6,1,1,0
-24,-29,5,1,1,0
4,-13,17,1,1,0
24,24,0,0,1,1
42,30,12,1,1,0
0,-18,18,1,1,0
49,37,12,1,1,0
-5,12,-17,0,1,1
26,18,8,1,1,0
-14,2,-16,0,1,1
-32,-39,7,1,1,0
-20,-10,-10,0,1,1
9,-2,11,1,1,0
33,44,-11,0,1,1
-61,-44,-17,0,1,1
2,7,-5,0,0,0
-45,-37,-8,0,0,0
15,30,-15,0,0,0
15,2,13,1,0,1
9,17,-8,0,0,0
26,39,-13,0,0,0
-2,2,-4,0,0,0
-36,-33,-3,0,0,0
12,7,5,1,1,0
-3,14,-17,0,1,1
36,32,4,1,1,0
39,22,17,1,1,0
-17,-35,18,1,1,0
1,-9,10,1,1,0
-15,-4,-11,0,1,1
43,23,20,1,1,0
25,25,0,0,0,0
11,1,10,1,0,1
32,32,0,0,0,0
-31,-19,-12,0,0,0
12,26,-14,0,0,0
12,2,10,1,0,1
28,8,20,1,0,1
-22,-5,-17,0,0,0
-30,-16,-14,0,0,0
-30,-10,-20,0,0,0
-12,-24,12,1,0,1
-45,-31,-14,0,0,0
41,31,10,1,0,1
-59,-44,-15,0,0,0
-47,-44,-3,0,0,0
-57,-39,-18,0,0,0
-2,16,-18,0,0,0
41,39,2,1,0,1
-24,-24,0,0,0,0
40,24,16,1,0,1
55,41,14,1,0,1
19,2,17,1,1,0
-25,-6,-19,0,1,1
-27,-42,15,1,1,0
19,12,7,1,1,0
-23,-33,10,1,1,0
8,27,-19,0,1,1
36,38,-2,0,1,1
36,29,7,1,1,0
-11,-4,-7,0,1,1
31,31,0,0,1,1
0,-7,7,1,1,0
17,11,6,1,1,0
57,44,13,1,1,0
31,19,12,1,0,1
-12,-8,-4,0,0,0
-5,-24,19,1,0,1
58,41,17,1,0,1
-14,-33,19,1,0,1
11,7,4,1,0,1
-65,-45,-20,0,0,0
-39,-40,1,1,0,1
18,2,16,1,0,1
-26,-13,-13,0,0,0
29,36,-7,0,0,0
-39,-23,-16,0,0,0
-26,-33,7,1,0,1
27,34,-7,0,0,0
13,30,-17,0,0,0
54,38,16,1,0,1
55,39,16,1,0,1
-14,-3,-11,0,0,0
58,42,16,1,0,1
-17,-32,15,1,0,1
-12,-5,-7,0,0,0
-18,-19,1,1,1,0
-5,0,-5,0,1,1
-15,-27,12,1,1,0
26,35,-9,0,1,1
16,1,15,1,1,0
58,41,17,1,1,0
41,30,11,1,1,0
16,3,13,1,1,0
-33,-39,6,1,1,0
49,34,15,1,1,0
14,4,10,1,1,0
-23,-12,-11,0,1,1
9,11,-2,0,1,1
-40,-25,-15,0,1,1
34,42,-8,0,1,1
6,19,-13,0,0,0
-29,-33,4,1,0,1
-32,-14,-18,0,0,0
6,-9,15,1,0,1
9,2,7,1,0,1
-30,-44,14,1,0,1
3,-6,9,1,0,1
-8,-1,-7,0,0,0
8,-8,16,1,0,1
22,37,-15,0,0,0
51,39,12,1,0,1
1,-8,9,1,0,1
11,-1,12,1,0,1
-28,-19,-9,0,0,0
-32,-14,-18,0,0,0
-22,-3,-19,0,0,0
-34,-37,3,1,0,1
12,15,-3,0,0,0
-32,-24,-8,0,0,0
-12,-2,-10,0,0,0
29,16,13,1,0,1
0,8,-8,0,1,1
7,6,1,1,1,0
-24,-42,18,1,1,0
45,42,3,1,1,0
-28,-8,-20,0,1,1
-4,-10,6,1,1,0
-2,-16,14,1,1,0
-32,-38,6,1,1,0
15,34,-19,0,1,1
26,13,13,1,1,0
-33,-27,-6,0,1,1
4,1,3,1,1,0
8,-2,10,1,1,0
-26,-26,0,0,1,1
-9,-12,3,1,1,0
9,3,6,1,1,0
50,37,13,1,1,0
-16,-31,15,1,1,0
48,32,16,1,1,0
17,31,-14,0,1,1
-8,-17,9,1,1,0
29,24,5,1,0,1
54,41,13,1,0,1
-38,-33,-5,0,0,0
-38,-26,-12,0,0,0
-5,9,-14,0,0,0
-43,-44,1,1,0,1
3,-2,5,1,0,1
40,21,19,1,0,1
43,29,14,1,0,1
35,24,11,1,0,1
-25,-6,-19,0,0,0
-38,-32,-6,0,0,0
39,40,-1,0,0,0
-21,-20,-1,0,0,0
-41,-30,-11,0,0,0
18,9,9,1,0,1
-7,0,-7,0,0,0
34,29,5,1,0,1
28,10,18,1,0,1
37,18,19,1,0,1
11,-7,18,1,0,1
15,-3,18,1,1,0
-39,-29,-10,0,1,1
20,34,-14,0,1,1
-15,1,-16,0,1,1
15,-2,17,1,1,0
16,23,-7,0,1,1
9,18,-9,0,1,1
-14,-5,-9,0,1,1
-41,-37,-4,0,1,1
-1,-5,4,1,1,0
42,32,10,1,1,0
23,6,17,1,1,0
15,4,11,1,1,0
9,28,-19,0,1,1
21,33,-12,0,1,1
23,43,-20,0,1,1
-42,-36,-6,0,1,1
-28,-10,-18,0,1,1
-3,7,-10,0,1,1
21,13,8,1,1,0
-43,-44,1,1,1,0
9,13,-4,0,0,0
-25,-15,-10,0,0,0
-4,11,-15,0,0,0
60,42,18,1,0,1
18,13,5,1,0,1
-45,-44,-1,0,0,0
-52,-39,-13,0,0,0
22,16,6,1,0,1
54,43,11,1,0,1
14,23,-9,0,0,0
-26,-9,-17,0,0,0
33,39,-6,0,0,0
12,11,1,1,0,1
-2,-14,12,1,1,0
46,29,17,1,1,0
-27,-27,0,0,1,1
8,20,-12,0,1,1
-24,-7,-17,0,1,1
-47,-33,-14,0,1,1
9,19,-10,0,1,1
31,11,20,1,1,0
-24,-9,-15,0,1,1
-15,-20,5,1,0,1
31,29,2,1,0,1
18,26,-8,0,0,0
2,2,0,0,0,0
-21,-23,2,1,0,1
-15,-14,-1,0,0,0
-3,-15,12,1,0,1
-15,-4,-11,0,0,0
17,34,-17,0,0,0
5,17,-12,0,0,0
-21,-40,19,1,0,1
10,1,9,1,1,0
-34,-20,-14,0,1,1
44,31,13,1,1,0
-4,8,-12,0,1,1
-20,-11,-9,0,1,1
4,14,-10,0,1,1
-5,8,-13,0,1,1
-2,-19,17,1,1,0
5,-13,18,1,1,0
-16,-26,10,1,1,0
2,-4,6,1,1,0
-35,-34,-1,0,1,1
-29,-44,15,1,1,0
-2,12,-14,0,1,1
5,12,-7,0,1,1
-4,-18,14,1,1,0
7,-7,14,1,1,0
16,17,-1,0,1,1
11,-9,20,1,1,0
6,16,-10,0,1,1
27,21,6,1,1,0
22,2,20,1,0,1
-12,-25,13,1,0,1
-45,-31,-14,0,0,0
23,16,7,1,0,1
9,13,-4,0,0,0
1,20,-19,0,0,0
0,19,-19,0,0,0
3,13,-10,0,0,0
-50,-35,-15,0,0,0
23,6,17,1,0,1
-18,-4,-14,0,0,0
13,30,-17,0,0,0
-11,-30,19,1,0,1
6,24,-18,0,0,0
-38,-45,7,1,0,1
-37,-36,-1,0,1,1
-14,-23,9,1,1,0
42,32,10,1,1,0
34,35,-1,0,1,1
14,31,-17,0,1,1
51,33,18,1,1,0
-36,-25,-11,0,1,1
34,30,4,1,1,0
-27,-35,8,1,1,0
-26,-35,9,1,1,0
-11,-8,-3,0,1,1
-37,-22,-15,0,1,1
12,31,-19,0,1,1
13,3,10,1,1,0
-15,-30,15,1,1,0
23,42,-19,0,0,0
-14,-9,-5,0,0,0
9,0,9,1,0,1
12,8,4,1,0,1
-30,-28,-2,0,0,0
-33,-13,-20,0,0,0
-18,-7,-11,0,0,0
-6,14,-20,0,0,0
-9,10,-19,0,0,0
-40,-20,-20,0,0,0
-35,-30,-5,0,0,0
5,8,-3,0,0,0
13,19,-6,0,0,0
-31,-27,-4,0,0,0
-20,-17,-3,0,0,0
30,37,-7,0,0,0
16,4,12,1,1,0
-31,-12,-19,0,1,1
30,37,-7,0,1,1
-49,-35,-14,0,1,1
26,38,-12,0,1,1
17,2,15,1,1,0
10,27,-17,0,1,1
19,34,-15,0,1,1
13,-1,14,1,1,0
-5,-20,15,1,1,0
7,13,-6,0,1,1
-1,-11,10,1,1,0
-8,-1,-7,0,1,1
20,34,-14,0,1,1
10,-7,17,1,1,0
-27,-40,13,1,1,0
-15,3,-18,0,1,1
24,24,0,0,1,1
-1,6,-7,0,1,1
43,30,13,1,1,0
-32,-20,-12,0,0,0
-16,-8,-8,0,0,0
-54,-40,-14,0,0,0
4,19,-15,0,0,0
25,14,11,1,0,1
32,28,4,1,0,1
-21,-18,-3,0,0,0
-7,-17,10,1,0,1
-39,-40,1,1,0,1
52,39,13,1,1,0
3,-16,19,1,1,0
19,4,15,1,1,0
27,24,3,1,1,0
-6,7,-13,0,1,1
54,39,15,1,1,0
31,38,-7,0,1,1
21,30,-9,0,1,1
13,14,-1,0,1,1
15,5,10,1,0,1
-35,-32,-3,0,0,0
11,-1,12,1,0,1
-37,-34,-3,0,0,0
45,25,20,1,0,1
29,35,-6,0,0,0
-34,-33,-1,0,0,0
-30,-35,5,1,0,1
-36,-27,-9,0,0,0
-22,-10,-12,0,1,1
23,25,-2,0,1,1
24,40,-16,0,1,1
-39,-39,0,0,1,1
-5,-14,9,1,1,0
-17,-16,-1,0,1,1
-2,-6,4,1,1,0
39,24,15,1,1,0
51,42,9,1,1,0
31,23,8,1,1,0
35,15,20,1,1,0
-37,-18,-19,0,1,1
-44,-36,-8,0,0,0
3,6,-3,0,0,0
33,36,-3,0,0,0
-18,-3,-15,0,0,0
-5,10,-15,0,0,0
-31,-35,4,1,0,1
5,8,-3,0,0,0
18,19,-1,0,0,0
25,21,4,1,1,0
36,26,10,1,1,0
22,28,-6,0,1,1
-8,-17,9,1,1,0
-3,8,-11,0,1,1
3,-12,15,1,1,0
-43,-23,-20,0,1,1
9,5,4,1,1,0
33,41,-8,0,1,1
19,21,-2,0,1,1
-43,-23,-20,0,1,1
0,-7,7,1,1,0
-18,-1,-17,0,0,0
-53,-34,-19,0,0,0
49,41,8,1,0,1
-24,-17,-7,0,0,0
1,9,-8,0,0,0
-13,-11,-2,0,0,0
-27,-32,5,1,0,1
2,-15,17,1,0,1
20,40,-20,0,0,0
15,35,-20,0,0,0
-27,-22,-5,0,1,1
43,26,17,1,1,0
-29,-29,0,0,1,1
4,8,-4,0,1,1
-7,-6,-1,0,1,1
-22,-9,-13,0,1,1
54,37,17,1,1,0
-34,-38,4,1,1,0
39,37,2,1,1,0
8,13,-5,0,1,1
24,42,-18,0,1,1
-42,-30,-12,0,1,1
-19,-2,-17,0,1,1
22,18,4,1,1,0
-55,-44,-11,0,1,1
-4,-13,9,1,1,0
-44,-45,1,1,1,0
-6,-8,2,1,1,0
12,11,1,1,1,0
17,25,-8,0,1,1
15,7,8,1,1,0
31,15,16,1,0,1
-3,7,-10,0,0,0
-26,-40,14,1,0,1
-11,3,-14,0,0,0
42,22,20,1,0,1
21,23,-2,0,0,0
-27,-9,-18,0,0,0
24,23,1,1,0,1
51,32,19,1,0,1
23,36,-13,0,0,0
-18,-26,8,1,0,1
-16,-25,9,1,0,1
-48,-39,-9,0,0,0
-4,14,-18,0,1,1
10,0,10,1,1,0
24,26,-2,0,1,1
-43,-41,-2,0,1,1
1,-9,10,1,1,0
17,-1,18,1,1,0
4,24,-20,0,1,1
-17,-4,-13,0,1,1
-16,2,-18,0,1,1
31,36,-5,0,1,1
-39,-28,-11,0,0,0
-35,-28,-7,0,0,0
-2,-17,15,1,0,1
37,33,4,1,0,1
1,-6,7,1,0,1
3,-17,20,1,0,1
-1,-21,20,1,0,1
-36,-34,-2,0,0,0
21,11,10,1,0,1
-23,-29,6,1,0,1
23,33,-10,0,0,0
14,24,-10,0,1,1
-58,-43,-15,0,1,1
26,26,0,0,1,1
-42,-22,-20,0,1,1
-42,-40,-2,0,1,1
-12,-18,6,1,1,0
9,16,-7,0,1,1
23,7,16,1,1,0
20,31,-11,0,1,1
0,-12,12,1,1,0
19,35,-16,0,1,1
35,30,5,1,1,0
28,32,-4,0,1,1
-20,-23,3,1,1,0
28,8,20,1,1,0
4,17,-13,0,1,1
-9,-8,-1,0,1,1
-3,7,-10,0,1,1
-37,-22,-15,0,1,1
-32,-28,-4,0,1,1
-5,-22,17,1,1,0
-17,-36,19,1,0,1
20,26,-6,0,0,0
8,1,7,1,0,1
-9,-19,10,1,0,1
-49,-33,-16,0,0,0
9,29,-20,0,0,0
44,29,15,1,0,1
-15,-2,-13,0,0,0
14,3,11,1,0,1
-27,-43,16,1,0,1
-10,-24,14,1,0,1
-47,-27,-20,0,0,0
-30,-14,-16,0,0,0
-13,-3,-10,0,0,0
-32,-34,2,1,0,1
33,31,2,1,0,1
-26,-34,8,1,0,1
14,9,5,1,0,1
25,31,-6,0,0,0
-17,-34,17,1,1,0
-23,-20,-3,0,1,1
2,-8,10,1,1,0
-1,-9,8,1,1,0
16,11,5,1,1,0
20,10,10,1,1,0
21,19,2,1,1,0
19,34,-15,0,1,1
-34,-39,5,1,1,0
-16,0,-16,0,1,1
-15,3,-18,0,1,1
-4,-8,4,1,1,0
-23,-12,-11,0,1,1
10,8,2,1,0,1
-51,-44,-7,0,0,0
-35,-24,-11,0,0,0
-38,-25,-13,0,0,0
-13,-30,17,1,0,1
-37,-17,-20,0,0,0
-33,-17,-16,0,0,0
-37,-21,-16,0,0,0
9,27,-18,0,0,0
-39,-42,3,1,1,0
-5,-5,0,0,1,1
31,28,3,1,1,0
-28,-31,3,1,1,0
-57,-43,-14,0,1,1
-17,-15,-2,0,1,1
29,42,-13,0,1,1
-1,-2,1,1,1,0
-4,5,-9,0,1,1
39,31,8,1,1,0
-44,-29,-15,0,1,1
24,27,-3,0,1,1
-4,5,-9,0,1,1
55,40,15,1,1,0
22,41,-19,0,1,1
43,38,5,1,1,0
25,22,3,1,1,0
-20,-35,15,1,1,0
-14,-9,-5,0,0,0
5,2,3,1,0,1
-25,-30,5,1,0,1
-6,-15,9,1,0,1
-38,-22,-16,0,0,0
-3,-11,8,1,0,1
-3,1,-4,0,0,0
7,9,-2,0,0,0
56,42,14,1,0,1
0,15,-15,0,0,0
26,34,-8,0,0,0
-10,-27,17,1,0,1
1,-15,16,1,0,1
22,30,-8,0,1,1
-47,-38,-9,0,1,1
35,34,1,1,1,0
19,0,19,1,1,0
2,-13,15,1,1,0
-25,-27,2,1,1,0
-52,-40,-12,0,1,1
36,26,10,1,1,0
-18,1,-19,0,1,1
30,18,12,1,1,0
-24,-22,-2,0,1,1
-25,-9,-16,0,1,1
-54,-41,-13,0,1,1
51,43,8,1,1,0
-14,-10,-4,0,1,1
13,24,-11,0,1,1
11,16,-5,0,1,1
18,18,0,0,0,0
38,19,19,1,0,1
-40,-43,3,1,0,1
-28,-14,-14,0,0,0
-46,-32,-14,0,0,0
3,14,-11,0,0,0
-27,-43,16,1,0,1
-8,-4,-4,0,0,0
23,35,-12,0,0,0
-3,-21,18,1,1,0
12,8,4,1,1,0
28,44,-16,0,1,1
-12,-27,15,1,1,0
51,32,19,1,1,0
31,25,6,1,1,0
13,30,-17,0,1,1
-4,-3,-1,0,1,1
35,44,-9,0,1,1
-43,-30,-13,0,1,1
-41,-38,-3,0,1,1
23,38,-15,0,1,1
-14,-23,9,1,1,0
53,42,11,1,0,1
4,-15,19,1,0,1
17,5,12,1,0,1
38,33,5,1,0,1
26,14,12,1,0,1
31,23,8,1,0,1
-19,-25,6,1,0,1
39,22,17,1,0,1
-37,-21,-16,0,0,0
25,22,3,1,0,1
49,29,20,1,0,1
10,18,-8,0,0,0
17,15,2,1,0,1
17,-1,18,1,0,1
22,9,13,1,1,0
10,8,2,1,1,0
1,-8,9,1,1,0
-37,-24,-13,0,1,1
9,8,1,1,1,0
-26,-8,-18,0,1,1
1,-17,18,1,1,0
-49,-40,-9,0,1,1
36,39,-3,0,1,1
-26,-25,-1,0,1,1
-34,-18,-16,0,1,1
-11,-31,20,1,1,0
39,37,2,1,1,0
35,20,15,1,1,0
8,-5,13,1,1,0
-61,-41,-20,0,1,1
3,19,-16,0,1,1
-44,-25,-19,0,1,1
1,-5,6,1,1,0
27,24,3,1,1,0
12,22,-10,0,1,1
-34,-27,-7,0,0,0
15,6,9,1,0,1
38,18,20,1,0,1
-15,-34,19,1,0,1
7,18,-11,0,0,0
7,-13,20,1,0,1
-41,-28,-13,0,0,0
-51,-32,-19,0,0,0
-39,-30,-9,0,0,0
21,32,-11,0,1,1
54,34,20,1,1,0
-11,-4,-7,0,1,1
-35,-45,10,1,1,0
26,36,-10,0,1,1
-62,-42,-20,0,1,1
-9,-27,18,1,1,0
-47,-32,-15,0,1,1
-27,-21,-6,0,1,1
-4,16,-20,0,1,1
-35,-39,4,1,0,1
49,33,16,1,0,1
-6,-10,4,1,0,1
49,29,20,1,0,1
-24,-20,-4,0,0,0
46,38,8,1,0,1
-13,-20,7,1,0,1
18,26,-8,0,0,0
18,0,18,1,0,1
-25,-13,-12,0,0,0
-52,-38,-14,0,0,0
37,26,11,1,0,1
-12,-23,11,1,0,1
64,44,20,1,0,1
3,9,-6,0,0,0
-15,-18,3,1,0,1
-33,-29,-4,0,0,0
-20,-36,16,1,0,1
-1,-2,1,1,0,1
-45,-42,-3,0,0,0
19,31,-12,0,0,0
29,15,14,1,1,0
-39,-41,2,1,1,0
15,8,7,1,1,0
-35,-44,9,1,1,0
50,30,20,1,1,0
40,21,19,1,1,0
-24,-30,6,1,1,0
8,3,5,1,1,0
28,17,11,1,0,1
-47,-27,-20,0,0,0
21,5,16,1,0,1
-35,-41,6,1,0,1
0,13,-13,0,0,0
52,41,11,1,0,1
-10,-8,-2,0,0,0
-18,-23,5,1,0,1
-26,-14,-12,0,0,0
-31,-12,-19,0,0,0
-14,-14,0,0,0,0
6,-9,15,1,0,1
-28,-38,10,1,0,1
0,17,-17,0,1,1
-25,-17,-8,0,1,1
51,36,15,1,1,0
-58,-42,-16,0,1,1
33,30,3,1,1,0
18,11,7,1,1,0
3,9,-6,0,1,1
-2,14,-16,0,1,1
38,19,19,1,1,0
51,38,13,1,1,0
-3,-14,11,1,0,1
5,-5,10,1,0,1
-28,-25,-3,0,0,0
35,22,13,1,0,1
-37,-27,-10,0,0,0
-5,9,-14,0,0,0
14,9,5,1,0,1
18,28,-10,0,0,0
-21,-36,15,1,0,1
-8,5,-13,0,0,0
-46,-33,-13,0,0,0
24,7,17,1,0,1
-28,-44,16,1,0,1
3,1,2,1,0,1
-2,-18,16,1,0,1
-16,-27,11,1,0,1
47,44,3,1,0,1
-3,5,-8,0,1,1
33,41,-8,0,1,1
11,1,10,1,1,0
7,16,-9,0,1,1
-31,-42,11,1,1,0
-57,-42,-15,0,1,1
-54,-36,-18,0,1,1
-4,-2,-2,0,1,1
-19,-6,-13,0,0,0
51,36,15,1,0,1
27,37,-10,0,0,0
37,30,7,1,0,1
9,17,-8,0,0,0
9,-5,14,1,0,1
18,12,6,1,0,1
33,31,2,1,0,1
10,-10,20,1,0,1
25,24,1,1,0,1
2,3,-1,0,1,1
-18,-30,12,1,1,0
-38,-30,-8,0,1,1
-8,0,-8,0,1,1
-22,-40,18,1,1,0
-29,-21,-8,0,1,1
-49,-42,-7,0,1,1
-7,3,-10,0,1,1
-28,-11,-17,0,1,1
-21,-35,14,1,0,1
26,26,0,0,0,0
-29,-25,-4,0,0,0
-13,-20,7,1,0,1
-42,-34,-8,0,0,0
-30,-40,10,1,0,1
6,8,-2,0,0,0
-10,-28,18,1,0,1
-10,-12,2,1,0,1
15,2,13,1,0,1
-25,-32,7,1,0,1
-4,7,-11,0,0,0
4,-13,17,1,0,1
-43,-39,-4,0,0,0
19,37,-18,0,0,0
62,42,20,1,0,1
4,-13,17,1,0,1
29,19,10,1,0,1
56,43,13,1,0,1
-23,-12,-11,0,0,0
-27,-41,14,1,0,1
-31,-12,-19,0,1,1
19,26,-7,0,1,1
-32,-23,-9,0,1,1
44,41,3,1,1,0
-17,-2,-15,0,1,1
10,28,-18,0,1,1
-9,10,-19,0,1,1
-32,-39,7,1,1,0
50,44,6,1,1,0
-24,-33,9,1,1,0
-50,-42,-8,0,1,1
-12,3,-15,0,1,1
44,38,6,1,1,0
6,6,0,0,1,1
19,2,17,1,1,0
-46,-34,-12,0,0,0
-17,-32,15,1,0,1
34,37,-3,0,0,0
55,37,18,1,0,1
22,22,0,0,0,0
44,38,6,1,0,1
-39,-27,-12,0,0,0
-15,5,-20,0,0,0
33,41,-8,0,0,0
4,17,-13,0,0,0
-25,-38,13,1,0,1
-22,-15,-7,0,0,0
35,43,-8,0,0,0
-33,-26,-7,0,0,0
-42,-34,-8,0,0,0
19,13,6,1,0,1
-26,-10,-16,0,0,0
20,23,-3,0,0,0
-37,-20,-17,0,1,1
-36,-25,-11,0,1,1
-38,-41,3,1,1,0
-8,6,-14,0,1,1
-21,-18,-3,0,1,1
61,41,20,1,1,0
-25,-12,-13,0,1,1
11,-5,16,1,1,0
-58,-45,-13,0,1,1
27,35,-8,0,1,1
-10,-1,-9,0,1,1
48,39,9,1,1,0
-39,-23,-16,0,1,1
13,-5,18,1,1,0
-19,-14,-5,0,1,1
-34,-32,-2,0,1,1
-29,-40,11,1,1,0
0,-9,9,1,1,0
-27,-29,2,1,1,0
-12,-18,6,1,1,0
-9,-4,-5,0,1,1
-26,-12,-14,0,0,0
-5,-2,-3,0,0,0
26,7,19,1,0,1
-1,-10,9,1,0,1
-39,-21,-18,0,0,0
-15,-5,-10,0,0,0
13,16,-3,0,0,0
-23,-12,-11,0,0,0
-5,15,-20,0,1,1
1,14,-13,0,1,1
-31,-17,-14,0,1,1
-32,-21,-11,0,1,1
40,34,6,1,1,0
27,18,9,1,1,0
-37,-18,-19,0,1,1
-49,-42,-7,0,1,1
18,31,-13,0,1,1
-9,-29,20,1,1,0
21,35,-14,0,1,1
20,19,1,1,1,0
-24,-29,5,1,1,0
-27,-44,17,1,1,0
35,28,7,1,1,0
-31,-42,11,1,1,0
-27,-17,-10,0,1,1
-6,8,-14,0,1,1
-52,-45,-7,0,1,1
-40,-35,-5,0,0,0
6,20,-14,0,0,0
16,2,14,1,0,1
43,36,7,1,0,1
9,14,-5,0,0,0
16,1,15,1,0,1
12,6,6,1,0,1
43,43,0,0,0,0
14,34,-20,0,0,0
16,8,8,1,0,1
11,1,10,1,0,1
-38,-39,1,1,0,1
38,44,-6,0,0,0
-32,-42,10,1,0,1
-22,-42,20,1,0,1
-9,4,-13,0,0,0
-37,-23,-14,0,0,0
-32,-30,-2,0,0,0
-4,13,-17,0,0,0
42,37,5,1,0,1
-31,-31,0,0,0,0
-1,-3,2,1,1,0
19,1,18,1,1,0
-47,-37,-10,0,1,1
5,-7,12,1,1,0
-30,-26,-4,0,1,1
5,1,4,1,1,0
-48,-45,-3,0,1,1
-11,-17,6,1,1,0
-38,-38,0,0,1,1
28,23,5,1,1,0
38,20,18,1,1,0
-26,-9,-17,0,1,1
-22,-12,-10,0,1,1
-5,-7,2,1,1,0
6,22,-16,0,1,1
-22,-39,17,1,1,0
-13,-13,0,0,1,1
-59,-41,-18,0,1,1
-9,7,-16,0,1,1
13,4,9,1,1,0
-50,-39,-11,0,0,0
44,35,9,1,0,1
-28,-38,10,1,0,1
17,23,-6,0,0,0
3,-1,4,1,0,1
9,-7,16,1,0,1
-26,-15,-11,0,0,0
-44,-27,-17,0,0,0
-37,-42,5,1,0,1
16,10,6,1,0,1
6,-4,10,1,0,1
15,11,4,1,0,1
5,2,3,1,0,1
50,40,10,1,0,1
13,-2,15,1,1,0
24,26,-2,0,1,1
-11,0,-11,0,1,1
26,44,-18,0,1,1
4,3,1,1,1,0
12,4,8,1,1,0
58,39,19,1,1,0
2,-4,6,1,1,0
18,7,11,1,0,1
-31,-14,-17,0,0,0
19,9,10,1,0,1
45,32,13,1,0,1
3,1,2,1,0,1
27,29,-2,0,0,0
-30,-11,-19,0,0,0
-31,-33,2,1,0,1
-2,-20,18,1,1,0
20,28,-8,0,1,1
-46,-34,-12,0,1,1
9,4,5,1,1,0
-36,-44,8,1,1,0
8,-6,14,1,1,0
-37,-41,4,1,1,0
12,18,-6,0,1,1
-11,5,-16,0,1,1
15,0,15,1,1,0
22,6,16,1,1,0
1,-7,8,1,1,0
-36,-42,6,1,1,0
-11,8,-19,0,1,1
29,36,-7,0,1,1
-14,-31,17,1,1,0
35,19,16,1,1,0
-7,4,-11,0,1,1
30,32,-2,0,1,1
-25,-44,19,1,1,0
55,38,17,1,1,0
15,26,-11,0,0,0
42,25,17,1,0,1
15,-2,17,1,0,1
39,28,11,1,0,1
-27,-43,16,1,0,1
35,15,20,1,0,1
-37,-40,3,1,0,1
-7,-4,-3,0,0,0
4,-1,5,1,0,1
27,15,12,1,0,1
-64,-44,-20,0,0,0
-1,13,-14,0,0,0
7,24,-17,0,0,0
20,5,15,1,0,1
34,36,-2,0,0,0
-17,-32,15,1,0,1
-21,-22,1,1,1,0
32,21,11,1,1,0
33,15,18,1,1,0
-8,-1,-7,0,1,1
-4,7,-11,0,1,1
0,15,-15,0,1,1
10,27,-17,0,1,1
-16,1,-17,0,1,1
-18,-25,7,1,1,0
14,11,3,1,0,1
-10,8,-18,0,0,0
-47,-33,-14,0,0,0
-42,-35,-7,0,0,0
-18,-38,20,1,0,1
20,2,18,1,0,1
23,3,20,1,0,1
28,10,18,1,0,1
-32,-31,-1,0,0,0
-1,-16,15,1,0,1
19,9,10,1,0,1
10,13,-3,0,0,0
-55,-45,-10,0,0,0
35,27,8,1,0,1
-6,-23,17,1,0,1
32,26,6,1,1,0
12,5,7,1,1,0
54,34,20,1,1,0
17,6,11,1,1,0
-1,-9,8,1,1,0
-23,-41,18,1,1,0
-42,-32,-10,0,1,1
-18,-10,-8,0,1,1
-15,-32,17,1,1,0
6,-13,19,1,1,0
7,14,-7,0,1,1
-8,2,-10,0,1,1
-24,-38,14,1,1,0
48,29,19,1,1,0
-26,-39,13,1,1,0
24,38,-14,0,1,1
9,21,-12,0,1,1
11,0,11,1,1,0
-38,-29,-9,0,1,1
-14,-10,-4,0,1,1
47,34,13,1,1,0
9,14,-5,0,0,0
30,16,14,1,0,1
33,21,12,1,0,1
28,34,-6,0,0,0
-13,2,-15,0,0,0
26,20,6,1,0,1
-3,14,-17,0,0,0
-5,1,-6,0,0,0
32,38,-6,0,0,0
-36,-45,9,1,0,1
43,31,12,1,0,1
-1,-18,17,1,0,1
-13,-21,8,1,0,1
28,28,0,0,0,0
27,15,12,1,0,1
34,37,-3,0,0,0
-27,-24,-3,0,0,0
-27,-10,-17,0,0,0
11,30,-19,0,1,1
32,37,-5,0,1,1
-13,-31,18,1,1,0
25,39,-14,0,1,1
11,30,-19,0,1,1
14,11,3,1,1,0
-1,6,-7,0,1,1
-33,-30,-3,0,1,1
33,13,20,1,1,0
51,43,8,1,1,0
42,37,5,1,1,0
6,13,-7,0,1,1
39,23,16,1,1,0
38,30,8,1,1,0
-21,-6,-15,0,1,1
-13,-17,4,1,1,0
6,-2,8,1,1,0
13,24,-11,0,1,1
2,0,2,1,1,0
18,29,-11,0,1,1
5,-3,8,1,0,1
-30,-22,-8,0,0,0
29,23,6,1,0,1
2,-18,20,1,0,1
19,33,-14,0,0,0
-26,-14,-12,0,0,0
6,-1,7,1,0,1
-20,-3,-17,0,0,0
2,17,-15,0,0,0
14,7,7,1,0,1
10,11,-1,0,0,0
-31,-26,-5,0,0,0
-12,6,-18,0,0,0
13,2,11,1,0,1
32,42,-10,0,0,0
-26,-33,7,1,0,1
44,37,7,1,0,1
11,20,-9,0,0,0
-18,-27,9,1,0,1
13,-1,14,1,0,1
-11,-8,-3,0,0,0
10,30,-20,0,1,1
-34,-41,7,1,1,0
17,11,6,1,1,0
41,35,6,1,1,0
-11,2,-13,0,1,1
23,43,-20,0,1,1
20,30,-10,0,1,1
-5,-2,-3,0,1,1
2,-13,15,1,1,0
-47,-41,-6,0,1,1
-5,-8,3,1,1,0
25,11,14,1,1,0
13,18,-5,0,1,1
17,17,0,0,0,0
14,-1,15,1,0,1
-13,5,-18,0,0,0
9,-6,15,1,0,1
-51,-33,-18,0,0,0
-19,-2,-17,0,0,0
2,-2,4,1,0,1
35,41,-6,0,0,0
-22,-4,-18,0,0,0
36,28,8,1,0,1
-5,7,-12,0,0,0
-35,-27,-8,0,0,0
-28,-41,13,1,0,1
-42,-43,1,1,0,1
33,26,7,1,0,1
47,29,18,1,0,1
10,2,8,1,0,1
-11,-7,-4,0,1,1
20,17,3,1,1,0
22,40,-18,0,1,1
46,32,14,1,1,0
58,38,20,1,1,0
-57,-41,-16,0,1,1
-28,-38,10,1,1,0
12,32,-20,0,1,1
-36,-25,-11,0,1,1
4,20,-16,0,1,1
17,4,13,1,1,0
-41,-22,-19,0,1,1
-1,-4,3,1,1,0
20,26,-6,0,1,1
-28,-23,-5,0,1,1
34,17,17,1,1,0
-35,-21,-14,0,1,1
-13,4,-17,0,1,1
53,37,16,1,1,0
-1,-1,0,0,0,0
7,1,6,1,0,1
23,32,-9,0,0,0
-2,12,-14,0,0,0
30,27,3,1,0,1
-3,-11,8,1,0,1
49,42,7,1,0,1
42,23,19,1,0,1
-3,-23,20,1,0,1
1,2,-1,0,0,0
17,-3,20,1,0,1
-42,-41,-1,0,0,0
-33,-32,-1,0,1,1
-58,-41,-17,0,1,1
8,-9,17,1,1,0
-18,-8,-10,0,1,1
46,43,3,1,1,0
6,23,-17,0,1,1
49,35,14,1,1,0
-7,11,-18,0,1,1
21,27,-6,0,1,1
47,42,5,1,1,0
30,10,20,1,1,0
16,26,-10,0,1,1
-26,-34,8,1,1,0
53,42,11,1,1,0
-5,6,-11,0,1,1
-21,-27,6,1,1,0
-13,-12,-1,0,1,1
41,32,9,1,1,0
-2,-5,3,1,1,0
-30,-42,12,1,1,0
-49,-33,-16,0,1,1
26,30,-4,0,0,0
60,42,18,1,0,1
-2,8,-10,0,0,0
27,36,-9,0,0,0
-43,-27,-16,0,0,0
-7,9,-16,0,0,0
25,32,-7,0,0,0
25,29,-4,0,0,0
-29,-41,12,1,0,1
-33,-26,-7,0,0,0
-48,-39,-9,0,1,1
31,17,14,1,1,0
29,31,-2,0,1,1
-8,-16,8,1,1,0
-61,-45,-16,0,1,1
18,-2,20,1,1,0
17,28,-11,0,1,1
4,23,-19,0,1,1
16,25,-9,0,1,1
51,36,15,1,1,0
-60,-44,-16,0,1,1
22,36,-14,0,1,1
42,22,20,1,1,0
-24,-25,1,1,1,0
-27,-20,-7,0,1,1
16,18,-2,0,1,1
-13,4,-17,0,1,1
4,8,-4,0,1,1
1,-2,3,1,1,0
-5,-22,17,1,1,0
-25,-41,16,1,1,0
33,21,12,1,0,1
-32,-31,-1,0,0,0
14,17,-3,0,0,0
6,-4,10,1,0,1
-30,-40,10,1,0,1
-9,0,-9,0,0,0
46,26,20,1,0,1
-34,-45,11,1,0,1
34,34,0,0,0,0
3,11,-8,0,0,0
-19,-33,14,1,0,1
3,8,-5,0,1,1
-41,-21,-20,0,1,1
-4,12,-16,0,1,1
-49,-42,-7,0,1,1
36,20,16,1,1,0
-45,-32,-13,0,1,1
-6,11,-17,0,1,1
-43,-25,-18,0,1,1
42,35,7,1,1,0
-30,-44,14,1,0,1
-52,-39,-13,0,0,0
-25,-8,-17,0,0,0
6,-8,14,1,0,1
14,24,-10,0,0,0
-25,-26,1,1,0,1
24,20,4,1,0,1
37,27,10,1,0,1
41,25,16,1,0,1
56,42,14,1,0,1
10,12,-2,0,0,0
48,44,4,1,0,1
27,15,12,1,0,1
2,4,-2,0,0,0
16,5,11,1,0,1
52,41,11,1,0,1
-51,-33,-18,0,0,0
7,23,-16,0,1,1
-35,-40,5,1,1,0
10,18,-8,0,1,1
43,32,11,1,1,0
4,21,-17,0,1,1
-21,-24,3,1,1,0
38,27,11,1,1,0
-7,6,-13,0,1,1
-19,-33,14,1,1,0
-18,-2,-16,0,0,0
-30,-31,1,1,0,1
-56,-39,-17,0,0,0
-17,-2,-15,0,0,0
15,26,-11,0,0,0
47,34,13,1,0,1
-33,-20,-13,0,0,0
-52,-45,-7,0,0,0
8,7,1,1,0,1
24,10,14,1,0,1
8,22,-14,0,0,0
49,43,6,1,0,1
44,28,16,1,0,1
32,27,5,1,1,0
18,37,-19,0,1,1
43,40,3,1,1,0
-5,-15,10,1,1,0
27,9,18,1,1,0
-16,-22,6,1,1,0
21,39,-18,0,1,1
-39,-21,-18,0,1,1
-6,3,-9,0,1,1
33,36,-3,0,1,1
-18,-14,-4,0,0,0
-9,-20,11,1,0,1
-35,-33,-2,0,0,0
-33,-44,11,1,0,1
-3,-21,18,1,0,1
32,12,20,1,0,1
30,17,13,1,0,1
21,20,1,1,0,1
17,28,-11,0,0,0
31,22,9,1,0,1
48,40,8,1,0,1
27,39,-12,0,0,0
10,9,1,1,0,1
1,18,-17,0,0,0
38,41,-3,0,0,0
-2,16,-18,0,0,0
4,0,4,1,0,1
25,34,-9,0,0,0
-41,-39,-2,0,0,0
11,24,-13,0,0,0
10,-2,12,1,0,1
53,43,10,1,1,0
9,-4,13,1,1,0
12,0,12,1,1,0
-56,-42,-14,0,1,1
26,24,2,1,1,0
47,43,4,1,1,0
-60,-42,-18,0,1,1
26,17,9,1,1,0
39,20,19,1,1,0
-16,-33,17,1,1,0
44,43,1,1,1,0
24,44,-20,0,1,1
17,10,7,1,1,0
34,20,14,1,1,0
17,18,-1,0,1,1
-50,-45,-5,0,1,1
-37,-23,-14,0,1,1
-9,-23,14,1,1,0
29,12,17,1,1,0
-21,-27,6,1,0,1
-23,-14,-9,0,0,0
-35,-17,-18,0,0,0
23,19,4,1,0,1
-46,-27,-19,0,0,0
1,0,1,1,0,1
23,12,11,1,0,1
-16,-11,-5,0,0,0
35,19,16,1,0,1
17,23,-6,0,0,0
46,30,16,1,0,1
-40,-42,2,1,0,1
33,29,4,1,0,1
52,32,20,1,0,1
-6,-13,7,1,0,1
-50,-37,-13,0,0,0
-25,-20,-5,0,0,0
20,35,-15,0,0,0
-36,-24,-12,0,0,0
-11,-26,15,1,0,1
20,28,-8,0,0,0
-26,-27,1,1,1,0
29,33,-4,0,1,1
35,41,-6,0,1,1
-16,-35,19,1,1,0
-32,-25,-7,0,1,1
-3,10,-13,0,1,1
-30,-43,13,1,1,0
41,33,8,1,1,0
-11,-6,-5,0,1,1
-57,-43,-14,0,1,1
-20,-25,5,1,1,0
-12,-14,2,1,1,0
-25,-21,-4,0,1,1
25,25,0,0,0,0
50,43,7,1,0,1
26,9,17,1,0,1
-38,-20,-18,0,0,0
15,18,-3,0,0,0
16,19,-3,0,0,0
43,39,4,1,0,1
27,34,-7,0,0,0
-27,-13,-14,0,0,0
-10,5,-15,0,0,0
-40,-24,-16,0,0,0
13,-2,15,1,0,1
-3,-13,10,1,0,1
44,28,16,1,0,1
-57,-38,-19,0,0,0
-4,-12,8,1,1,0
-44,-26,-18,0,1,1
-23,-28,5,1,1,0
-26,-14,-12,0,1,1
0,-17,17,1,1,0
31,35,-4,0,1,1
34,24,10,1,1,0
-46,-40,-6,0,1,1
24,10,14,1,1,0
-2,-10,8,1,0,1
12,0,12,1,0,1
-29,-21,-8,0,0,0
-17,-10,-7,0,0,0
21,8,13,1,0,1
59,43,16,1,0,1
-7,5,-12,0,0,0
32,36,-4,0,0,0
-15,-20,5,1,0,1
23,14,9,1,0,1
-38,-45,7,1,0,1
-15,-22,7,1,0,1
8,12,-4,0,0,0
-41,-23,-18,0,0,0
-8,-5,-3,0,0,0
-45,-28,-17,0,0,0
28,21,7,1,0,1
-21,-24,3,1,0,1
-16,-15,-1,0,0,0
40,30,10,1,0,1
-36,-31,-5,0,0,0
-6,11,-17,0,1,1
-26,-44,18,1,1,0
23,41,-18,0,1,1
50,33,17,1,1,0
25,40,-15,0,1,1
0,1,-1,0,1,1
-33,-42,9,1,1,0
-57,-38,-19,0,1,1
22,38,-16,0,1,1
-1,-5,4,1,1,0
10,-10,20,1,1,0
-2,-15,13,1,0,1
-20,-28,8,1,0,1
-15,-31,16,1,0,1
36,36,0,0,0,0
-16,1,-17,0,0,0
23,25,-2,0,0,0
38,27,11,1,0,1
-16,-27,11,1,0,1
8,21,-13,0,1,1
33,38,-5,0,1,1
-11,3,-14,0,1,1
-19,-38,19,1,1,0
24,41,-17,0,1,1
-15,-21,6,1,1,0
-23,-9,-14,0,1,1
-11,0,-11,0,1,1
36,31,5,1,1,0
-53,-42,-11,0,1,1
2,6,-4,0,1,1
4,22,-18,0,1,1
-14,-17,3,1,1,0
-8,-25,17,1,0,1
18,2,16,1,0,1
17,20,-3,0,0,0
-49,-37,-12,0,0,0
-39,-37,-2,0,0,0
-2,-14,12,1,0,1
-7,12,-19,0,0,0
-46,-39,-7,0,0,0
-56,-37,-19,0,0,0
-12,-23,11,1,0,1
23,33,-10,0,0,0
1,3,-2,0,0,0
-37,-19,-18,0,0,0
18,11,7,1,1,0
-55,-39,-16,0,1,1
45,40,5,1,1,0
-33,-35,2,1,1,0
32,33,-1,0,1,1
33,35,-2,0,1,1
-34,-36,2,1,1,0
2,17,-15,0,1,1
-26,-19,-7,0,1,1
17,23,-6,0,1,1
30,23,7,1,1,0
1,-3,4,1,0,1
-5,8,-13,0,0,0
24,30,-6,0,0,0
-13,-6,-7,0,0,0
43,40,3,1,0,1
-46,-33,-13,0,0,0
-50,-37,-13,0,0,0
-27,-24,-3,0,0,0
51,35,16,1,0,1
27,10,17,1,0,1
-9,-1,-8,0,1,1
34,32,2,1,1,0
-25,-12,-13,0,1,1
16,22,-6,0,1,1
41,34,7,1,1,0
-13,-1,-12,0,1,1
-15,1,-16,0,1,1
39,41,-2,0,1,1
-44,-44,0,0,1,1
-21,-6,-15,0,1,1
-12,-27,15,1,0,1
15,16,-1,0,0,0
-20,-30,10,1,0,1
-29,-9,-20,0,0,0
17,36,-19,0,0,0
29,23,6,1,0,1
0,17,-17,0,0,0
32,40,-8,0,0,0
19,3,16,1,0,1
14,23,-9,0,0,0
-43,-33,-10,0,0,0
21,37,-16,0,0,0
-9,-17,8,1,1,0
6,-11,17,1,1,0
28,36,-8,0,1,1
-13,-15,2,1,1,0
26,28,-2,0,1,1
27,41,-14,0,1,1
-27,-18,-9,0,1,1
37,28,9,1,1,0
-26,-16,-10,0,1,1
-24,-35,11,1,1,0
-30,-32,2,1,1,0
26,16,10,1,1,0
-29,-36,7,1,1,0
6,15,-9,0,1,1
41,41,0,0,1,1
-31,-37,6,1,1,0
-43,-34,-9,0,1,1
18,15,3,1,1,0
9,-10,19,1,1,0
22,25,-3,0,1,1
-24,-33,9,1,1,0
-38,-18,-20,0,0,0
48,35,13,1,0,1
7,24,-17,0,0,0
54,34,20,1,0,1
30,30,0,0,0,0
-22,-38,16,1,0,1
13,31,-18,0,0,0
-19,-29,10,1,0,1
-25,-33,8,1,0,1
27,21,6,1,0,1
24,19,5,1,0,1
-6,-6,0,0,0,0
-11,7,-18,0,0,0
0,7,-7,0,0,0
35,43,-8,0,1,1
38,34,4,1,1,0
-31,-45,14,1,1,0
-38,-26,-12,0,1,1
-12,-11,-1,0,1,1
10,23,-13,0,1,1
-18,-25,7,1,1,0
-21,-12,-9,0,1,1
-31,-23,-8,0,1,1
40,34,6,1,1,0
19,39,-20,0,1,1
24,41,-17,0,1,1
16,29,-13,0,1,1
7,16,-9,0,1,1
-11,-5,-6,0,0,0
32,31,1,1,0,1
-18,-38,20,1,0,1
-28,-12,-16,0,0,0
1,-10,11,1,0,1
10,2,8,1,0,1
-4,-23,19,1,0,1
17,15,2,1,0,1
15,2,13,1,0,1
-50,-43,-7,0,0,0
-21,-20,-1,0,0,0
9,16,-7,0,0,0
6,17,-11,0,0,0
6,19,-13,0,0,0
-28,-19,-9,0,0,0
28,28,0,0,0,0
-51,-44,-7,0,0,0
40,36,4,1,1,0
-37,-30,-7,0,1,1
23,17,6,1,1,0
19,32,-13,0,1,1
-26,-14,-12,0,1,1
42,23,19,1,1,0
17,19,-2,0,1,1
-29,-40,11,1,1,0
-57,-37,-20,0,0,0
-15,-24,9,1,0,1
28,31,-3,0,0,0
3,19,-16,0,0,0
9,9,0,0,0,0
-33,-43,10,1,0,1
25,7,18,1,0,1
-2,6,-8,0,0,0
5,20,-15,0,0,0
-14,1,-15,0,0,0
-41,-30,-11,0,0,0
-43,-44,1,1,0,1
-12,-5,-7,0,0,0
27,40,-13,0,0,0
22,22,0,0,1,1
11,21,-10,0,1,1
22,11,11,1,1,0
-12,-27,15,1,1,0
-15,-7,-8,0,1,1
4,8,-4,0,1,1
-15,-11,-4,0,1,1
28,8,20,1,1,0
-13,0,-13,0,1,1
48,39,9,1,1,0
16,22,-6,0,1,1
10,12,-2,0,0,0
-18,-2,-16,0,0,0
-18,-29,11,1,0,1
15,9,6,1,0,1
0,-9,9,1,0,1
7,19,-12,0,0,0
-37,-20,-17,0,0,0
16,-2,18,1,0,1
-35,-33,-2,0,1,1
-10,2,-12,0,1,1
30,43,-13,0,1,1
5,-7,12,1,1,0
34,14,20,1,1,0
-27,-31,4,1,1,0
-23,-20,-3,0,1,1
-18,1,-19,0,1,1
19,38,-19,0,1,1
31,38,-7,0,1,1
-41,-42,1,1,1,0
17,6,11,1,1,0
23,10,13,1,1,0
1,17,-16,0,1,1
2,2,0,0,1,1
14,33,-19,0,1,1
-41,-32,-9,0,1,1
-38,-26,-12,0,1,1
29,40,-11,0,1,1
-24,-36,12,1,1,0
20,17,3,1,1,0
-33,-13,-20,0,0,0
-41,-36,-5,0,0,0
56,36,20,1,0,1
44,27,17,1,0,1
-33,-36,3,1,0,1
29,37,-8,0,0,0
-16,-3,-13,0,0,0
-17,-11,-6,0,0,0
-22,-4,-18,0,0,0
-24,-6,-18,0,1,1
1,-9,10,1,1,0
11,14,-3,0,1,1
-38,-40,2,1,1,0
46,31,15,1,1,0
22,22,0,0,1,1
-3,1,-4,0,1,1
16,28,-12,0,1,1
-9,-15,6,1,1,0
34,15,19,1,1,0
34,44,-10,0,1,1
45,29,16,1,1,0
26,6,20,1,1,0
38,24,14,1,1,0
12,4,8,1,1,0
-44,-32,-12,0,1,1
-1,5,-6,0,1,1
7,26,-19,0,1,1
42,40,2,1,1,0
-23,-16,-7,0,1,1
44,34,10,1,1,0
-37,-19,-18,0,0,0
45,40,5,1,0,1
-54,-43,-11,0,0,0
-45,-43,-2,0,0,0
-48,-31,-17,0,0,0
51,44,7,1,0,1
-31,-25,-6,0,0,0
-4,-19,15,1,0,1
-35,-27,-8,0,0,0
0,15,-15,0,0,0
-18,-26,8,1,1,0
-15,-34,19,1,1,0
6,13,-7,0,1,1
17,32,-15,0,1,1
-2,-18,16,1,1,0
6,-11,17,1,1,0
-64,-44,-20,0,1,1
-5,-3,-2,0,1,1
4,6,-2,0,0,0
4,-6,10,1,0,1
-38,-18,-20,0,0,0
10,24,-14,0,0,0
27,19,8,1,0,1
7,3,4,1,0,1
32,20,12,1,0,1
30,11,19,1,0,1
-16,-26,10,1,0,1
-12,-3,-9,0,1,1
25,18,7,1,1,0
10,10,0,0,1,1
6,20,-14,0,1,1
-13,-15,2,1,1,0
-21,-1,-20,0,1,1
8,9,-1,0,1,1
-17,-16,-1,0,1,1
-25,-9,-16,0,0,0
-60,-41,-19,0,0,0
12,18,-6,0,0,0
-41,-39,-2,0,0,0
-37,-25,-12,0,0,0
1,-11,12,1,0,1
-14,-15,1,1,0,1
-22,-15,-7,0,0,0
-23,-27,4,1,0,1
1,6,-5,0,1,1
-24,-19,-5,0,1,1
50,32,18,1,1,0
31,38,-7,0,1,1
36,35,1,1,1,0
27,32,-5,0,1,1
-4,-16,12,1,1,0
-25,-15,-10,0,1,1
11,27,-16,0,1,1
16,14,2,1,1,0
-40,-26,-14,0,1,1
16,33,-17,0,1,1
-30,-32,2,1,1,0
42,32,10,1,1,0
12,3,9,1,1,0
28,38,-10,0,1,1
-44,-42,-2,0,1,1
5,-6,11,1,1,0
10,15,-5,0,1,1
6,-11,17,1,1,0
-20,-29,9,1,0,1
9,1,8,1,0,1
-26,-23,-3,0,0,0
-41,-27,-14,0,0,0
-18,-33,15,1,0,1
-19,-37,18,1,0,1
13,7,6,1,0,1
9,28,-19,0,0,0
10,-9,19,1,1,0
-45,-40,-5,0,1,1
-36,-38,2,1,1,0
58,38,20,1,1,0
-12,-28,16,1,1,0
-1,0,-1,0,1,1
33,24,9,1,1,0
-3,-7,4,1,1,0
2,5,-3,0,1,1
23,35,-12,0,1,1
-5,5,-10,0,1,1
-17,-32,15,1,1,0
14,-6,20,1,1,0
-46,-44,-2,0,1,1
49,44,5,1,1,0
-15,5,-20,0,1,1
25,25,0,0,1,1
60,42,18,1,1,0
12,4,8,1,1,0
3,10,-7,0,1,1
-18,-25,7,1,1,0
-1,-12,11,1,0,1
7,-10,17,1,0,1
-15,-24,9,1,0,1
23,33,-10,0,0,0
3,19,-16,0,0,0
-53,-33,-20,0,0,0
27,28,-1,0,0,0
-5,6,-11,0,0,0
0,19,-19,0,0,0
-27,-23,-4,0,0,0
-30,-19,-11,0,0,0
43,43,0,0,0,0
2,-14,16,1,0,1
-3,-1,-2,0,0,0
-25,-39,14,1,0,1
28,38,-10,0,0,0
36,43,-7,0,0,0
5,-12,17,1,0,1
46,39,7,1,0,1
59,40,19,1,0,1
-4,-22,18,1,0,1
-26,-25,-1,0,1,1
40,20,20,1,1,0
-23,-29,6,1,1,0
-45,-36,-9,0,1,1
24,32,-8,0,1,1
21,14,7,1,1,0
31,17,14,1,1,0
30,40,-10,0,1,1
12,21,-9,0,1,1
45,43,2,1,1,0
4,17,-13,0,0,0
-40,-34,-6,0,0,0
-9,-29,20,1,0,1
30,21,9,1,0,1
-39,-32,-7,0,0,0
-38,-44,6,1,0,1
-6,-9,3,1,0,1
3,-8,11,1,0,1
-36,-17,-19,0,0,0
-2,7,-9,0,1,1
34,30,4,1,1,0
16,9,7,1,1,0
-26,-10,-16,0,1,1
-35,-16,-19,0,1,1
1,-5,6,1,1,0
-5,-23,18,1,1,0
-36,-33,-3,0,1,1
23,10,13,1,1,0
24,16,8,1,1,0
15,35,-20,0,1,1
-36,-44,8,1,1,0
-12,-2,-10,0,1,1
6,3,3,1,1,0
41,42,-1,0,1,1
30,17,13,1,1,0
-50,-38,-12,0,1,1
22,32,-10,0,0,0
-8,7,-15,0,0,0
9,20,-11,0,0,0
-24,-42,18,1,0,1
2,-13,15,1,0,1
5,25,-20,0,0,0
20,8,12,1,0,1
-5,-7,2,1,0,1
14,19,-5,0,0,0
-47,-39,-8,0,0,0
50,30,20,1,0,1
-10,-17,7,1,1,0
39,41,-2,0,1,1
30,33,-3,0,1,1
-55,-35,-20,0,1,1
-14,5,-19,0,1,1
7,8,-1,0,1,1
9,6,3,1,1,0
-2,6,-8,0,1,1
-27,-38,11,1,0,1
6,0,6,1,0,1
-24,-7,-17,0,0,0
-12,-26,14,1,0,1
12,-7,19,1,0,1
56,38,18,1,0,1
29,42,-13,0,0,0
8,-8,16,1,0,1
-13,-23,10,1,0,1
-41,-31,-10,0,0,0
-2,16,-18,0,0,0
-11,-23,12,1,0,1
40,43,-3,0,0,0
25,16,9,1,0,1
-20,-35,15,1,0,1
-50,-31,-19,0,0,0
2,5,-3,0,0,0
-23,-24,1,1,0,1
-17,-8,-9,0,0,0
30,35,-5,0,0,0
-24,-27,3,1,1,0
2,-10,12,1,1,0
26,44,-18,0,1,1
-21,-16,-5,0,1,1
-6,-2,-4,0,1,1
-16,-6,-10,0,1,1
-3,-20,17,1,1,0
18,17,1,1,1,0
38,34,4,1,1,0
-24,-10,-14,0,1,1
7,8,-1,0,1,1
-1,8,-9,0,1,1
-3,5,-8,0,1,1
8,-9,17,1,1,0
13,15,-2,0,1,1
21,8,13,1,1,0
17,24,-7,0,1,1
-43,-28,-15,0,1,1
4,6,-2,0,1,1
-29,-11,-18,0,1,1
52,34,18,1,1,0
-16,-15,-1,0,0,0
-18,-9,-9,0,0,0
-45,-35,-10,0,0,0
3,12,-9,0,0,0
29,35,-6,0,0,0
-11,-20,9,1,0,1
-2,16,-18,0,0,0
-32,-18,-14,0,0,0
9,27,-18,0,0,0
8,24,-16,0,0,0
-1,15,-16,0,0,0
-12,-22,10,1,0,1
-1,-18,17,1,0,1
25,20,5,1,0,1
-4,13,-17,0,0,0
-48,-42,-6,0,0,0
21,33,-12,0,0,0
7,19,-12,0,0,0
-44,-40,-4,0,1,1
-55,-39,-16,0,1,1
1,17,-16,0,1,1
40,42,-2,0,1,1
-7,6,-13,0,1,1
13,-5,18,1,1,0
21,21,0,0,1,1
51,42,9,1,1,0
2,-10,12,1,1,0
20,11,9,1,1,0
-15,-31,16,1,1,0
18,14,4,1,1,0
-7,-16,9,1,1,0
6,-14,20,1,1,0
29,22,7,1,1,0
-30,-43,13,1,1,0
25,9,16,1,1,0
-56,-39,-17,0,1,1
17,-3,20,1,1,0
38,27,11,1,1,0
-38,-30,-8,0,1,1
-15,-33,18,1,0,1
-15,-25,10,1,0,1
-30,-21,-9,0,0,0
21,39,-18,0,0,0
14,7,7,1,0,1
35,27,8,1,0,1
-42,-34,-8,0,0,0
5,4,1,1,0,1
-4,3,-7,0,0,0
-41,-28,-13,0,1,1
-43,-40,-3,0,1,1
-27,-40,13,1,1,0
-24,-43,19,1,1,0
-10,-21,11,1,1,0
-23,-6,-17,0,1,1
-46,-38,-8,0,1,1
19,0,19,1,1,0
11,17,-6,0,1,1
-49,-41,-8,0,0,0
-30,-30,0,0,0,0
-32,-24,-8,0,0,0
9,17,-8,0,0,0
4,11,-7,0,0,0
30,12,18,1,0,1
8,0,8,1,0,1
20,36,-16,0,0,0
29,23,6,1,0,1
-24,-40,16,1,0,1
5,-4,9,1,0,1
-46,-45,-1,0,0,0
-12,3,-15,0,0,0
-7,-17,10,1,0,1
34,35,-1,0,0,0
3,-4,7,1,1,0
33,29,4,1,1,0
2,-13,15,1,1,0
-29,-19,-10,0,1,1
-3,-9,6,1,1,0
-8,-2,-6,0,1,1
10,8,2,1,1,0
22,3,19,1,1,0
-8,-27,19,1,1,0
9,11,-2,0,1,1
19,31,-12,0,1,1
-22,-41,19,1,0,1
27,17,10,1,0,1
30,20,10,1,0,1
-10,-1,-9,0,0,0
39,39,0,0,0,0
-28,-18,-10,0,0,0
19,11,8,1,0,1
-31,-13,-18,0,0,0
8,7,1,1,0,1
31,31,0,0,0,0
-20,-32,12,1,0,1
-14,-28,14,1,0,1
7,-4,11,1,0,1
10,12,-2,0,1,1
-37,-21,-16,0,1,1
3,-2,5,1,1,0
-20,-14,-6,0,1,1
-37,-40,3,1,1,0
48,37,11,1,1,0
-58,-42,-16,0,1,1
3,-9,12,1,1,0
-15,-20,5,1,1,0
-2,-12,10,1,1,0
9,16,-7,0,1,1
10,7,3,1,1,0
40,31,9,1,1,0
25,9,16,1,1,0
-50,-34,-16,0,1,1
32,34,-2,0,0,0
-12,-2,-10,0,0,0
19,27,-8,0,0,0
8,14,-6,0,0,0
-25,-45,20,1,0,1
32,40,-8,0,0,0
51,44,7,1,0,1
-14,-31,17,1,0,1
7,22,-15,0,0,0
2,-6,8,1,0,1
-29,-13,-16,0,0,0
22,40,-18,0,1,1
-30,-13,-17,0,1,1
-31,-12,-19,0,1,1
-53,-34,-19,0,1,1
-21,-14,-7,0,1,1
-50,-42,-8,0,1,1
18,29,-11,0,1,1
-5,1,-6,0,1,1
-39,-39,0,0,1,1
-34,-22,-12,0,1,1
-8,-17,9,1,1,0
2,11,-9,0,1,1
-5,6,-11,0,1,1
-12,-27,15,1,1,0
59,40,19,1,0,1
14,25,-11,0,0,0
24,10,14,1,0,1
44,25,19,1,0,1
23,31,-8,0,0,0
49,41,8,1,0,1
56,42,14,1,0,1
55,40,15,1,0,1
-40,-43,3,1,0,1
-8,-28,20,1,0,1
-25,-23,-2,0,0,0
38,18,20,1,0,1
-13,-17,4,1,0,1
52,37,15,1,0,1
-36,-20,-16,0,1,1
45,39,6,1,1,0
-56,-43,-13,0,1,1
-39,-43,4,1,1,0
-16,-6,-10,0,1,1
-9,-17,8,1,1,0
54,42,12,1,1,0
23,16,7,1,1,0
7,-13,20,1,1,0
41,28,13,1,1,0
-10,9,-19,0,0,0
33,18,15,1,0,1
-5,14,-19,0,0,0
-43,-30,-13,0,0,0
35,37,-2,0,0,0
32,19,13,1,0,1
-1,2,-3,0,0,0
-34,-24,-10,0,0,0
18,20,-2,0,0,0
16,-2,18,1,0,1
-14,-7,-7,0,0,0
0,6,-6,0,0,0
-23,-17,-6,0,0,0
-24,-22,-2,0,0,0
29,26,3,1,0,1
30,10,20,1,1,0
-42,-22,-20,0,1,1
28,19,9,1,1,0
-13,2,-15,0,1,1
-43,-26,-17,0,1,1
-12,-30,18,1,1,0
19,36,-17,0,1,1
10,25,-15,0,1,1
28,29,-1,0,1,1
44,40,4,1,1,0
-32,-35,3,1,1,0
29,40,-11,0,1,1
-34,-14,-20,0,1,1
-11,-26,15,1,1,0
46,32,14,1,0,1
19,16,3,1,0,1
-5,13,-18,0,0,0
7,25,-18,0,0,0
14,-5,19,1,0,1
37,44,-7,0,0,0
-10,-3,-7,0,0,0
10,16,-6,0,0,0
-40,-36,-4,0,0,0
-16,-6,-10,0,0,0
3,-2,5,1,0,1
-24,-40,16,1,0,1
-27,-16,-11,0,1,1
-37,-29,-8,0,1,1
14,24,-10,0,1,1
5,9,-4,0,1,1
13,6,7,1,1,0
-37,-18,-19,0,1,1
-23,-4,-19,0,1,1
-12,6,-18,0,1,1
63,44,19,1,0,1
17,7,10,1,0,1
-32,-21,-11,0,0,0
22,17,5,1,0,1
24,13,11,1,0,1
-44,-38,-6,0,0,0
22,15,7,1,0,1
38,39,-1,0,0,0
4,10,-6,0,0,0
-3,-12,9,1,1,0
20,7,13,1,1,0
44,24,20,1,1,0
-12,3,-15,0,1,1
-53,-41,-12,0,1,1
-59,-44,-15,0,1,1
38,30,8,1,1,0
-8,0,-8,0,1,1
-20,-35,15,1,1,0
-1,-16,15,1,1,0
23,32,-9,0,0,0
20,15,5,1,0,1
17,25,-8,0,0,0
-17,-3,-14,0,0,0
13,16,-3,0,0,0
-25,-27,2,1,0,1
-19,-32,13,1,0,1
-12,-27,15,1,0,1
-57,-45,-12,0,0,0
-5,-19,14,1,0,1
-32,-45,13,1,0,1
-16,-9,-7,0,0,0
-6,-19,13,1,0,1
-24,-8,-16,0,0,0
36,43,-7,0,0,0
-16,-35,19,1,0,1
-17,-16,-1,0,0,0
28,12,16,1,0,1
-7,-10,3,1,1,0
23,23,0,0,1,1
53,39,14,1,1,0
34,38,-4,0,1,1
-26,-33,7,1,1,0
36,35,1,1,1,0
9,23,-14,0,1,1
6,12,-6,0,1,1
5,-8,13,1,1,0
23,31,-8,0,1,1
44,44,0,0,1,1
-39,-26,-13,0,1,1
-45,-29,-16,0,1,1
55,36,19,1,1,0
38,31,7,1,1,0
-31,-44,13,1,1,0
17,21,-4,0,1,1
32,44,-12,0,1,1
15,13,2,1,1,0
4,5,-1,0,1,1
-7,0,-7,0,1,1
9,-8,17,1,0,1
21,10,11,1,0,1
36,31,5,1,0,1
44,43,1,1,0,1
3,23,-20,0,0,0
38,22,16,1,0,1
21,3,18,1,0,1
9,23,-14,0,0,0
-47,-37,-10,0,0,0
20,3,17,1,0,1
1,-12,13,1,0,1
49,43,6,1,0,1
40,37,3,1,1,0
-28,-39,11,1,1,0
3,12,-9,0,1,1
54,38,16,1,1,0
54,43,11,1,1,0
-22,-6,-16,0,1,1
1,12,-11,0,1,1
52,36,16,1,1,0
50,39,11,1,1,0
20,28,-8,0,1,1
36,28,8,1,1,0
-21,-30,9,1,0,1
53,34,19,1,0,1
-36,-44,8,1,0,1
-9,-7,-2,0,0,0
-5,-22,17,1,0,1
1,-14,15,1,0,1
8,-11,19,1,0,1
-25,-15,-10,0,0,0
-63,-44,-19,0,0,0
-22,-5,-17,0,0,0
22,21,1,1,1,0
-56,-44,-12,0,1,1
9,17,-8,0,1,1
-21,-4,-17,0,1,1
-14,-30,16,1,1,0
-7,1,-8,0,1,1
51,32,19,1,1,0
30,22,8,1,1,0
33,24,9,1,0,1
-53,-44,-9,0,0,0
58,44,14,1,0,1
-27,-34,7,1,0,1
-51,-38,-13,0,0,0
-40,-26,-14,0,0,0
2,-12,14,1,0,1
4,19,-15,0,0,0
8,-2,10,1,0,1
37,40,-3,0,0,0
-31,-18,-13,0,0,0
-13,-29,16,1,0,1
-5,-20,15,1,0,1
28,39,-11,0,0,0
42,41,1,1,0,1
25,8,17,1,0,1
-22,-8,-14,0,0,0
-13,-2,-11,0,0,0
3,15,-12,0,0,0
-34,-38,4,1,0,1
43,38,5,1,0,1
-8,-10,2,1,1,0
11,19,-8,0,1,1
20,26,-6,0,1,1
-12,-25,13,1,1,0
-24,-13,-11,0,1,1
-7,9,-16,0,1,1
3,8,-5,0,1,1
12,32,-20,0,1,1
44,30,14,1,1,0
-19,-14,-5,0,1,1
50,38,12,1,1,0
23,32,-9,0,1,1
26,21,5,1,1,0
2,-11,13,1,1,0
-21,-21,0,0,1,1
44,30,14,1,1,0
10,27,-17,0,1,1
5,16,-11,0,1,1
0,-12,12,1,1,0
-27,-30,3,1,1,0
-59,-44,-15,0,1,1
16,27,-11,0,0,0
3,-8,11,1,0,1
12,13,-1,0,0,0
43,29,14,1,0,1
-23,-8,-15,0,0,0
6,-3,9,1,0,1
-15,-5,-10,0,0,0
39,22,17,1,0,1
39,21,18,1,0,1
6,23,-17,0,0,0
9,-5,14,1,0,1
1,-1,2,1,0,1
-43,-36,-7,0,0,0
-16,-3,-13,0,0,0
-23,-8,-15,0,0,0
-38,-42,4,1,0,1
-8,-9,1,1,0,1
-11,-19,8,1,0,1
18,10,8,1,0,1
-39,-41,2,1,0,1
0,-13,13,1,0,1
-2,-18,16,1,1,0
-13,-29,16,1,1,0
3,-12,15,1,1,0
22,25,-3,0,1,1
-17,-33,16,1,1,0
8,-11,19,1,1,0
3,21,-18,0,1,1
-36,-42,6,1,1,0
-28,-8,-20,0,1,1
-20,-7,-13,0,1,1
48,29,19,1,1,0
-49,-29,-20,0,1,1
34,34,0,0,1,1
-35,-34,-1,0,1,1
43,42,1,1,1,0
-49,-41,-8,0,1,1
-23,-42,19,1,1,0
-42,-31,-11,0,1,1
24,23,1,1,1,0
-4,-19,15,1,1,0
-1,-7,6,1,1,0
40,24,16,1,0,1
24,21,3,1,0,1
8,-11,19,1,0,1
49,41,8,1,0,1
40,32,8,1,0,1
-47,-31,-16,0,0,0
6,18,-12,0,0,0
12,20,-8,0,0,0
-30,-43,13,1,0,1
1,-9,10,1,0,1
-29,-25,-4,0,0,0
-26,-19,-7,0,0,0
39,42,-3,0,0,0
-16,-27,11,1,0,1
49,33,16,1,0,1
-11,-9,-2,0,0,0
21,3,18,1,1,0
5,-5,10,1,1,0
-41,-44,3,1,1,0
-2,-15,13,1,1,0
22,19,3,1,1,0
59,39,20,1,1,0
-29,-36,7,1,1,0
-10,-27,17,1,1,0
-11,-26,15,1,1,0
-3,-2,-1,0,1,1
13,26,-13,0,1,1
-15,-24,9,1,1,0
-5,-25,20,1,1,0
16,31,-15,0,1,1
8,-5,13,1,1,0
-3,11,-14,0,1,1
-33,-41,8,1,1,0
-10,-10,0,0,1,1
51,43,8,1,1,0
-32,-36,4,1,1,0
-13,-5,-8,0,0,0
23,41,-18,0,0,0
44,42,2,1,0,1
27,21,6,1,0,1
11,7,4,1,0,1
-32,-29,-3,0,0,0
-36,-45,9,1,0,1
54,41,13,1,0,1
-28,-16,-12,0,0,0
-39,-20,-19,0,0,0
50,43,7,1,0,1
27,18,9,1,0,1
46,29,17,1,0,1
-35,-17,-18,0,0,0
24,35,-11,0,0,0
31,42,-11,0,0,0
-50,-34,-16,0,0,0
-24,-7,-17,0,0,0
16,11,5,1,0,1
-37,-29,-8,0,0,0
26,20,6,1,0,1
24,27,-3,0,1,1
-2,-14,12,1,1,0
7,-3,10,1,1,0
-42,-24,-18,0,1,1
-6,-7,1,1,1,0
-34,-24,-10,0,1,1
0,2,-2,0,1,1
-42,-37,-5,0,1,1
38,31,7,1,1,0
24,21,3,1,1,0
-16,-6,-10,0,1,1
39,27,12,1,0,1
-59,-39,-20,0,0,0
-16,-28,12,1,0,1
-29,-35,6,1,0,1
25,20,5,1,0,1
-10,-7,-3,0,0,0
44,42,2,1,0,1
5,11,-6,0,0,0
-3,12,-15,0,1,1
-45,-40,-5,0,1,1
-47,-40,-7,0,1,1
34,31,3,1,1,0
25,15,10,1,1,0
-45,-36,-9,0,1,1
-48,-38,-10,0,1,1
50,43,7,1,1,0
15,25,-10,0,1,1
-9,-3,-6,0,1,1
17,31,-14,0,0,0
-46,-44,-2,0,0,0
1,12,-11,0,0,0
18,33,-15,0,0,0
29,17,12,1,0,1
-7,-1,-6,0,0,0
-10,2,-12,0,0,0
60,40,20,1,0,1
-11,-21,10,1,0,1
-44,-30,-14,0,0,0
-10,-13,3,1,0,1
-32,-21,-11,0,0,0
-61,-41,-20,0,0,0
-37,-36,-1,0,0,0
-1,-5,4,1,0,1
47,42,5,1,0,1
29,10,19,1,0,1
45,44,1,1,0,1
-42,-33,-9,0,0,0
1,-15,16,1,0,1
-3,-5,2,1,0,1
3,-8,11,1,1,0
30,25,5,1,1,0
-2,12,-14,0,1,1
7,21,-14,0,1,1
-16,-36,20,1,1,0
-24,-16,-8,0,1,1
-40,-21,-19,0,1,1
-4,14,-18,0,1,1
44,37,7,1,1,0
-21,-38,17,1,0,1
-5,5,-10,0,0,0
15,2,13,1,0,1
-26,-36,10,1,0,1
38,36,2,1,0,1
-11,-22,11,1,0,1
35,41,-6,0,0,0
16,0,16,1,0,1
21,40,-19,0,0,0
-24,-34,10,1,0,1
-44,-36,-8,0,0,0
45,35,10,1,0,1
21,40,-19,0,0,0
29,34,-5,0,0,0
28,17,11,1,0,1
-55,-45,-10,0,0,0
-21,-14,-7,0,0,0
-43,-28,-15,0,0,0
15,19,-4,0,0,0
26,19,7,1,0,1
9,1,8,1,0,1
12,17,-5,0,1,1
-11,-14,3,1,1,0
53,34,19,1,1,0
-27,-29,2,1,1,0
-16,-19,3,1,1,0
-37,-26,-11,0,1,1
49,39,10,1,1,0
-29,-21,-8,0,1,1
-27,-25,-2,0,1,1
-23,-26,3,1,1,0
40,40,0,0,1,1
38,24,14,1,1,0
39,30,9,1,1,0
40,35,5,1,1,0
15,24,-9,0,1,1
34,23,11,1,1,0
29,30,-1,0,1,1
9,28,-19,0,1,1
31,22,9,1,1,0
-26,-38,12,1,1,0
-53,-41,-12,0,1,1
40,40,0,0,0,0
13,33,-20,0,0,0
42,27,15,1,0,1
9,23,-14,0,0,0
57,38,19,1,0,1
-25,-8,-17,0,0,0
12,15,-3,0,0,0
4,19,-15,0,0,0
8,10,-2,0,0,0
2,20,-18,0,0,0
9,17,-8,0,0,0
32,26,6,1,1,0
52,38,14,1,1,0
56,41,15,1,1,0
-39,-29,-10,0,1,1
22,19,3,1,1,0
-1,-19,18,1,1,0
-34,-16,-18,0,1,1
-9,-3,-6,0,1,1
-59,-44,-15,0,1,1
-10,-5,-5,0,0,0
-39,-34,-5,0,0,0
-6,-15,9,1,0,1
24,14,10,1,0,1
-33,-42,9,1,0,1
28,14,14,1,0,1
-42,-41,-1,0,0,0
-60,-45,-15,0,0,0
24,17,7,1,0,1
-35,-41,6,1,1,0
-5,-10,5,1,1,0
20,37,-17,0,1,1
-11,5,-16,0,1,1
11,25,-14,0,1,1
-46,-37,-9,0,1,1
-7,-7,0,0,1,1
-41,-30,-11,0,1,1
-30,-39,9,1,1,0
-21,-39,18,1,1,0
-30,-37,7,1,1,0
-34,-19,-15,0,1,1
-24,-19,-5,0,1,1
12,0,12,1,1,0
61,43,18,1,1,0
6,18,-12,0,1,1
-38,-40,2,1,1,0
-11,-8,-3,0,1,1
-16,-22,6,1,0,1
24,14,10,1,0,1
46,28,18,1,0,1
-44,-27,-17,0,0,0
20,3,17,1,0,1
-42,-40,-2,0,0,0
23,28,-5,0,0,0
49,36,13,1,0,1
-53,-40,-13,0,0,0
-25,-38,13,1,0,1
-2,8,-10,0,0,0
-4,-10,6,1,0,1
-22,-36,14,1,0,1
-7,1,-8,0,0,0
-4,13,-17,0,0,0
-7,6,-13,0,0,0
23,25,-2,0,0,0
-20,-22,2,1,0,1
-46,-32,-14,0,1,1
32,33,-1,0,1,1
-20,-30,10,1,1,0
-18,-10,-8,0,1,1
38,27,11,1,1,0
-31,-15,-16,0,1,1
28,17,11,1,1,0
-32,-41,9,1,1,0
17,2,15,1,1,0
-39,-36,-3,0,1,1
-12,-4,-8,0,1,1
-32,-33,1,1,0,1
52,37,15,1,0,1
34,19,15,1,0,1
-13,-11,-2,0,0,0
-25,-28,3,1,0,1
19,14,5,1,0,1
-13,4,-17,0,0,0
-2,2,-4,0,0,0
-60,-44,-16,0,0,0
28,27,1,1,0,1
-20,-25,5,1,0,1
-46,-30,-16,0,0,0
34,15,19,1,0,1
-15,-16,1,1,0,1
54,41,13,1,0,1
22,40,-18,0,0,0
24,34,-10,0,0,0
41,26,15,1,0,1
28,43,-15,0,0,0
-51,-31,-20,0,1,1
1,7,-6,0,1,1
-35,-33,-2,0,1,1
5,18,-13,0,1,1
30,28,2,1,1,0
6,14,-8,0,1,1
-14,-21,7,1,1,0
38,20,18,1,1,0
-6,-4,-2,0,1,1
-43,-25,-18,0,1,1
21,34,-13,0,1,1
-9,-22,13,1,0,1
-9,10,-19,0,0,0
-26,-27,1,1,0,1
34,41,-7,0,0,0
-29,-10,-19,0,0,0
-43,-40,-3,0,0,0
21,16,5,1,0,1
25,19,6,1,0,1
-1,-7,6,1,0,1
-53,-38,-15,0,0,0
50,34,16,1,0,1
44,33,11,1,0,1
-25,-44,19,1,0,1
-58,-44,-14,0,0,0
58,40,18,1,0,1
13,15,-2,0,0,0
-43,-34,-9,0,0,0
-1,14,-15,0,0,0
9,17,-8,0,0,0
38,38,0,0,0,0
31,24,7,1,0,1
16,32,-16,0,1,1
36,22,14,1,1,0
6,23,-17,0,1,1
-13,-4,-9,0,1,1
36,17,19,1,1,0
-22,-20,-2,0,1,1
-29,-22,-7,0,1,1
26,22,4,1,1,0
38,18,20,1,1,0
29,33,-4,0,1,1
13,32,-19,0,1,1
30,44,-14,0,1,1
40,24,16,1,0,1
13,31,-18,0,0,0
-58,-43,-15,0,0,0
10,28,-18,0,0,0
-19,-38,19,1,0,1
49,29,20,1,0,1
40,31,9,1,0,1
-1,12,-13,0,0,0
-6,12,-18,0,0,0
37,27,10,1,0,1
22,6,16,1,0,1
-16,-29,13,1,0,1
18,33,-15,0,0,0
-53,-44,-9,0,0,0
-19,-22,3,1,0,1
-59,-45,-14,0,0,0
55,38,17,1,0,1
30,28,2,1,0,1
-1,14,-15,0,0,0
6,-7,13,1,0,1
-44,-45,1,1,0,1
21,2,19,1,1,0
-37,-34,-3,0,1,1
-53,-37,-16,0,1,1
3,-5,8,1,1,0
-31,-40,9,1,1,0
9,27,-18,0,1,1
21,16,5,1,1,0
13,9,4,1,1,0
-26,-31,5,1,1,0
4,21,-17,0,1,1
37,17,20,1,0,1
-40,-22,-18,0,0,0
-59,-43,-16,0,0,0
24,26,-2,0,0,0
4,21,-17,0,0,0
-22,-9,-13,0,0,0
47,28,19,1,0,1
24,18,6,1,0,1
17,1,16,1,0,1
30,14,16,1,0,1
-3,10,-13,0,0,0
37,36,1,1,1,0
5,-14,19,1,1,0
23,42,-19,0,1,1
-25,-37,12,1,1,0
-41,-26,-15,0,1,1
2,-9,11,1,1,0
-41,-28,-13,0,1,1
-28,-12,-16,0,1,1
-14,-10,-4,0,1,1
-53,-43,-10,0,1,1
-23,-9,-14,0,1,1
-18,-16,-2,0,1,1
-27,-22,-5,0,1,1
-50,-44,-6,0,1,1
-14,-14,0,0,1,1
20,9,11,1,1,0
-18,0,-18,0,1,1
6,19,-13,0,1,1
-10,10,-20,0,1,1
-49,-30,-19,0,1,1
-8,-5,-3,0,1,1
-11,-25,14,1,0,1
3,2,1,1,0,1
4,-5,9,1,0,1
-18,2,-20,0,0,0
-3,-17,14,1,0,1
39,39,0,0,0,0
8,-4,12,1,0,1
45,44,1,1,0,1
-10,-2,-8,0,0,0
36,33,3,1,0,1
42,30,12,1,0,1
-48,-30,-18,0,0,0
-7,-25,18,1,0,1
-42,-34,-8,0,0,0
31,24,7,1,1,0
33,39,-6,0,1,1
-37,-17,-20,0,1,1
-32,-41,9,1,1,0
-20,-26,6,1,1,0
-50,-31,-19,0,1,1
13,1,12,1,1,0
5,1,4,1,1,0
-13,-18,5,1,1,0
3,8,-5,0,1,1
29,42,-13,0,1,1
-1,13,-14,0,1,1
27,22,5,1,1,0
45,44,1,1,1,0
58,38,20,1,1,0
-44,-29,-15,0,1,1
-44,-40,-4,0,1,1
-21,-3,-18,0,1,1
22,5,17,1,1,0
-37,-34,-3,0,1,1
13,23,-10,0,1,1
-41,-23,-18,0,0,0
-6,-17,11,1,0,1
50,32,18,1,0,1
-33,-18,-15,0,0,0
-53,-44,-9,0,0,0
43,30,13,1,0,1
-38,-39,1,1,0,1
20,39,-19,0,0,0
-20,-38,18,1,0,1
-23,-20,-3,0,0,0
-16,-23,7,1,1,0
-41,-35,-6,0,1,1
20,17,3,1,1,0
-24,-25,1,1,1,0
-28,-27,-1,0,1,1
-33,-26,-7,0,1,1
1,-9,10,1,1,0
-33,-27,-6,0,1,1
16,13,3,1,1,0
-25,-18,-7,0,0,0
13,33,-20,0,0,0
-20,-4,-16,0,0,0
-2,6,-8,0,0,0
2,-15,17,1,0,1
39,24,15,1,0,1
-22,-42,20,1,0,1
27,25,2,1,0,1
26,12,14,1,0,1
-12,-24,12,1,1,0
-29,-14,-15,0,1,1
39,25,14,1,1,0
34,18,16,1,1,0
32,40,-8,0,1,1
43,34,9,1,1,0
25,9,16,1,1,0
-19,-18,-1,0,1,1
-4,3,-7,0,1,1
-26,-44,18,1,1,0
-46,-45,-1,0,1,1
-9,-23,14,1,1,0
-8,-22,14,1,1,0
23,26,-3,0,1,1
14,5,9,1,1,0
-30,-27,-3,0,0,0
43,29,14,1,0,1
-50,-36,-14,0,0,0
-51,-40,-11,0,0,0
27,42,-15,0,0,0
62,44,18,1,0,1
-13,-33,20,1,0,1
11,10,1,1,0,1
-36,-41,5,1,0,1
5,9,-4,0,0,0
-25,-41,16,1,0,1
7,-12,19,1,0,1
0,-11,11,1,0,1
-33,-28,-5,0,0,0
30,28,2,1,1,0
10,10,0,0,1,1
32,29,3,1,1,0
-35,-39,4,1,1,0
16,30,-14,0,1,1
-26,-45,19,1,1,0
-2,16,-18,0,1,1
20,15,5,1,1,0
12,16,-4,0,1,1
7,20,-13,0,1,1
-13,4,-17,0,1,1
-34,-35,1,1,1,0
27,32,-5,0,1,1
-36,-43,7,1,1,0
-28,-17,-11,0,1,1
-32,-42,10,1,1,0
-4,10,-14,0,1,1
-6,-23,17,1,1,0
-9,-6,-3,0,0,0
-3,-6,3,1,0,1
18,22,-4,0,0,0
23,33,-10,0,0,0
10,1,9,1,0,1
-35,-41,6,1,0,1
18,36,-18,0,0,0
-20,-3,-17,0,0,0
-15,-17,2,1,0,1
47,43,4,1,0,1
-41,-39,-2,0,0,0
-11,5,-16,0,0,0
-3,14,-17,0,0,0
16,32,-16,0,0,0
-27,-41,14,1,0,1
-22,-17,-5,0,0,0
-26,-40,14,1,0,1
25,41,-16,0,0,0
28,21,7,1,0,1
20,30,-10,0,0,0
28,30,-2,0,0,0
-28,-14,-14,0,1,1
-24,-26,2,1,1,0
-29,-21,-8,0,1,1
-1,-21,20,1,1,0
-39,-24,-15,0,1,1
-11,-31,20,1,1,0
24,32,-8,0,1,1
51,42,9,1,1,0
10,-2,12,1,1,0
-58,-38,-20,0,1,1
22,18,4,1,1,0
-49,-36,-13,0,1,1
49,43,6,1,1,0
60,40,20,1,0,1
-18,-9,-9,0,0,0
-35,-39,4,1,0,1
2,0,2,1,0,1
4,14,-10,0,0,0
-18,-9,-9,0,0,0
-52,-34,-18,0,0,0
-5,-11,6,1,0,1
20,23,-3,0,0,0
54,38,16,1,0,1
-13,-11,-2,0,0,0
-29,-43,14,1,0,1
12,19,-7,0,0,0
-17,-22,5,1,0,1
-4,-13,9,1,0,1
16,24,-8,0,0,0
15,19,-4,0,0,0
-50,-35,-15,0,0,0
50,38,12,1,0,1
22,5,17,1,0,1
22,31,-9,0,0,0
-8,-6,-2,0,1,1
-17,3,-20,0,1,1
30,30,0,0,1,1
-7,-2,-5,0,1,1
-11,7,-18,0,1,1
-18,-18,0,0,1,1
-26,-24,-2,0,1,1
18,33,-15,0,1,1
-5,-25,20,1,1,0
-43,-36,-7,0,1,1
53,35,18,1,1,0
21,24,-3,0,1,1
-35,-34,-1,0,1,1
2,-10,12,1,1,0
10,24,-14,0,1,1
5,15,-10,0,0,0
8,4,4,1,0,1
45,25,20,1,0,1
28,38,-10,0,0,0
-10,-1,-9,0,0,0
-16,-13,-3,0,0,0
2,11,-9,0,0,0
6,6,0,0,0,0
-27,-14,-13,0,0,0
-4,-18,14,1,0,1
-2,10,-12,0,0,0
25,21,4,1,0,1
9,10,-1,0,0,0
-15,-8,-7,0,0,0
18,24,-6,0,0,0
15,20,-5,0,0,0
40,33,7,1,0,1
20,31,-11,0,0,0
4,3,1,1,0,1
13,6,7,1,1,0
12,-8,20,1,1,0
-3,12,-15,0,1,1
43,27,16,1,1,0
2,4,-2,0,1,1
18,28,-10,0,1,1
-49,-29,-20,0,1,1
-22,-30,8,1,1,0
-50,-41,-9,0,1,1
-16,-5,-11,0,1,1
31,39,-8,0,1,1
10,0,10,1,1,0
38,29,9,1,0,1
-27,-31,4,1,0,1
40,27,13,1,0,1
-22,-21,-1,0,0,0
-36,-29,-7,0,0,0
-25,-5,-20,0,0,0
-22,-15,-7,0,0,0
4,-16,20,1,0,1
-20,-20,0,0,0,0
39,42,-3,0,0,0
-9,-17,8,1,0,1
14,23,-9,0,0,0
14,28,-14,0,0,0
-36,-42,6,1,0,1
-35,-45,10,1,0,1
-31,-34,3,1,0,1
22,20,2,1,0,1
18,37,-19,0,0,0
-22,-10,-12,0,0,0
24,22,2,1,0,1
-31,-20,-11,0,0,0
-42,-28,-14,0,1,1
6,23,-17,0,1,1
20,34,-14,0,1,1
43,33,10,1,1,0
46,43,3,1,1,0
-2,-3,1,1,1,0
-29,-43,14,1,1,0
30,21,9,1,1,0
22,26,-4,0,0,0
15,23,-8,0,0,0
-15,-24,9,1,0,1
16,7,9,1,0,1
-22,-41,19,1,0,1
49,42,7,1,0,1
33,35,-2,0,0,0
0,-9,9,1,0,1
-57,-41,-16,0,0,0
8,14,-6,0,0,0
-13,4,-17,0,0,0
0,7,-7,0,0,0
-11,-9,-2,0,0,0
-20,-11,-9,0,0,0
49,44,5,1,0,1
-33,-28,-5,0,0,0
7,3,4,1,0,1
16,31,-15,0,0,0
-31,-26,-5,0,0,0
30,41,-11,0,0,0
-20,-11,-9,0,0,0
49,39,10,1,1,0
22,34,-12,0,1,1
5,-14,19,1,1,0
9,2,7,1,1,0
35,21,14,1,1,0
-35,-36,1,1,1,0
-16,-23,7,1,1,0
-23,-24,1,1,1,0
-25,-13,-12,0,1,1
-47,-29,-18,0,1,1
-56,-41,-15,0,0,0
-16,-12,-4,0,0,0
4,19,-15,0,0,0
-5,8,-13,0,0,0
24,34,-10,0,0,0
-6,-25,19,1,0,1
21,35,-14,0,0,0
-30,-19,-11,0,0,0
10,-2,12,1,0,1
-44,-40,-4,0,0,0
18,8,10,1,0,1
40,28,12,1,0,1
13,24,-11,0,0,0
-18,-11,-7,0,1,1
-30,-31,1,1,1,0
6,-10,16,1,1,0
-18,-29,11,1,1,0
-18,0,-18,0,1,1
-28,-8,-20,0,1,1
-30,-16,-14,0,1,1
5,25,-20,0,1,1
-27,-13,-14,0,0,0
18,27,-9,0,0,0
54,43,11,1,0,1
-14,5,-19,0,0,0
23,37,-14,0,0,0
-1,5,-6,0,0,0
-34,-31,-3,0,0,0
-22,-34,12,1,0,1
-5,-18,13,1,0,1
7,2,5,1,0,1
6,-7,13,1,0,1
8,-7,15,1,0,1
-31,-32,1,1,1,0
-12,0,-12,0,1,1
-52,-33,-19,0,1,1
12,-4,16,1,1,0
36,16,20,1,1,0
-37,-41,4,1,1,0
12,14,-2,0,1,1
-18,-23,5,1,1,0
9,-9,18,1,1,0
-23,-31,8,1,1,0
19,18,1,1,1,0
-43,-39,-4,0,1,1
-31,-37,6,1,1,0
19,36,-17,0,1,1
-11,3,-14,0,1,1
41,37,4,1,1,0
49,35,14,1,1,0
37,29,8,1,1,0
10,15,-5,0,1,1
16,3,13,1,1,0
-20,-2,-18,0,1,1
2,6,-4,0,0,0
-48,-38,-10,0,0,0
4,6,-2,0,0,0
22,17,5,1,0,1
9,-1,10,1,0,1
37,32,5,1,0,1
6,13,-7,0,0,0
-11,-18,7,1,0,1
-39,-23,-16,0,0,0
-29,-11,-18,0,0,0
-3,5,-8,0,1,1
-2,14,-16,0,1,1
25,32,-7,0,1,1
-4,7,-11,0,1,1
-24,-35,11,1,1,0
-43,-25,-18,0,1,1
2,-9,11,1,1,0
23,25,-2,0,1,1
26,30,-4,0,0,0
-12,-15,3,1,0,1
12,4,8,1,0,1
48,41,7,1,0,1
44,40,4,1,0,1
22,5,17,1,0,1
-22,-17,-5,0,0,0
17,32,-15,0,0,0
16,-4,20,1,0,1
42,34,8,1,0,1
10,5,5,1,0,1
-49,-32,-17,0,0,0
21,39,-18,0,0,0
-23,-21,-2,0,0,0
-21,-12,-9,0,0,0
7,5,2,1,0,1
-14,-21,7,1,0,1
60,42,18,1,0,1
-11,-22,11,1,0,1
-11,-21,10,1,0,1
-32,-40,8,1,0,1
-48,-43,-5,0,1,1
32,37,-5,0,1,1
-15,-12,-3,0,1,1
-33,-21,-12,0,1,1
-4,11,-15,0,1,1
10,-1,11,1,1,0
18,19,-1,0,1,1
-49,-32,-17,0,1,1
33,38,-5,0,1,1
-52,-34,-18,0,1,1
-18,-35,17,1,1,0
47,44,3,1,1,0
21,27,-6,0,0,0
7,11,-4,0,0,0
-12,-18,6,1,0,1
-10,-12,2,1,0,1
36,18,18,1,0,1
9,7,2,1,0,1
-34,-34,0,0,0,0
13,-7,20,1,0,1
-43,-26,-17,0,0,0
56,41,15,1,0,1
52,38,14,1,0,1
11,0,11,1,0,1
-46,-39,-7,0,0,0
9,24,-15,0,0,0
49,38,11,1,0,1
13,2,11,1,0,1
-37,-32,-5,0,0,0
-15,-24,9,1,0,1
-4,-14,10,1,0,1
8,-9,17,1,0,1
31,37,-6,0,0,0
25,44,-19,0,1,1
-35,-39,4,1,1,0
10,4,6,1,1,0
4,8,-4,0,1,1
21,41,-20,0,1,1
-31,-11,-20,0,1,1
14,10,4,1,1,0
-47,-41,-6,0,1,1
4,-10,14,1,1,0
28,25,3,1,1,0
-9,-1,-8,0,1,1
31,11,20,1,1,0
-34,-26,-8,0,1,1
0,6,-6,0,1,1
-16,-7,-9,0,0,0
-19,-29,10,1,0,1
-19,-16,-3,0,0,0
19,27,-8,0,0,0
23,40,-17,0,0,0
-19,-27,8,1,0,1
-28,-35,7,1,0,1
11,-4,15,1,0,1
46,42,4,1,0,1
4,20,-16,0,1,1
-51,-35,-16,0,1,1
-10,-14,4,1,1,0
6,10,-4,0,1,1
-8,-12,4,1,1,0
-3,6,-9,0,1,1
-35,-27,-8,0,1,1
56,36,20,1,1,0
-34,-35,1,1,1,0
1,-16,17,1,1,0
6,-8,14,1,1,0
54,38,16,1,1,0
-9,-4,-5,0,1,1
-29,-14,-15,0,1,1
13,6,7,1,1,0
-3,-3,0,0,1,1
33,44,-11,0,0,0
-24,-8,-16,0,0,0
-21,-32,11,1,0,1
-44,-42,-2,0,0,0
-2,-7,5,1,0,1
39,35,4,1,0,1
-6,-19,13,1,0,1
3,9,-6,0,0,0
17,34,-17,0,0,0
-13,-22,9,1,0,1
1,-5,6,1,0,1
19,6,13,1,0,1
18,18,0,0,0,0
-40,-26,-14,0,0,0
31,27,4,1,0,1
25,17,8,1,0,1
29,41,-12,0,0,0
-38,-20,-18,0,0,0
-30,-44,14,1,0,1
-15,0,-15,0,0,0
31,25,6,1,0,1
36,17,19,1,1,0
8,17,-9,0,1,1
-35,-33,-2,0,1,1
-6,-19,13,1,1,0
8,15,-7,0,1,1
5,-13,18,1,1,0
-48,-38,-10,0,1,1
38,41,-3,0,1,1
-33,-24,-9,0,1,1
6,2,4,1,1,0
16,30,-14,0,1,1
-52,-45,-7,0,1,1
42,27,15,1,1,0
-6,-6,0,0,1,1
-60,-45,-15,0,0,0
-42,-44,2,1,0,1
4,-3,7,1,0,1
-45,-35,-10,0,0,0
16,35,-19,0,0,0
9,11,-2,0,0,0
-14,5,-19,0,0,0
-33,-41,8,1,0,1
-4,14,-18,0,1,1
-3,17,-20,0,1,1
-20,-3,-17,0,1,1
-31,-25,-6,0,1,1
-26,-31,5,1,1,0
-17,-11,-6,0,1,1
-1,-8,7,1,1,0
-17,-28,11,1,1,0
-5,13,-18,0,0,0
-26,-17,-9,0,0,0
2,14,-12,0,0,0
49,41,8,1,0,1
-11,-20,9,1,0,1
-3,-11,8,1,0,1
-43,-39,-4,0,0,0
8,-8,16,1,0,1
-6,-21,15,1,0,1
-1,0,-1,0,0,0
-26,-34,8,1,0,1
20,37,-17,0,0,0
11,12,-1,0,1,1
26,11,15,1,1,0
4,21,-17,0,1,1
12,-3,15,1,1,0
-15,-7,-8,0,1,1
1,20,-19,0,1,1
-37,-30,-7,0,1,1
-7,3,-10,0,1,1
-58,-45,-13,0,1,1
-41,-33,-8,0,1,1
21,5,16,1,1,0
24,28,-4,0,1,1
-44,-30,-14,0,1,1
28,25,3,1,1,0
-33,-20,-13,0,1,1
43,36,7,1,1,0
-51,-41,-10,0,1,1
2,-7,9,1,0,1
-8,1,-9,0,0,0
26,41,-15,0,0,0
-30,-45,15,1,0,1
5,14,-9,0,0,0
9,-3,12,1,0,1
38,24,14,1,0,1
1,18,-17,0,0,0
32,34,-2,0,0,0
-34,-43,9,1,0,1
11,20,-9,0,0,0
-7,11,-18,0,0,0
-28,-29,1,1,1,0
-16,-20,4,1,1,0
-23,-31,8,1,1,0
24,34,-10,0,1,1
38,24,14,1,1,0
16,22,-6,0,1,1
-10,1,-11,0,1,1
-10,-11,1,1,1,0
6,-7,13,1,1,0
-6,-8,2,1,1,0
-44,-39,-5,0,1,1
-32,-40,8,1,1,0
27,35,-8,0,1,1
12,-3,15,1,0,1
22,27,-5,0,0,0
-32,-41,9,1,0,1
12,13,-1,0,0,0
-35,-25,-10,0,0,0
-38,-18,-20,0,0,0
-23,-36,13,1,0,1
-5,7,-12,0,0,0
43,32,11,1,0,1
13,26,-13,0,0,0
-9,-25,16,1,0,1
21,33,-12,0,0,0
24,32,-8,0,0,0
-17,-4,-13,0,0,0
-18,-1,-17,0,0,0
26,30,-4,0,0,0
29,42,-13,0,0,0
29,40,-11,0,0,0
-44,-33,-11,0,0,0
-11,-3,-8,0,0,0
-50,-39,-11,0,0,0
37,22,15,1,1,0
33,22,11,1,1,0
21,1,20,1,1,0
-8,-15,7,1,1,0
-19,-16,-3,0,1,1
15,28,-13,0,1,1
7,1,6,1,1,0
45,31,14,1,1,0
20,18,2,1,0,1
39,34,5,1,0,1
-40,-22,-18,0,0,0
-7,-27,20,1,0,1
-9,-11,2,1,0,1
-3,10,-13,0,0,0
-28,-33,5,1,0,1
-55,-44,-11,0,0,0
26,8,18,1,1,0
18,37,-19,0,1,1
27,32,-5,0,1,1
48,29,19,1,1,0
-19,-13,-6,0,1,1
17,19,-2,0,1,1
-28,-16,-12,0,1,1
3,3,0,0,1,1
22,6,16,1,1,0
27,21,6,1,1,0
-32,-39,7,1,1,0
0,11,-11,0,1,1
11,0,11,1,1,0
5,19,-14,0,1,1
2,-2,4,1,1,0
3,19,-16,0,1,1
-22,-27,5,1,1,0
-36,-39,3,1,1,0
35,29,6,1,1,0
15,7,8,1,1,0
6,-1,7,1,1,0
12,23,-11,0,0,0
54,37,17,1,0,1
8,15,-7,0,0,0
-38,-35,-3,0,0,0
-32,-30,-2,0,0,0
21,34,-13,0,0,0
35,29,6,1,0,1
54,39,15,1,0,1
50,37,13,1,0,1
1,-5,6,1,0,1
-30,-24,-6,0,0,0
39,32,7,1,0,1
30,27,3,1,0,1
14,10,4,1,1,0
30,17,13,1,1,0
-33,-32,-1,0,1,1
43,37,6,1,1,0
-11,-31,20,1,1,0
-24,-44,20,1,1,0
-47,-35,-12,0,1,1
-31,-11,-20,0,1,1
49,41,8,1,1,0
12,10,2,1,0,1
38,33,5,1,0,1
-58,-43,-15,0,0,0
14,0,14,1,0,1
44,37,7,1,0,1
-52,-34,-18,0,0,0
49,30,19,1,0,1
-18,-26,8,1,0,1
-46,-38,-8,0,0,0
1,15,-14,0,0,0
21,8,13,1,0,1
-58,-44,-14,0,0,0
-18,-13,-5,0,0,0
48,33,15,1,0,1
18,-2,20,1,0,1
-31,-41,10,1,0,1
36,22,14,1,0,1
21,27,-6,0,0,0
8,11,-3,0,0,0
-19,-1,-18,0,0,0
-35,-40,5,1,0,1
47,28,19,1,1,0
-23,-38,15,1,1,0
33,18,15,1,1,0
24,20,4,1,1,0
-9,-21,12,1,1,0
39,36,3,1,1,0
-54,-45,-9,0,1,1
-10,4,-14,0,1,1
17,32,-15,0,1,1
-44,-42,-2,0,1,1
43,33,10,1,1,0
13,20,-7,0,1,1
-27,-10,-17,0,1,1
0,20,-20,0,1,1
-17,-5,-12,0,1,1
-23,-30,7,1,1,0
-24,-28,4,1,1,0
35,34,1,1,1,0
-3,2,-5,0,0,0
-30,-28,-2,0,0,0
-12,-31,19,1,0,1
27,43,-16,0,0,0
7,-4,11,1,0,1
52,36,16,1,0,1
-44,-29,-15,0,0,0
5,-11,16,1,0,1
-18,-20,2,1,0,1
0,20,-20,0,0,0
3,-15,18,1,0,1
14,19,-5,0,0,0
51,44,7,1,0,1
41,24,17,1,0,1
-22,-29,7,1,0,1
-24,-10,-14,0,0,0
30,35,-5,0,0,0
-52,-43,-9,0,0,0
13,17,-4,0,0,0
27,42,-15,0,0,0
-1,-15,14,1,0,1
-19,1,-20,0,1,1
-5,-7,2,1,1,0
17,14,3,1,1,0
26,44,-18,0,1,1
-57,-43,-14,0,1,1
42,26,16,1,1,0
-36,-18,-18,0,1,1
7,20,-13,0,1,1
3,19,-16,0,1,1
-27,-29,2,1,1,0
-41,-39,-2,0,1,1
33,28,5,1,1,0
1,-17,18,1,1,0
-16,-5,-11,0,1,1
-15,-16,1,1,1,0
-21,-18,-3,0,1,1
-10,-27,17,1,1,0
2,-6,8,1,1,0
-38,-43,5,1,1,0
18,13,5,1,0,1
-23,-30,7,1,0,1
-33,-16,-17,0,0,0
-27,-44,17,1,0,1
-40,-31,-9,0,0,0
1,-8,9,1,0,1
39,21,18,1,0,1
-6,-14,8,1,0,1
20,0,20,1,1,0
-15,4,-19,0,1,1
2,1,1,1,1,0
-41,-22,-19,0,1,1
-43,-23,-20,0,1,1
-30,-33,3,1,1,0
3,-2,5,1,1,0
-22,-13,-9,0,1,1
8,-2,10,1,1,0
8,17,-9,0,1,1
7,-4,11,1,0,1
21,9,12,1,0,1
-30,-35,5,1,0,1
-2,11,-13,0,0,0
10,16,-6,0,0,0
-22,-26,4,1,0,1
13,17,-4,0,0,0
-49,-31,-18,0,0,0
-6,-24,18,1,0,1
62,42,20,1,1,0
-48,-34,-14,0,1,1
-31,-31,0,0,1,1
41,40,1,1,1,0
-13,-2,-11,0,1,1
8,18,-10,0,1,1
-57,-43,-14,0,1,1
22,26,-4,0,1,1
3,-2,5,1,1,0
-59,-41,-18,0,1,1
-23,-6,-17,0,1,1
17,37,-20,0,0,0
-18,-36,18,1,0,1
-41,-38,-3,0,0,0
-27,-12,-15,0,0,0
-9,-5,-4,0,0,0
17,-2,19,1,0,1
-20,-11,-9,0,0,0
-8,-9,1,1,0,1
3,23,-20,0,1,1
13,4,9,1,1,0
-42,-45,3,1,1,0
-41,-40,-1,0,1,1
8,0,8,1,1,0
-11,-24,13,1,1,0
-11,7,-18,0,1,1
8,-9,17,1,1,0
-21,-31,10,1,1,0
8,-4,12,1,1,0
-26,-14,-12,0,1,1
-1,5,-6,0,0,0
-1,-20,19,1,0,1
45,43,2,1,0,1
-16,-33,17,1,0,1
-42,-22,-20,0,0,0
41,39,2,1,0,1
-13,-16,3,1,0,1
-8,-20,12,1,0,1
-42,-44,2,1,0,1
-35,-19,-16,0,1,1
-17,-9,-8,0,1,1
28,23,5,1,1,0
-18,-12,-6,0,1,1
25,34,-9,0,1,1
-17,-34,17,1,1,0
22,40,-18,0,1,1
39,43,-4,0,1,1
-5,10,-15,0,1,1
-15,-25,10,1,1,0
7,-9,16,1,1,0
2,10,-8,0,1,1
-8,11,-19,0,1,1
38,44,-6,0,1,1
23,42,-19,0,1,1
15,35,-20,0,1,1
3,13,-10,0,1,1
53,41,12,1,1,0
5,-6,11,1,1,0
-42,-45,3,1,1,0
48,40,8,1,1,0
1,-12,13,1,0,1
34,32,2,1,0,1
4,8,-4,0,0,0
-31,-34,3,1,0,1
-8,6,-14,0,0,0
10,-3,13,1,0,1
48,37,11,1,0,1
40,31,9,1,0,1
43,28,15,1,0,1
-21,-11,-10,0,0,0
19,29,-10,0,0,0
42,25,17,1,0,1
39,29,10,1,0,1
34,40,-6,0,0,0
16,20,-4,0,1,1
26,25,1,1,1,0
34,23,11,1,1,0
4,16,-12,0,1,1
-20,-24,4,1,1,0
-32,-22,-10,0,1,1
-40,-23,-17,0,1,1
19,11,8,1,1,0
15,-4,19,1,1,0
-35,-24,-11,0,1,1
53,36,17,1,1,0
-20,-25,5,1,0,1
0,9,-9,0,0,0
-22,-36,14,1,0,1
34,18,16,1,0,1
-8,-3,-5,0,0,0
8,14,-6,0,0,0
26,42,-16,0,0,0
4,-16,20,1,0,1
31,44,-13,0,0,0
39,38,1,1,0,1
-7,-12,5,1,0,1
54,41,13,1,0,1
3,-16,19,1,0,1
48,42,6,1,1,0
-14,-2,-12,0,1,1
-24,-28,4,1,1,0
33,14,19,1,1,0
31,24,7,1,1,0
-3,-13,10,1,1,0
9,29,-20,0,1,1
28,35,-7,0,1,1
26,28,-2,0,1,1
-4,11,-15,0,1,1
23,25,-2,0,1,1
-27,-34,7,1,1,0
45,43,2,1,1,0
32,33,-1,0,1,1
27,32,-5,0,1,1
20,17,3,1,1,0
-37,-36,-1,0,1,1
5,8,-3,0,1,1
3,22,-19,0,1,1
30,29,1,1,1,0
-16,-34,18,1,1,0
34,14,20,1,0,1
34,37,-3,0,0,0
-16,4,-20,0,0,0
31,39,-8,0,0,0
21,35,-14,0,0,0
11,8,3,1,0,1
-30,-43,13,1,0,1
-15,-15,0,0,0,0
25,20,5,1,0,1
-26,-12,-14,0,0,0
-17,-18,1,1,0,1
-24,-44,20,1,0,1
-7,11,-18,0,0,0
29,42,-13,0,0,0
-27,-39,12,1,1,0
13,8,5,1,1,0
-6,7,-13,0,1,1
-34,-16,-18,0,1,1
25,14,11,1,1,0
-23,-21,-2,0,1,1
5,10,-5,0,1,1
8,21,-13,0,1,1
30,22,8,1,1,0
39,27,12,1,1,0
56,37,19,1,1,0
-50,-35,-15,0,1,1
27,14,13,1,1,0
46,35,11,1,0,1
-37,-20,-17,0,0,0
33,17,16,1,0,1
43,28,15,1,0,1
18,15,3,1,0,1
46,30,16,1,0,1
10,1,9,1,0,1
-29,-9,-20,0,0,0
-4,5,-9,0,0,0
-22,-23,1,1,0,1
22,38,-16,0,1,1
49,39,10,1,1,0
-15,-4,-11,0,1,1
3,-8,11,1,1,0
-47,-30,-17,0,1,1
-43,-43,0,0,1,1
-8,6,-14,0,1,1
1,-11,12,1,1,0
25,42,-17,0,1,1
16,23,-7,0,1,1
-10,-2,-8,0,1,1
-17,-12,-5,0,1,1
3,-5,8,1,1,0
25,33,-8,0,1,1
-9,-11,2,1,1,0
-2,9,-11,0,1,1
14,11,3,1,0,1
12,18,-6,0,0,0
7,23,-16,0,0,0
-28,-32,4,1,0,1
39,31,8,1,0,1
-19,-3,-16,0,0,0
-50,-45,-5,0,0,0
7,15,-8,0,0,0
-39,-35,-4,0,0,0
47,37,10,1,0,1
36,44,-8,0,0,0
-2,16,-18,0,0,0
20,30,-10,0,0,0
-23,-29,6,1,0,1
18,14,4,1,0,1
20,8,12,1,0,1
8,15,-7,0,0,0
-21,-18,-3,0,0,0
9,-10,19,1,0,1
-29,-16,-13,0,0,0
-12,0,-12,0,0,0
45,38,7,1,1,0
-11,-17,6,1,1,0
-43,-30,-13,0,1,1
-3,2,-5,0,1,1
-39,-44,5,1,1,0
-23,-21,-2,0,1,1
58,44,14,1,1,0
-38,-30,-8,0,1,1
-8,6,-14,0,1,1
16,36,-20,0,1,1
-25,-32,7,1,1,0
-26,-6,-20,0,1,1
-36,-32,-4,0,1,1
48,40,8,1,1,0
2,4,-2,0,1,1
7,-11,18,1,1,0
-21,-25,4,1,1,0
20,17,3,1,1,0
-1,12,-13,0,1,1
-6,-26,20,1,1,0
-2,-22,20,1,1,0
-11,-20,9,1,0,1
18,5,13,1,0,1
-25,-9,-16,0,0,0
-6,-8,2,1,0,1
-23,-15,-8,0,0,0
49,30,19,1,0,1
18,18,0,0,0,0
9,27,-18,0,0,0
-48,-31,-17,0,0,0
20,0,20,1,0,1
43,29,14,1,0,1
-15,0,-15,0,1,1
-12,-10,-2,0,1,1
5,-9,14,1,1,0
-49,-40,-9,0,1,1
-14,-13,-1,0,1,1
59,39,20,1,1,0
-3,11,-14,0,1,1
-6,5,-11,0,1,1
-62,-44,-18,0,1,1
-15,-28,13,1,1,0
-13,1,-14,0,1,1
-45,-29,-16,0,1,1
8,-9,17,1,1,0
-21,-6,-15,0,1,1
50,36,14,1,1,0
39,21,18,1,1,0
32,35,-3,0,1,1
37,28,9,1,1,0
-55,-37,-18,0,0,0
-28,-22,-6,0,0,0
-42,-31,-11,0,0,0
-27,-16,-11,0,0,0
-16,4,-20,0,0,0
-23,-23,0,0,0,0
-9,-17,8,1,0,1
39,30,9,1,0,1
-10,-22,12,1,0,1
23,40,-17,0,1,1
-39,-29,-10,0,1,1
0,15,-15,0,1,1
16,17,-1,0,1,1
-17,-33,16,1,1,0
42,31,11,1,1,0
19,38,-19,0,1,1
12,-3,15,1,1,0
-26,-33,7,1,1,0
-25,-7,-18,0,1,1
27,18,9,1,1,0
23,13,10,1,1,0
16,8,8,1,1,0
-20,-31,11,1,0,1
55,38,17,1,0,1
43,24,19,1,0,1
-16,-20,4,1,0,1
-25,-34,9,1,0,1
25,39,-14,0,0,0
-28,-44,16,1,0,1
-56,-36,-20,0,0,0
6,4,2,1,0,1
42,34,8,1,0,1
-40,-22,-18,0,0,0
-3,-1,-2,0,0,0
-31,-33,2,1,0,1
-13,-33,20,1,0,1
44,36,8,1,0,1
-20,-32,12,1,0,1
-12,-4,-8,0,0,0
-42,-30,-12,0,0,0
-22,-30,8,1,0,1
-63,-45,-18,0,0,0
11,-2,13,1,0,1
-25,-33,8,1,1,0
-25,-19,-6,0,1,1
8,10,-2,0,1,1
-28,-40,12,1,1,0
34,18,16,1,1,0
-19,-33,14,1,1,0
-25,-20,-5,0,1,1
40,24,16,1,1,0
-19,-7,-12,0,1,1
-22,-25,3,1,1,0
-30,-36,6,1,1,0
-53,-38,-15,0,1,1
-1,-15,14,1,1,0
-14,-21,7,1,1,0
-50,-35,-15,0,1,1
-44,-45,1,1,1,0
0,14,-14,0,1,1
-3,-14,11,1,1,0
6,-13,19,1,1,0
-50,-30,-20,0,0,0
-17,0,-17,0,0,0
-8,11,-19,0,0,0
20,34,-14,0,0,0
-28,-32,4,1,0,1
-15,-30,15,1,0,1
-35,-17,-18,0,0,0
9,23,-14,0,0,0
33,22,11,1,0,1
28,11,17,1,0,1
4,6,-2,0,0,0
54,41,13,1,0,1
-14,-4,-10,0,1,1
-8,-7,-1,0,1,1
-22,-23,1,1,1,0
-35,-34,-1,0,1,1
-48,-38,-10,0,1,1
31,30,1,1,1,0
-5,11,-16,0,1,1
-45,-38,-7,0,1,1
-30,-12,-18,0,1,1
-8,-28,20,1,1,0
6,0,6,1,1,0
4,-3,7,1,1,0
-36,-33,-3,0,1,1
44,37,7,1,1,0
-37,-26,-11,0,1,1
-40,-42,2,1,1,0
-34,-36,2,1,1,0
-19,-20,1,1,0,1
30,10,20,1,0,1
14,4,10,1,0,1
5,16,-11,0,0,0
30,43,-13,0,0,0
-60,-41,-19,0,0,0
-20,-20,0,0,0,0
-9,9,-18,0,0,0
-25,-19,-6,0,0,0
-41,-44,3,1,0,1
18,36,-18,0,0,0
8,8,0,0,0,0
40,30,10,1,0,1
-4,-17,13,1,0,1
5,-14,19,1,0,1
-16,-25,9,1,0,1
22,21,1,1,0,1
19,25,-6,0,0,0
-1,9,-10,0,0,0
54,39,15,1,0,1
-41,-45,4,1,0,1
33,17,16,1,1,0
-1,5,-6,0,1,1
20,16,4,1,1,0
6,6,0,0,1,1
28,12,16,1,1,0
51,43,8,1,1,0
57,43,14,1,1,0
-47,-31,-16,0,1,1
-25,-43,18,1,0,1
-60,-40,-20,0,0,0
-30,-44,14,1,0,1
-16,-16,0,0,0,0
16,13,3,1,0,1
4,-11,15,1,0,1
-5,13,-18,0,0,0
-5,7,-12,0,0,0
-6,-15,9,1,0,1
-29,-10,-19,0,0,0
13,30,-17,0,0,0
-25,-13,-12,0,0,0
-21,-2,-19,0,0,0
-33,-17,-16,0,0,0
-44,-39,-5,0,0,0
6,10,-4,0,0,0
-37,-34,-3,0,0,0
-23,-12,-11,0,0,0
-13,-22,9,1,0,1
-42,-32,-10,0,0,0
-44,-25,-19,0,0,0
16,18,-2,0,1,1
7,-3,10,1,1,0
59,40,19,1,1,0
11,31,-20,0,1,1
2,-7,9,1,1,0
-8,11,-19,0,1,1
29,20,9,1,1,0
5,-11,16,1,1,0
17,9,8,1,1,0
33,19,14,1,1,0
-45,-45,0,0,1,1
-44,-28,-16,0,1,1
20,20,0,0,1,1
-28,-27,-1,0,1,1
-19,-2,-17,0,1,1
-25,-45,20,1,1,0
-24,-29,5,1,0,1
26,42,-16,0,0,0
34,16,18,1,0,1
-3,-17,14,1,0,1
-15,-8,-7,0,0,0
-32,-32,0,0,0,0
-36,-45,9,1,0,1
16,29,-13,0,0,0
-4,-15,11,1,0,1
2,1,1,1,0,1
-13,-19,6,1,0,1
-21,-7,-14,0,0,0
14,6,8,1,0,1
17,8,9,1,1,0
-4,-12,8,1,1,0
7,-8,15,1,1,0
-32,-28,-4,0,1,1
-20,-13,-7,0,1,1
-43,-37,-6,0,1,1
20,33,-13,0,1,1
-14,-13,-1,0,1,1
1,14,-13,0,1,1
42,44,-2,0,1,1
12,22,-10,0,1,1
-6,13,-19,0,1,1
32,25,7,1,1,0
-39,-33,-6,0,1,1
-4,6,-10,0,1,1
-60,-45,-15,0,1,1
-43,-23,-20,0,1,1
-1,11,-12,0,1,1
2,5,-3,0,1,1
9,6,3,1,1,0
-10,-19,9,1,1,0
15,19,-4,0,0,0
-8,-18,10,1,0,1
-56,-39,-17,0,0,0
-28,-14,-14,0,0,0
18,27,-9,0,0,0
7,-7,14,1,0,1
-60,-42,-18,0,0,0
-5,1,-6,0,0,0
-11,9,-20,0,0,0
26,22,4,1,0,1
-8,-28,20,1,0,1
-32,-37,5,1,0,1
-23,-4,-19,0,0,0
-48,-33,-15,0,0,0
10,11,-1,0,0,0
55,41,14,1,0,1
23,32,-9,0,0,0
14,32,-18,0,0,0
-35,-27,-8,0,0,0
20,28,-8,0,0,0
-28,-30,2,1,0,1
13,29,-16,0,1,1
-12,-29,17,1,1,0
44,39,5,1,1,0
3,-10,13,1,1,0
-1,13,-14,0,1,1
35,21,14,1,1,0
11,19,-8,0,1,1
-50,-42,-8,0,1,1
-46,-28,-18,0,1,1
32,28,4,1,0,1
8,-1,9,1,0,1
30,17,13,1,0,1
-26,-23,-3,0,0,0
-18,-38,20,1,0,1
8,27,-19,0,0,0
35,44,-9,0,0,0
49,41,8,1,0,1
-20,-22,2,1,0,1
-18,-16,-2,0,0,0
-11,-19,8,1,0,1
12,5,7,1,0,1
-33,-39,6,1,0,1
8,19,-11,0,0,0
37,21,16,1,0,1
-1,0,-1,0,0,0
-40,-31,-9,0,0,0
22,19,3,1,0,1
-11,-25,14,1,0,1
-55,-38,-17,0,0,0
-24,-23,-1,0,0,0
32,20,12,1,1,0
26,10,16,1,1,0
-18,-26,8,1,1,0
47,43,4,1,1,0
9,18,-9,0,1,1
-40,-32,-8,0,1,1
-26,-28,2,1,1,0
24,20,4,1,1,0
-29,-31,2,1,1,0
2,2,0,0,1,1
16,15,1,1,1,0
-29,-10,-19,0,1,1
-29,-30,1,1,1,0
46,32,14,1,1,0
-46,-37,-9,0,1,1
-33,-33,0,0,1,1
-34,-30,-4,0,0,0
49,41,8,1,0,1
-49,-36,-13,0,0,0
15,14,1,1,0,1
-37,-26,-11,0,0,0
45,27,18,1,0,1
-12,3,-15,0,0,0
5,-15,20,1,0,1
-9,7,-16,0,0,0
-31,-33,2,1,0,1
-7,-10,3,1,1,0
35,35,0,0,1,1
-10,-15,5,1,1,0
10,-6,16,1,1,0
59,40,19,1,1,0
12,3,9,1,1,0
13,5,8,1,1,0
47,41,6,1,1,0
-13,5,-18,0,1,1
-20,0,-20,0,1,1
25,36,-11,0,1,1
3,-13,16,1,1,0
24,5,19,1,1,0
0,8,-8,0,1,1
2,1,1,1,1,0
15,27,-12,0,0,0
39,40,-1,0,0,0
10,9,1,1,0,1
-3,3,-6,0,0,0
-30,-14,-16,0,0,0
3,21,-18,0,0,0
-17,-28,11,1,0,1
-4,-18,14,1,0,1
13,-2,15,1,0,1
-17,-35,18,1,0,1
33,17,16,1,0,1
14,26,-12,0,0,0
-19,-23,4,1,0,1
-7,11,-18,0,0,0
-2,-16,14,1,0,1
-20,-10,-10,0,0,0
10,-3,13,1,0,1
39,25,14,1,0,1
-7,-4,-3,0,0,0
10,28,-18,0,1,1
11,21,-10,0,1,1
3,23,-20,0,1,1
35,23,12,1,1,0
26,33,-7,0,1,1
38,44,-6,0,1,1
6,-5,11,1,1,0
-33,-31,-2,0,1,1
-14,-15,1,1,1,0
52,38,14,1,1,0
-27,-45,18,1,1,0
40,43,-3,0,1,1
-16,-7,-9,0,1,1
1,5,-4,0,1,1
-5,-7,2,1,1,0
-21,-37,16,1,1,0
31,11,20,1,1,0
49,42,7,1,1,0
-21,-39,18,1,1,0
-54,-34,-20,0,1,1
-23,-8,-15,0,1,1
-37,-24,-13,0,0,0
39,35,4,1,0,1
19,24,-5,0,0,0
6,10,-4,0,0,0
12,10,2,1,0,1
15,28,-13,0,0,0
-2,2,-4,0,0,0
-50,-35,-15,0,0,0
18,15,3,1,0,1
12,29,-17,0,0,0
-13,-33,20,1,1,0
-4,-4,0,0,1,1
14,33,-19,0,1,1
-33,-28,-5,0,1,1
2,4,-2,0,1,1
-25,-42,17,1,1,0
25,14,11,1,1,0
53,38,15,1,1,0
0,-11,11,1,1,0
50,44,6,1,1,0
33,41,-8,0,1,1
56,41,15,1,1,0
32,17,15,1,1,0
24,41,-17,0,1,1
-9,-16,7,1,1,0
-7,-17,10,1,1,0
8,16,-8,0,1,1
13,-5,18,1,1,0
-30,-31,1,1,1,0
26,10,16,1,1,0
19,22,-3,0,1,1
-52,-42,-10,0,0,0
-40,-20,-20,0,0,0
-33,-25,-8,0,0,0
52,35,17,1,0,1
53,36,17,1,0,1
0,-16,16,1,0,1
0,-15,15,1,0,1
48,30,18,1,0,1
-57,-45,-12,0,0,0
-10,2,-12,0,0,0
-15,-28,13,1,0,1
46,27,19,1,0,1
-4,-12,8,1,0,1
19,13,6,1,0,1
-32,-21,-11,0,0,0
11,12,-1,0,0,0
52,43,9,1,0,1
4,22,-18,0,0,0
-48,-43,-5,0,0,0
27,21,6,1,0,1
-6,-13,7,1,0,1
-1,-3,2,1,1,0
13,11,2,1,1,0
14,33,-19,0,1,1
-12,-11,-1,0,1,1
-20,-3,-17,0,1,1
26,37,-11,0,1,1
-21,-8,-13,0,1,1
-51,-31,-20,0,1,1
-17,3,-20,0,1,1
-41,-23,-18,0,1,1
-33,-39,6,1,1,0
-16,-16,0,0,1,1
-45,-29,-16,0,1,1
-16,-34,18,1,1,0
22,15,7,1,1,0
-45,-25,-20,0,1,1
-24,-20,-4,0,1,1
27,32,-5,0,1,1
-22,-40,18,1,1,0
-46,-42,-4,0,1,1
-22,-24,2,1,1,0
20,16,4,1,0,1
46,30,16,1,0,1
-40,-40,0,0,0,0
38,25,13,1,0,1
23,33,-10,0,0,0
-5,12,-17,0,0,0
-26,-30,4,1,0,1
-25,-19,-6,0,0,0
-30,-37,7,1,0,1
46,28,18,1,0,1
41,36,5,1,0,1
-1,-7,6,1,0,1
-28,-25,-3,0,0,0
39,27,12,1,0,1
-11,-6,-5,0,0,0
9,19,-10,0,0,0
28,27,1,1,0,1
26,11,15,1,0,1
23,41,-18,0,0,0
59,39,20,1,0,1
-1,-16,15,1,0,1
39,31,8,1,1,0
5,21,-16,0,1,1
-31,-43,12,1,1,0
6,-6,12,1,1,0
-8,7,-15,0,1,1
-31,-44,13,1,1,0
-30,-19,-11,0,1,1
40,36,4,1,1,0
33,27,6,1,1,0
16,10,6,1,0,1
43,39,4,1,0,1
-33,-23,-10,0,0,0
-31,-20,-11,0,0,0
47,31,16,1,0,1
23,7,16,1,0,1
-22,-38,16,1,0,1
-34,-16,-18,0,0,0
-20,-33,13,1,0,1
-52,-39,-13,0,0,0
-1,5,-6,0,0,0
-38,-18,-20,0,0,0
16,4,12,1,0,1
-10,-23,13,1,0,1
47,28,19,1,0,1
-2,16,-18,0,0,0
-5,-14,9,1,0,1
45,44,1,1,0,1
43,43,0,0,0,0
-6,-24,18,1,1,0
1,-16,17,1,1,0
-14,5,-19,0,1,1
-6,-19,13,1,1,0
-4,16,-20,0,1,1
-23,-19,-4,0,1,1
-5,-11,6,1,1,0
39,35,4,1,1,0
33,40,-7,0,1,1
17,20,-3,0,1,1
-14,-25,11,1,1,0
4,-16,20,1,1,0
-10,-1,-9,0,1,1
-33,-41,8,1,1,0
24,25,-1,0,1,1
34,30,4,1,1,0
-2,-8,6,1,1,0
-44,-33,-11,0,1,1
2,-7,9,1,1,0
-33,-20,-13,0,1,1
32,25,7,1,1,0
27,32,-5,0,0,0
-6,10,-16,0,0,0
-29,-21,-8,0,0,0
-30,-13,-17,0,0,0
-2,6,-8,0,0,0
-25,-31,6,1,0,1
-54,-44,-10,0,0,0
-22,-7,-15,0,0,0
-19,-24,5,1,0,1
29,29,0,0,0,0
-27,-36,9,1,0,1
5,-15,20,1,0,1
-2,12,-14,0,0,0
1,19,-18,0,0,0
5,-1,6,1,0,1
-32,-45,13,1,0,1
29,39,-10,0,0,0
-47,-42,-5,0,0,0
9,22,-13,0,0,0
-37,-25,-12,0,0,0
-24,-4,-20,0,0,0
-8,-8,0,0,1,1
20,9,11,1,1,0
19,31,-12,0,1,1
-27,-41,14,1,1,0
-9,-3,-6,0,1,1
48,43,5,1,1,0
16,21,-5,0,1,1
-46,-32,-14,0,1,1
-49,-44,-5,0,1,1
-41,-37,-4,0,1,1
-37,-30,-7,0,0,0
9,8,1,1,0,1
-6,3,-9,0,0,0
27,36,-9,0,0,0
45,44,1,1,0,1
27,15,12,1,0,1
-34,-26,-8,0,0,0
-1,-12,11,1,0,1
-54,-35,-19,0,1,1
-13,3,-16,0,1,1
-39,-19,-20,0,1,1
33,16,17,1,1,0
2,-3,5,1,1,0
-14,3,-17,0,1,1
8,3,5,1,1,0
38,32,6,1,1,0
22,29,-7,0,1,1
-5,-24,19,1,1,0
12,23,-11,0,0,0
3,-3,6,1,0,1
-13,-24,11,1,0,1
-32,-36,4,1,0,1
56,43,13,1,0,1
-25,-45,20,1,0,1
7,-6,13,1,0,1
-7,-26,19,1,0,1
34,39,-5,0,0,0
43,28,15,1,0,1
-8,-27,19,1,0,1
-42,-27,-15,0,0,0
-1,17,-18,0,0,0
4,-13,17,1,0,1
32,41,-9,0,0,0
28,20,8,1,0,1
36,36,0,0,0,0
-21,-6,-15,0,0,0
46,42,4,1,0,1
-7,10,-17,0,0,0
16,11,5,1,0,1
12,10,2,1,1,0
12,27,-15,0,1,1
10,23,-13,0,1,1
-7,-23,16,1,1,0
26,15,11,1,1,0
32,30,2,1,1,0
-51,-37,-14,0,1,1
13,26,-13,0,1,1
-33,-44,11,1,1,0
51,44,7,1,1,0
53,40,13,1,1,0
-12,-17,5,1,1,0
10,-5,15,1,0,1
-30,-16,-14,0,0,0
-31,-43,12,1,0,1
49,37,12,1,0,1
25,7,18,1,0,1
28,44,-16,0,0,0
17,2,15,1,0,1
41,31,10,1,0,1
5,-9,14,1,0,1
-36,-20,-16,0,0,0
26,13,13,1,0,1
13,27,-14,0,0,0
-9,-17,8,1,0,1
-5,-17,12,1,0,1
27,33,-6,0,0,0
10,4,6,1,0,1
30,17,13,1,1,0
-6,-1,-5,0,1,1
-30,-39,9,1,1,0
-50,-35,-15,0,1,1
-36,-33,-3,0,1,1
25,33,-8,0,1,1
-21,-8,-13,0,1,1
2,19,-17,0,1,1
-23,-35,12,1,0,1
-7,7,-14,0,0,0
17,33,-16,0,0,0
32,27,5,1,0,1
22,38,-16,0,0,0
-27,-44,17,1,0,1
33,38,-5,0,0,0
-48,-32,-16,0,0,0
38,20,18,1,0,1
-1,-9,8,1,1,0
-39,-33,-6,0,1,1
49,41,8,1,1,0
-34,-14,-20,0,1,1
11,6,5,1,1,0
-31,-35,4,1,1,0
25,37,-12,0,1,1
7,-2,9,1,1,0
1,5,-4,0,0,0
-29,-29,0,0,0,0
-25,-17,-8,0,0,0
-10,-5,-5,0,0,0
-58,-40,-18,0,0,0
-6,-10,4,1,0,1
41,42,-1,0,0,0
-14,-29,15,1,0,1
40,36,4,1,0,1
-24,-15,-9,0,0,0
-27,-7,-20,0,0,0
33,34,-1,0,0,0
3,-15,18,1,0,1
32,31,1,1,0,1
-32,-25,-7,0,0,0
23,36,-13,0,0,0
6,18,-12,0,0,0
-10,5,-15,0,0,0
-15,-33,18,1,0,1
-31,-44,13,1,0,1
0,-14,14,1,0,1
17,32,-15,0,1,1
13,-5,18,1,1,0
10,16,-6,0,1,1
-23,-26,3,1,1,0
-40,-23,-17,0,1,1
11,-8,19,1,1,0
57,41,16,1,1,0
57,38,19,1,1,0
-33,-29,-4,0,1,1
32,32,0,0,1,1
-42,-28,-14,0,0,0
-14,2,-16,0,0,0
-35,-35,0,0,0,0
36,19,17,1,0,1
-17,2,-19,0,0,0
-51,-36,-15,0,0,0
-38,-38,0,0,0,0
-20,-19,-1,0,0,0
-43,-25,-18,0,0,0
7,20,-13,0,0,0
39,38,1,1,0,1
-19,-14,-5,0,0,0
53,44,9,1,1,0
14,29,-15,0,1,1
26,30,-4,0,1,1
-41,-28,-13,0,1,1
5,-6,11,1,1,0
-8,-16,8,1,1,0
-53,-41,-12,0,1,1
40,41,-1,0,1,1
42,37,5,1,1,0
-5,11,-16,0,1,1
41,30,11,1,1,0
-31,-26,-5,0,1,1
34,39,-5,0,1,1
-30,-23,-7,0,1,1
-6,-10,4,1,1,0
-10,-7,-3,0,1,1
-7,-27,20,1,1,0
14,6,8,1,1,0
5,16,-11,0,1,1
-31,-25,-6,0,0,0
9,9,0,0,0,0
-59,-41,-18,0,0,0
3,1,2,1,0,1
-47,-42,-5,0,0,0
31,24,7,1,0,1
21,29,-8,0,0,0
-45,-32,-13,0,0,0
5,22,-17,0,0,0
-40,-34,-6,0,0,0
-18,-15,-3,0,0,0
-45,-30,-15,0,0,0
-14,2,-16,0,0,0
56,36,20,1,0,1
44,34,10,1,0,1
-24,-25,1,1,0,1
-30,-24,-6,0,0,0
18,2,16,1,0,1
-3,-4,1,1,0,1
-4,-12,8,1,0,1
34,40,-6,0,1,1
50,35,15,1,1,0
17,8,9,1,1,0
-19,-4,-15,0,1,1
23,12,11,1,1,0
3,10,-7,0,1,1
-40,-29,-11,0,1,1
8,27,-19,0,1,1
-7,-4,-3,0,1,1
14,10,4,1,0,1
-4,11,-15,0,0,0
18,5,13,1,0,1
-16,-34,18,1,0,1
-17,-3,-14,0,0,0
5,8,-3,0,0,0
-11,-21,10,1,0,1
-9,-10,1,1,0,1
-3,11,-14,0,0,0
-11,4,-15,0,0,0
-20,-26,6,1,0,1
-14,-1,-13,0,0,0
33,14,19,1,0,1
-40,-44,4,1,0,1
-30,-23,-7,0,0,0
-10,-18,8,1,0,1
44,39,5,1,0,1
-17,-34,17,1,1,0
-51,-36,-15,0,1,1
-9,-28,19,1,1,0
-38,-36,-2,0,1,1
-21,-34,13,1,1,0
25,26,-1,0,1,1
-36,-29,-7,0,1,1
1,4,-3,0,1,1
-40,-23,-17,0,1,1
-6,-9,3,1,1,0
-13,0,-13,0,1,1
0,-6,6,1,0,1
-13,-33,20,1,0,1
-30,-43,13,1,0,1
0,3,-3,0,0,0
-12,-4,-8,0,0,0
26,16,10,1,0,1
32,17,15,1,0,1
-1,-6,5,1,0,1
28,9,19,1,0,1
11,7,4,1,0,1
18,35,-17,0,0,0
-2,4,-6,0,1,1
37,34,3,1,1,0
37,44,-7,0,1,1
-30,-37,7,1,1,0
-41,-29,-12,0,1,1
-35,-31,-4,0,1,1
43,35,8,1,1,0
-37,-20,-17,0,1,1
16,6,10,1,1,0
6,17,-11,0,1,1
19,17,2,1,1,0
-13,5,-18,0,1,1
-9,-24,15,1,1,0
-7,-11,4,1,1,0
31,42,-11,0,1,1
10,21,-11,0,1,1
35,27,8,1,1,0
-3,-6,3,1,1,0
11,-1,12,1,1,0
-42,-30,-12,0,1,1
45,43,2,1,1,0
-21,-10,-11,0,0,0
43,42,1,1,0,1
-5,-19,14,1,0,1
17,15,2,1,0,1
-4,3,-7,0,0,0
-43,-33,-10,0,0,0
24,14,10,1,0,1
-30,-41,11,1,0,1
25,5,20,1,0,1
-48,-30,-18,0,0,0
9,8,1,1,0,1
-28,-26,-2,0,0,0
-17,-27,10,1,0,1
-57,-41,-16,0,0,0
-9,-4,-5,0,0,0
2,22,-20,0,0,0
8,9,-1,0,0,0
-42,-40,-2,0,0,0
-8,-28,20,1,0,1
33,22,11,1,0,1
28,11,17,1,0,1
13,-3,16,1,1,0
36,32,4,1,1,0
42,41,1,1,1,0
-42,-30,-12,0,1,1
-37,-44,7,1,1,0
-26,-29,3,1,1,0
-7,-4,-3,0,1,1
17,20,-3,0,1,1
-34,-17,-17,0,1,1
42,26,16,1,1,0
17,12,5,1,1,0
31,36,-5,0,1,1
4,-7,11,1,1,0
-7,-18,11,1,1,0
1,15,-14,0,1,1
-45,-42,-3,0,1,1
-41,-39,-2,0,1,1
61,41,20,1,1,0
57,43,14,1,0,1
-31,-23,-8,0,0,0
25,34,-9,0,0,0
-14,-21,7,1,0,1
17,4,13,1,0,1
12,19,-7,0,0,0
21,29,-8,0,0,0
18,27,-9,0,0,0
-37,-43,6,1,0,1
44,33,11,1,0,1
-51,-39,-12,0,0,0
40,28,12,1,0,1
-53,-44,-9,0,0,0
3,-10,13,1,0,1
-29,-12,-17,0,0,0
-8,-12,4,1,0,1
30,28,2,1,1,0
-30,-21,-9,0,1,1
-39,-33,-6,0,1,1
9,5,4,1,1,0
-49,-31,-18,0,1,1
43,30,13,1,1,0
-26,-26,0,0,1,1
7,11,-4,0,1,1
17,21,-4,0,0,0
-12,-1,-11,0,0,0
-34,-41,7,1,0,1
20,26,-6,0,0,0
-12,-31,19,1,0,1
29,25,4,1,0,1
-34,-23,-11,0,0,0
-48,-36,-12,0,0,0
23,8,15,1,0,1
23,10,13,1,0,1
-16,-35,19,1,0,1
28,42,-14,0,0,0
39,24,15,1,0,1
-8,-11,3,1,0,1
-18,-25,7,1,0,1
-11,-14,3,1,0,1
15,29,-14,0,0,0
-28,-9,-19,0,0,0
20,33,-13,0,0,0
-40,-41,1,1,0,1
30,16,14,1,0,1
-35,-15,-20,0,1,1
-17,-19,2,1,1,0
5,22,-17,0,1,1
-45,-30,-15,0,1,1
-3,3,-6,0,1,1
-14,-23,9,1,1,0
34,17,17,1,1,0
5,-13,18,1,1,0
20,39,-19,0,0,0
45,41,4,1,0,1
-51,-45,-6,0,0,0
-29,-16,-13,0,0,0
7,18,-11,0,0,0
-42,-34,-8,0,0,0
-1,-12,11,1,0,1
27,38,-11,0,0,0
-34,-14,-20,0,1,1
-5,-21,16,1,1,0
0,-11,11,1,1,0
-62,-43,-19,0,1,1
-18,-17,-1,0,1,1
31,24,7,1,1,0
32,43,-11,0,1,1
-5,10,-15,0,1,1
37,29,8,1,1,0
-19,-19,0,0,1,1
-31,-38,7,1,1,0
28,44,-16,0,1,1
42,40,2,1,1,0
-22,-11,-11,0,1,1
-5,-9,4,1,1,0
-21,-13,-8,0,1,1
36,25,11,1,1,0
30,41,-11,0,1,1
8,-8,16,1,1,0
36,23,13,1,1,0
35,37,-2,0,1,1
-35,-30,-5,0,0,0
8,-11,19,1,0,1
-9,8,-17,0,0,0
35,28,7,1,0,1
22,12,10,1,0,1
-9,-21,12,1,0,1
-29,-45,16,1,0,1
31,36,-5,0,0,0
-11,-29,18,1,0,1
46,41,5,1,0,1
28,11,17,1,0,1
-3,4,-7,0,1,1
13,6,7,1,1,0
-56,-42,-14,0,1,1
-28,-43,15,1,1,0
11,14,-3,0,1,1
9,-11,20,1,1,0
30,19,11,1,1,0
-31,-19,-12,0,1,1
35,36,-1,0,1,1
9,18,-9,0,1,1
16,-1,17,1,1,0
-37,-30,-7,0,0,0
-46,-45,-1,0,0,0
-29,-26,-3,0,0,0
-6,-8,2,1,0,1
30,21,9,1,0,1
16,4,12,1,0,1
-40,-29,-11,0,0,0
-13,-20,7,1,0,1
32,39,-7,0,0,0
-41,-29,-12,0,0,0
-35,-22,-13,0,0,0
14,-2,16,1,0,1
-9,7,-16,0,0,0
-40,-25,-15,0,0,0
26,21,5,1,0,1
0,9,-9,0,0,0
-24,-29,5,1,0,1
11,10,1,1,0,1
-10,-27,17,1,0,1
22,31,-9,0,0,0
16,8,8,1,0,1
-22,-23,1,1,1,0
-34,-45,11,1,1,0
-47,-45,-2,0,1,1
-36,-25,-11,0,1,1
-25,-37,12,1,1,0
-54,-42,-12,0,1,1
-31,-20,-11,0,1,1
23,25,-2,0,1,1
29,9,20,1,0,1
-26,-13,-13,0,0,0
-46,-34,-12,0,0,0
1,17,-16,0,0,0
-21,-28,7,1,0,1
37,36,1,1,0,1
-17,-17,0,0,0,0
14,32,-18,0,0,0
26,44,-18,0,0,0
-13,7,-20,0,0,0
16,3,13,1,0,1
-32,-36,4,1,0,1
21,35,-14,0,0,0
8,7,1,1,0,1
-24,-41,17,1,1,0
15,27,-12,0,1,1
-24,-9,-15,0,1,1
1,-9,10,1,1,0
-22,-14,-8,0,1,1
-6,-19,13,1,1,0
-29,-13,-16,0,1,1
25,9,16,1,1,0
-42,-40,-2,0,1,1
-4,-22,18,1,1,0
-38,-22,-16,0,1,1
48,34,14,1,1,0
-23,-19,-4,0,1,1
-41,-40,-1,0,1,1
39,23,16,1,1,0
23,43,-20,0,1,1
26,11,15,1,1,0
41,27,14,1,1,0
45,37,8,1,1,0
39,30,9,1,0,1
-16,-36,20,1,0,1
-27,-33,6,1,0,1
-10,-30,20,1,0,1
-33,-17,-16,0,0,0
-9,4,-13,0,0,0
46,26,20,1,0,1
33,34,-1,0,0,0
-15,-3,-12,0,0,0
-13,-22,9,1,0,1
-16,-16,0,0,1,1
28,30,-2,0,1,1
-51,-43,-8,0,1,1
19,19,0,0,1,1
10,6,4,1,1,0
-18,-8,-10,0,1,1
-16,-1,-15,0,1,1
16,32,-16,0,1,1
-61,-42,-19,0,1,1
-64,-44,-20,0,1,1
15,3,12,1,1,0
-22,-15,-7,0,1,1
-17,-20,3,1,1,0
15,21,-6,0,1,1
-35,-15,-20,0,1,1
-9,-17,8,1,1,0
-10,-23,13,1,1,0
-14,-13,-1,0,1,1
-12,8,-20,0,1,1
45,27,18,1,1,0
8,3,5,1,1,0
-11,7,-18,0,0,0
-30,-26,-4,0,0,0
16,11,5,1,0,1
-42,-28,-14,0,0,0
13,12,1,1,0,1
29,16,13,1,0,1
-36,-35,-1,0,0,0
21,23,-2,0,0,0
-25,-37,12,1,0,1
-36,-28,-8,0,0,0
-26,-17,-9,0,0,0
-22,-34,12,1,0,1
46,31,15,1,1,0
-56,-36,-20,0,1,1
2,17,-15,0,1,1
-17,-1,-16,0,1,1
-33,-25,-8,0,1,1
31,28,3,1,1,0
18,38,-20,0,1,1
3,-14,17,1,1,0
5,-8,13,1,1,0
-26,-7,-19,0,1,1
-5,10,-15,0,1,1
-15,0,-15,0,1,1
21,38,-17,0,1,1
-61,-44,-17,0,1,1
41,24,17,1,1,0
26,42,-16,0,1,1
-11,-1,-10,0,1,1
38,34,4,1,1,0
-42,-33,-9,0,1,1
-23,-6,-17,0,1,1
-15,-20,5,1,1,0
17,2,15,1,0,1
-21,-18,-3,0,0,0
32,17,15,1,0,1
-15,-5,-10,0,0,0
-17,-25,8,1,0,1
-5,-2,-3,0,0,0
4,-4,8,1,0,1
11,-8,19,1,0,1
35,17,18,1,0,1
45,43,2,1,0,1
-34,-41,7,1,0,1
-41,-26,-15,0,0,0
-48,-38,-10,0,0,0
-21,-35,14,1,1,0
-3,17,-20,0,1,1
15,29,-14,0,1,1
-21,-6,-15,0,1,1
-8,4,-12,0,1,1
17,28,-11,0,1,1
-47,-35,-12,0,1,1
1,-4,5,1,1,0
-38,-42,4,1,1,0
18,20,-2,0,1,1
-4,7,-11,0,1,1
-22,-36,14,1,1,0
44,35,9,1,0,1
-14,-5,-9,0,0,0
-39,-35,-4,0,0,0
-43,-38,-5,0,0,0
16,33,-17,0,0,0
2,20,-18,0,0,0
18,16,2,1,0,1
54,37,17,1,0,1
41,42,-1,0,0,0
-52,-42,-10,0,0,0
18,14,4,1,1,0
50,40,10,1,1,0
-7,-14,7,1,1,0
17,21,-4,0,1,1
41,35,6,1,1,0
-63,-45,-18,0,1,1
5,23,-18,0,1,1
12,2,10,1,1,0
-50,-37,-13,0,1,1
19,12,7,1,1,0
-3,17,-20,0,1,1
10,-5,15,1,1,0
-36,-21,-15,0,1,1
15,-1,16,1,1,0
-24,-22,-2,0,1,1
-46,-38,-8,0,1,1
26,10,16,1,1,0
-15,-8,-7,0,1,1
-35,-24,-11,0,1,1
-35,-30,-5,0,1,1
50,40,10,1,1,0
19,24,-5,0,0,0
28,22,6,1,0,1
-34,-45,11,1,0,1
6,12,-6,0,0,0
23,26,-3,0,0,0
-2,-9,7,1,0,1
-44,-37,-7,0,0,0
-1,-12,11,1,0,1
12,22,-10,0,0,0
8,20,-12,0,0,0
-20,-33,13,1,0,1
33,41,-8,0,1,1
-12,5,-17,0,1,1
32,26,6,1,1,0
43,40,3,1,1,0
-27,-7,-20,0,1,1
-31,-12,-19,0,1,1
-16,-29,13,1,1,0
-18,-17,-1,0,1,1
47,28,19,1,1,0
6,26,-20,0,1,1
-16,-22,6,1,1,0
-2,6,-8,0,1,1
-47,-36,-11,0,1,1
31,20,11,1,1,0
26,26,0,0,1,1
42,32,10,1,1,0
38,21,17,1,1,0
-27,-13,-14,0,1,1
-34,-29,-5,0,0,0
-12,-12,0,0,0,0
20,21,-1,0,0,0
14,34,-20,0,0,0
3,17,-14,0,0,0
-9,2,-11,0,0,0
-4,-4,0,0,0,0
-30,-18,-12,0,0,0
-30,-20,-10,0,1,1
23,31,-8,0,1,1
23,37,-14,0,1,1
22,30,-8,0,1,1
8,10,-2,0,1,1
30,25,5,1,1,0
17,22,-5,0,1,1
-20,-11,-9,0,1,1
6,19,-13,0,1,1
-4,-18,14,1,1,0
-9,-25,16,1,1,0
6,-7,13,1,1,0
-58,-40,-18,0,0,0
24,26,-2,0,0,0
18,37,-19,0,0,0
-32,-44,12,1,0,1
-31,-37,6,1,0,1
37,40,-3,0,0,0
10,22,-12,0,0,0
31,31,0,0,0,0
-4,-19,15,1,0,1
-11,-5,-6,0,0,0
6,9,-3,0,0,0
36,38,-2,0,0,0
-10,2,-12,0,0,0
15,14,1,1,1,0
-20,-29,9,1,1,0
29,44,-15,0,1,1
22,6,16,1,1,0
11,3,8,1,1,0
-10,-4,-6,0,1,1
1,19,-18,0,1,1
24,40,-16,0,1,1
1,-18,19,1,0,1
27,19,8,1,0,1
-34,-44,10,1,0,1
2,-7,9,1,0,1
43,23,20,1,0,1
-33,-29,-4,0,0,0
33,34,-1,0,0,0
-28,-28,0,0,0,0
-10,3,-13,0,0,0
-33,-35,2,1,0,1
-20,-35,15,1,0,1
-8,-5,-3,0,0,0
34,24,10,1,0,1
48,35,13,1,0,1
-44,-42,-2,0,0,0
-41,-27,-14,0,0,0
-24,-38,14,1,0,1
-36,-41,5,1,0,1
23,6,17,1,0,1
-17,3,-20,0,1,1
-10,1,-11,0,1,1
-31,-42,11,1,1,0
28,28,0,0,1,1
12,-5,17,1,1,0
-31,-19,-12,0,1,1
12,-1,13,1,1,0
-26,-44,18,1,1,0
20,34,-14,0,1,1
-25,-10,-15,0,1,1
-21,-20,-1,0,1,1
18,23,-5,0,1,1
39,27,12,1,1,0
-10,5,-15,0,1,1
22,41,-19,0,1,1
28,13,15,1,1,0
-34,-26,-8,0,0,0
20,11,9,1,0,1
-31,-36,5,1,0,1
-35,-44,9,1,0,1
1,-9,10,1,0,1
-14,1,-15,0,0,0
38,44,-6,0,0,0
-30,-37,7,1,0,1
35,19,16,1,0,1
6,-2,8,1,0,1
-28,-16,-12,0,0,0
5,-9,14,1,0,1
8,21,-13,0,0,0
27,11,16,1,0,1
30,27,3,1,0,1
19,12,7,1,0,1
27,27,0,0,0,0
12,29,-17,0,0,0
17,33,-16,0,0,0
18,31,-13,0,0,0
20,19,1,1,0,1
6,11,-5,0,1,1
15,12,3,1,1,0
11,2,9,1,1,0
1,-11,12,1,1,0
54,39,15,1,1,0
-4,-22,18,1,1,0
0,17,-17,0,1,1
-55,-38,-17,0,1,1
-42,-36,-6,0,1,1
-37,-21,-16,0,1,1
-11,-12,1,1,1,0
-19,-37,18,1,1,0
-18,-19,1,1,1,0
48,35,13,1,1,0
27,20,7,1,1,0
10,-1,11,1,1,0
-31,-24,-7,0,1,1
-39,-32,-7,0,1,1
21,2,19,1,1,0
-11,-14,3,1,1,0
-19,0,-19,0,1,1
-23,-36,13,1,0,1
-44,-33,-11,0,0,0
-8,-2,-6,0,0,0
-16,-26,10,1,0,1
26,9,17,1,0,1
10,10,0,0,0,0
-32,-33,1,1,0,1
43,23,20,1,0,1
-20,-8,-12,0,0,0
-40,-24,-16,0,0,0
-3,-7,4,1,1,0
49,34,15,1,1,0
-5,-25,20,1,1,0
40,31,9,1,1,0
-7,-27,20,1,1,0
-17,-17,0,0,1,1
18,14,4,1,1,0
-42,-30,-12,0,1,1
-50,-30,-20,0,1,1
-6,4,-10,0,1,1
3,3,0,0,1,1
23,30,-7,0,0,0
26,43,-17,0,0,0
-8,5,-13,0,0,0
34,15,19,1,0,1
-23,-20,-3,0,0,0
2,-16,18,1,0,1
-16,-8,-8,0,0,0
-45,-40,-5,0,0,0
6,16,-10,0,0,0
1,18,-17,0,0,0
13,29,-16,0,0,0
13,32,-19,0,0,0
33,17,16,1,0,1
46,36,10,1,0,1
-11,4,-15,0,0,0
32,40,-8,0,0,0
-32,-36,4,1,0,1
-6,0,-6,0,0,0
49,43,6,1,0,1
-10,-26,16,1,0,1
-8,5,-13,0,0,0
-47,-39,-8,0,1,1
-16,-30,14,1,1,0
24,43,-19,0,1,1
-14,-31,17,1,1,0
13,17,-4,0,1,1
-42,-35,-7,0,1,1
-20,-16,-4,0,1,1
-5,-2,-3,0,1,1
21,38,-17,0,1,1
26,43,-17,0,1,1
-24,-36,12,1,1,0
15,22,-7,0,1,1
-11,-23,12,1,1,0
13,-2,15,1,1,0
-33,-44,11,1,1,0
-32,-35,3,1,1,0
-29,-17,-12,0,1,1
-15,-23,8,1,0,1
27,10,17,1,0,1
-50,-30,-20,0,0,0
27,27,0,0,0,0
-11,-29,18,1,0,1
30,43,-13,0,0,0
18,24,-6,0,0,0
-14,-14,0,0,0,0
10,16,-6,0,0,0
9,-10,19,1,0,1
25,33,-8,0,0,0
-28,-25,-3,0,0,0
46,41,5,1,0,1
3,12,-9,0,0,0
32,23,9,1,0,1
44,31,13,1,0,1
-40,-33,-7,0,1,1
20,28,-8,0,1,1
-16,4,-20,0,1,1
18,19,-1,0,1,1
-37,-20,-17,0,1,1
-1,-2,1,1,1,0
24,34,-10,0,1,1
-3,10,-13,0,1,1
-32,-12,-20,0,1,1
-27,-7,-20,0,1,1
-32,-40,8,1,1,0
20,37,-17,0,1,1
29,35,-6,0,1,1
13,8,5,1,1,0
-39,-28,-11,0,1,1
-10,-16,6,1,0,1
46,42,4,1,0,1
31,30,1,1,0,1
34,35,-1,0,0,0
40,28,12,1,0,1
-33,-43,10,1,0,1
-32,-36,4,1,0,1
13,18,-5,0,0,0
10,3,7,1,0,1
31,35,-4,0,0,0
-42,-27,-15,0,0,0
51,34,17,1,0,1
-9,-27,18,1,1,0
21,21,0,0,1,1
-23,-10,-13,0,1,1
-22,-9,-13,0,1,1
39,35,4,1,1,0
-49,-34,-15,0,1,1
11,11,0,0,1,1
62,42,20,1,1,0
-31,-14,-17,0,0,0
14,-1,15,1,0,1
33,27,6,1,0,1
-10,-6,-4,0,0,0
-50,-37,-13,0,0,0
-41,-42,1,1,0,1
-39,-22,-17,0,0,0
-36,-28,-8,0,0,0
8,21,-13,0,0,0
-5,-19,14,1,0,1
-24,-22,-2,0,0,0
27,11,16,1,0,1
-4,-21,17,1,0,1
-58,-44,-14,0,0,0
17,-1,18,1,0,1
39,22,17,1,0,1
-2,14,-16,0,0,0
-8,-20,12,1,0,1
-28,-10,-18,0,0,0
36,27,9,1,0,1
34,20,14,1,0,1
20,33,-13,0,1,1
45,43,2,1,1,0
24,31,-7,0,1,1
41,25,16,1,1,0
-4,-16,12,1,1,0
38,37,1,1,1,0
43,28,15,1,1,0
1,-15,16,1,1,0
4,1,3,1,1,0
-17,-9,-8,0,1,1
-45,-37,-8,0,1,1
19,15,4,1,1,0
-48,-41,-7,0,0,0
7,21,-14,0,0,0
18,24,-6,0,0,0
-12,-5,-7,0,0,0
-20,-24,4,1,0,1
-14,-4,-10,0,0,0
-7,-17,10,1,0,1
46,34,12,1,0,1
-26,-14,-12,0,1,1
27,15,12,1,1,0
-4,-12,8,1,1,0
-25,-33,8,1,1,0
-42,-22,-20,0,1,1
46,30,16,1,1,0
11,9,2,1,1,0
-14,-12,-2,0,1,1
-14,-7,-7,0,1,1
-43,-30,-13,0,1,1
7,-5,12,1,1,0
39,40,-1,0,1,1
-21,-5,-16,0,1,1
-31,-12,-19,0,0,0
-20,-13,-7,0,0,0
20,2,18,1,0,1
27,23,4,1,0,1
-18,-31,13,1,0,1
35,40,-5,0,0,0
-31,-37,6,1,0,1
2,1,1,1,0,1
-26,-34,8,1,0,1
13,20,-7,0,0,0
25,33,-8,0,0,0
-19,-29,10,1,0,1
-21,-34,13,1,0,1
50,34,16,1,0,1
25,41,-16,0,0,0
-17,-28,11,1,0,1
-10,-10,0,0,0,0
-13,-31,18,1,0,1
-16,-18,2,1,0,1
26,31,-5,0,0,0
-43,-38,-5,0,0,0
54,37,17,1,1,0
-31,-26,-5,0,1,1
28,10,18,1,1,0
-52,-35,-17,0,1,1
-39,-19,-20,0,1,1
38,36,2,1,1,0
23,30,-7,0,1,1
10,19,-9,0,1,1
-23,-20,-3,0,1,1
11,-8,19,1,1,0
-23,-16,-7,0,1,1
0,-9,9,1,1,0
17,34,-17,0,1,1
6,18,-12,0,1,1
25,34,-9,0,1,1
-6,-19,13,1,1,0
37,41,-4,0,0,0
4,-16,20,1,0,1
39,23,16,1,0,1
31,14,17,1,0,1
19,30,-11,0,0,0
-4,4,-8,0,0,0
-29,-15,-14,0,0,0
-10,6,-16,0,0,0
7,20,-13,0,0,0
1,21,-20,0,0,0
-22,-8,-14,0,0,0
6,20,-14,0,0,0
-34,-33,-1,0,0,0
-16,-11,-5,0,0,0
26,32,-6,0,0,0
3,3,0,0,0,0
-31,-25,-6,0,0,0
21,19,2,1,0,1
-39,-31,-8,0,0,0
27,40,-13,0,0,0
28,18,10,1,1,0
-54,-37,-17,0,1,1
25,32,-7,0,1,1
-35,-24,-11,0,1,1
-36,-28,-8,0,1,1
3,12,-9,0,1,1
-18,-8,-10,0,1,1
-29,-43,14,1,1,0
-62,-45,-17,0,1,1
54,37,17,1,1,0
-32,-42,10,1,1,0
20,1,19,1,1,0
12,18,-6,0,1,1
-7,-9,2,1,1,0
-13,-4,-9,0,0,0
5,12,-7,0,0,0
2,21,-19,0,0,0
-46,-44,-2,0,0,0
18,32,-14,0,0,0
-3,-13,10,1,0,1
-20,-2,-18,0,0,0
-14,-34,20,1,0,1
51,42,9,1,0,1
-31,-27,-4,0,0,0
-27,-19,-8,0,0,0
19,3,16,1,0,1
4,23,-19,0,0,0
5,3,2,1,0,1
28,31,-3,0,0,0
-47,-37,-10,0,0,0
0,-3,3,1,1,0
-39,-19,-20,0,1,1
-33,-20,-13,0,1,1
-3,7,-10,0,1,1
-24,-8,-16,0,1,1
38,32,6,1,1,0
-22,-15,-7,0,1,1
-14,-15,1,1,1,0
35,35,0,0,1,1
-51,-33,-18,0,1,1
37,26,11,1,1,0
-8,7,-15,0,1,1
-24,-40,16,1,1,0
-4,9,-13,0,1,1
36,38,-2,0,1,1
40,25,15,1,1,0
43,36,7,1,1,0
22,7,15,1,1,0
-5,6,-11,0,1,1
0,16,-16,0,1,1
-18,-32,14,1,1,0
-13,5,-18,0,0,0
-32,-21,-11,0,0,0
-28,-31,3,1,0,1
3,11,-8,0,0,0
-26,-42,16,1,0,1
0,-7,7,1,0,1
24,43,-19,0,0,0
-14,-10,-4,0,0,0
-37,-32,-5,0,0,0
6,-11,17,1,0,1
-23,-16,-7,0,0,0
8,21,-13,0,1,1
3,14,-11,0,1,1
11,12,-1,0,1,1
20,8,12,1,1,0
22,36,-14,0,1,1
35,25,10,1,1,0
-35,-22,-13,0,1,1
34,26,8,1,1,0
-23,-25,2,1,1,0
8,-12,20,1,1,0
27,25,2,1,1,0
-42,-33,-9,0,1,1
-21,-36,15,1,1,0
28,44,-16,0,1,1
1,2,-1,0,1,1
-36,-36,0,0,0,0
-28,-41,13,1,0,1
12,28,-16,0,0,0
-44,-37,-7,0,0,0
-6,-11,5,1,0,1
18,3,15,1,0,1
17,9,8,1,0,1
-58,-38,-20,0,0,0
-21,-9,-12,0,0,0
-62,-42,-20,0,0,0
50,37,13,1,0,1
3,-1,4,1,0,1
43,23,20,1,0,1
22,34,-12,0,0,0
-16,-35,19,1,0,1
-2,-7,5,1,0,1
-21,-37,16,1,0,1
-28,-32,4,1,0,1
0,-19,19,1,0,1
-31,-14,-17,0,0,0
10,13,-3,0,0,0
18,29,-11,0,1,1
14,34,-20,0,1,1
10,20,-10,0,1,1
37,42,-5,0,1,1
-2,-5,3,1,1,0
44,24,20,1,1,0
2,-13,15,1,1,0
-10,8,-18,0,1,1
22,29,-7,0,1,1
-25,-33,8,1,1,0
32,42,-10,0,1,1
-33,-42,9,1,1,0
28,15,13,1,1,0
-9,5,-14,0,1,1
-27,-44,17,1,1,0
29,42,-13,0,1,1
-7,-21,14,1,1,0
-9,11,-20,0,0,0
-38,-43,5,1,0,1
33,44,-11,0,0,0
22,34,-12,0,0,0
-13,-29,16,1,0,1
-7,-25,18,1,0,1
24,8,16,1,0,1
14,18,-4,0,0,0
-53,-45,-8,0,0,0
-20,-16,-4,0,0,0
18,16,2,1,0,1
27,21,6,1,0,1
24,34,-10,0,0,0
6,12,-6,0,0,0
9,-7,16,1,0,1
-23,-27,4,1,0,1
18,15,3,1,0,1
32,12,20,1,0,1
4,10,-6,0,0,0
23,26,-3,0,0,0
-9,10,-19,0,0,0
7,-1,8,1,1,0
-21,-28,7,1,1,0
36,19,17,1,1,0
-26,-44,18,1,1,0
37,36,1,1,1,0
31,36,-5,0,1,1
27,32,-5,0,1,1
31,19,12,1,1,0
16,20,-4,0,1,1
20,2,18,1,1,0
-10,-5,-5,0,1,1
-45,-40,-5,0,1,1
-20,-20,0,0,1,1
3,4,-1,0,1,1
-32,-34,2,1,1,0
28,17,11,1,1,0
-15,-6,-9,0,0,0
-21,-9,-12,0,0,0
21,29,-8,0,0,0
25,40,-15,0,0,0
57,43,14,1,0,1
-13,-21,8,1,0,1
14,4,10,1,0,1
-13,-1,-12,0,0,0
54,38,16,1,0,1
-4,-5,1,1,0,1
-16,-20,4,1,0,1
28,11,17,1,0,1
-33,-24,-9,0,0,0
-8,-8,0,0,0,0
-36,-36,0,0,0,0
27,27,0,0,0,0
-27,-7,-20,0,1,1
4,23,-19,0,1,1
-39,-22,-17,0,1,1
6,-8,14,1,1,0
-55,-35,-20,0,1,1
-24,-18,-6,0,1,1
-24,-12,-12,0,1,1
37,21,16,1,1,0
1,-8,9,1,0,1
11,14,-3,0,0,0
-45,-41,-4,0,0,0
-14,-3,-11,0,0,0
-39,-27,-12,0,0,0
-1,11,-12,0,0,0
-32,-28,-4,0,0,0
13,2,11,1,0,1
-44,-38,-6,0,0,0
13,15,-2,0,0,0
-12,-26,14,1,0,1
21,1,20,1,1,0
-15,-8,-7,0,1,1
52,40,12,1,1,0
32,34,-2,0,1,1
-26,-15,-11,0,1,1
26,26,0,0,1,1
-1,13,-14,0,1,1
-26,-21,-5,0,1,1
34,39,-5,0,1,1
10,6,4,1,1,0
-40,-33,-7,0,0,0
56,41,15,1,0,1
51,31,20,1,0,1
-51,-42,-9,0,0,0
-14,-13,-1,0,0,0
-12,-18,6,1,0,1
-56,-37,-19,0,0,0
24,17,7,1,0,1
-48,-45,-3,0,0,0
-12,3,-15,0,0,0
-33,-37,4,1,0,1
41,28,13,1,0,1
33,15,18,1,0,1
-44,-37,-7,0,0,0
31,35,-4,0,0,0
-8,6,-14,0,0,0
21,1,20,1,0,1
35,39,-4,0,0,0
-40,-45,5,1,0,1
31,30,1,1,0,1
8,16,-8,0,0,0
25,42,-17,0,1,1
21,26,-5,0,1,1
-25,-30,5,1,1,0
27,44,-17,0,1,1
-14,-22,8,1,1,0
32,14,18,1,1,0
42,42,0,0,1,1
-11,-2,-9,0,1,1
34,25,9,1,1,0
-27,-14,-13,0,1,1
16,15,1,1,1,0
-33,-29,-4,0,1,1
-2,-21,19,1,1,0
-30,-36,6,1,1,0
23,18,5,1,1,0
41,24,17,1,1,0
18,12,6,1,1,0
-48,-33,-15,0,1,1
10,2,8,1,1,0
39,34,5,1,1,0
-11,-11,0,0,0,0
-5,7,-12,0,0,0
53,33,20,1,0,1
45,26,19,1,0,1
-16,-10,-6,0,0,0
21,34,-13,0,0,0
8,23,-15,0,0,0
-23,-9,-14,0,0,0
16,20,-4,0,0,0
15,0,15,1,0,1
19,9,10,1,0,1
3,6,-3,0,0,0
19,14,5,1,0,1
3,4,-1,0,0,0
-56,-36,-20,0,0,0
-5,-21,16,1,1,0
-34,-26,-8,0,1,1
-26,-18,-8,0,1,1
-17,-33,16,1,1,0
-18,-28,10,1,1,0
-19,-21,2,1,1,0
17,30,-13,0,1,1
-10,3,-13,0,1,1
4,-8,12,1,1,0
9,15,-6,0,1,1
-51,-45,-6,0,1,1
-19,0,-19,0,1,1
-33,-42,9,1,1,0
-27,-23,-4,0,1,1
38,30,8,1,1,0
32,29,3,1,1,0
32,32,0,0,1,1
-7,1,-8,0,1,1
3,17,-14,0,1,1
-20,-2,-18,0,0,0
36,40,-4,0,0,0
-6,6,-12,0,0,0
-59,-44,-15,0,0,0
-22,-26,4,1,0,1
16,36,-20,0,0,0
-3,6,-9,0,0,0
29,34,-5,0,0,0
-57,-43,-14,0,0,0
-13,-4,-9,0,0,0
-17,-20,3,1,0,1
-6,-26,20,1,0,1
-60,-43,-17,0,0,0
40,36,4,1,0,1
44,35,9,1,0,1
-52,-35,-17,0,0,0
4,13,-9,0,0,0
14,30,-16,0,0,0
-35,-28,-7,0,0,0
-32,-22,-10,0,0,0
-23,-16,-7,0,0,0
30,12,18,1,1,0
28,23,5,1,1,0
-18,-15,-3,0,1,1
22,28,-6,0,1,1
-29,-10,-19,0,1,1
-39,-33,-6,0,1,1
49,29,20,1,1,0
-40,-24,-16,0,1,1
7,7,0,0,1,1
-29,-30,1,1,1,0
21,36,-15,0,1,1
-9,1,-10,0,1,1
3,-3,6,1,1,0
-43,-36,-7,0,1,1
-33,-16,-17,0,1,1
56,42,14,1,1,0
-25,-7,-18,0,1,1
33,18,15,1,0,1
-46,-39,-7,0,0,0
-25,-21,-4,0,0,0
-24,-14,-10,0,0,0
-20,-4,-16,0,0,0
44,40,4,1,0,1
29,37,-8,0,0,0
-27,-22,-5,0,0,0
34,17,17,1,1,0
-46,-42,-4,0,1,1
-10,1,-11,0,1,1
21,3,18,1,1,0
8,-5,13,1,1,0
-13,6,-19,0,1,1
-4,10,-14,0,1,1
-12,4,-16,0,1,1
1,-3,4,1,1,0
-7,-10,3,1,1,0
9,-5,14,1,1,0
32,37,-5,0,0,0
-32,-16,-16,0,0,0
-37,-32,-5,0,0,0
-41,-43,2,1,0,1
23,29,-6,0,0,0
-41,-24,-17,0,0,0
-7,-4,-3,0,0,0
1,-9,10,1,0,1
49,42,7,1,0,1
-14,-28,14,1,0,1
-22,-5,-17,0,0,0
-59,-40,-19,0,0,0
17,18,-1,0,0,0
33,37,-4,0,0,0
-31,-30,-1,0,0,0
36,32,4,1,0,1
7,8,-1,0,0,0
25,26,-1,0,0,0
0,-5,5,1,0,1
-17,-31,14,1,0,1
-26,-41,15,1,0,1
-32,-34,2,1,1,0
-17,-27,10,1,1,0
-30,-35,5,1,1,0
27,33,-6,0,1,1
-26,-36,10,1,1,0
42,30,12,1,1,0
28,32,-4,0,1,1
13,-7,20,1,1,0
-34,-33,-1,0,1,1
-19,-25,6,1,1,0
-14,-19,5,1,0,1
-25,-24,-1,0,0,0
5,-3,8,1,0,1
2,-4,6,1,0,1
-18,-24,6,1,0,1
49,36,13,1,0,1
-2,-4,2,1,0,1
0,-15,15,1,0,1
-10,-21,11,1,0,1
-9,9,-18,0,0,0
-20,-3,-17,0,0,0
-35,-28,-7,0,0,0
14,12,2,1,0,1
-20,-24,4,1,0,1
-7,-14,7,1,0,1
-28,-40,12,1,0,1
-7,3,-10,0,0,0
32,14,18,1,0,1
1,2,-1,0,0,0
-23,-16,-7,0,0,0
26,25,1,1,0,1
25,27,-2,0,1,1
-34,-35,1,1,1,0
-28,-34,6,1,1,0
-18,-17,-1,0,1,1
-46,-31,-15,0,1,1
-40,-45,5,1,1,0
-51,-35,-16,0,1,1
33,33,0,0,1,1
5,15,-10,0,1,1
-34,-42,8,1,1,0
34,31,3,1,1,0
-17,-16,-1,0,1,1
-12,0,-12,0,1,1
-33,-16,-17,0,1,1
-22,-13,-9,0,1,1
49,31,18,1,1,0
-1,10,-11,0,1,1
14,2,12,1,1,0
39,40,-1,0,1,1
-16,-11,-5,0,1,1
23,42,-19,0,1,1
-43,-40,-3,0,0,0
-13,5,-18,0,0,0
38,43,-5,0,0,0
28,33,-5,0,0,0
35,38,-3,0,0,0
-55,-40,-15,0,0,0
15,-3,18,1,0,1
38,40,-2,0,0,0
-17,-18,1,1,0,1
2,9,-7,0,0,0
16,1,15,1,0,1
-26,-26,0,0,0,0
-5,7,-12,0,0,0
4,-16,20,1,0,1
24,38,-14,0,0,0
57,40,17,1,0,1
-25,-30,5,1,0,1
4,-5,9,1,0,1
-16,-26,10,1,0,1
-28,-23,-5,0,0,0
-40,-43,3,1,0,1
3,7,-4,0,1,1
41,44,-3,0,1,1
1,18,-17,0,1,1
6,12,-6,0,1,1
-28,-28,0,0,1,1
25,19,6,1,1,0
56,39,17,1,1,0
20,40,-20,0,1,1
38,18,20,1,1,0
26,12,14,1,1,0
-13,-20,7,1,1,0
0,1,-1,0,1,1
15,28,-13,0,1,1
19,2,17,1,1,0
-33,-24,-9,0,1,1
-42,-37,-5,0,1,1
56,42,14,1,1,0
-29,-14,-15,0,1,1
56,43,13,1,1,0
-19,-13,-6,0,1,1
6,26,-20,0,1,1
38,30,8,1,0,1
33,22,11,1,0,1
-21,-10,-11,0,0,0
-13,4,-17,0,0,0
-40,-44,4,1,0,1
-46,-38,-8,0,0,0
-22,-10,-12,0,0,0
6,-8,14,1,0,1
-52,-39,-13,0,0,0
-10,-19,9,1,0,1
12,-3,15,1,0,1
30,22,8,1,0,1
-20,-24,4,1,0,1
-2,-9,7,1,0,1
48,43,5,1,0,1
-10,-21,11,1,0,1
-25,-26,1,1,0,1
-15,5,-20,0,0,0
26,10,16,1,0,1
19,38,-19,0,0,0
-11,2,-13,0,0,0
-17,-17,0,0,1,1
-39,-29,-10,0,1,1
-28,-22,-6,0,1,1
-18,0,-18,0,1,1
-46,-35,-11,0,1,1
30,31,-1,0,1,1
3,-9,12,1,1,0
-4,14,-18,0,1,1
13,10,3,1,1,0
24,32,-8,0,1,1
-56,-42,-14,0,1,1
57,37,20,1,1,0
0,-1,1,1,1,0
32,38,-6,0,1,1
-58,-45,-13,0,1,1
-2,-19,17,1,1,0
-6,8,-14,0,1,1
32,33,-1,0,1,1
2,21,-19,0,1,1
4,-8,12,1,1,0
-52,-36,-16,0,1,1
-61,-43,-18,0,0,0
15,-2,17,1,0,1
15,25,-10,0,0,0
30,32,-2,0,0,0
3,0,3,1,0,1
12,5,7,1,0,1
-52,-45,-7,0,0,0
-47,-28,-19,0,0,0
-48,-33,-15,0,0,0
-50,-35,-15,0,0,0
10,-2,12,1,0,1
11,18,-7,0,0,0
9,10,-1,0,0,0
-1,17,-18,0,0,0
42,37,5,1,0,1
-13,-13,0,0,0,0
-47,-42,-5,0,0,0
24,32,-8,0,1,1
-15,-4,-11,0,1,1
12,15,-3,0,1,1
48,38,10,1,1,0
12,14,-2,0,1,1
-52,-43,-9,0,1,1
16,30,-14,0,1,1
12,21,-9,0,1,1
-24,-25,1,1,1,0
24,23,1,1,1,0
-32,-14,-18,0,1,1
11,18,-7,0,1,1
12,-6,18,1,1,0
9,1,8,1,0,1
-10,4,-14,0,0,0
-31,-33,2,1,0,1
51,43,8,1,0,1
-32,-45,13,1,0,1
4,4,0,0,0,0
-38,-27,-11,0,0,0
6,-6,12,1,0,1
-38,-38,0,0,0,0
-5,-14,9,1,1,0
19,24,-5,0,1,1
36,23,13,1,1,0
-57,-37,-20,0,1,1
14,-3,17,1,1,0
-44,-45,1,1,1,0
29,27,2,1,1,0
27,29,-2,0,1,1
-30,-32,2,1,1,0
18,21,-3,0,1,1
-2,3,-5,0,1,1
-42,-41,-1,0,0,0
-37,-43,6,1,0,1
-37,-22,-15,0,0,0
-30,-45,15,1,0,1
-38,-42,4,1,0,1
-49,-37,-12,0,0,0
30,31,-1,0,0,0
7,16,-9,0,0,0
-5,-24,19,1,0,1
33,21,12,1,0,1
-19,-36,17,1,0,1
42,23,19,1,0,1
-1,14,-15,0,0,0
-6,-24,18,1,0,1
-50,-45,-5,0,0,0
-6,-21,15,1,0,1
38,33,5,1,0,1
-1,0,-1,0,1,1
-21,-26,5,1,1,0
-41,-43,2,1,1,0
-11,6,-17,0,1,1
4,20,-16,0,1,1
-4,-16,12,1,1,0
0,-8,8,1,1,0
19,4,15,1,1,0
-5,-14,9,1,1,0
24,26,-2,0,0,0
-35,-29,-6,0,0,0
5,-2,7,1,0,1
43,37,6,1,0,1
-28,-20,-8,0,0,0
39,34,5,1,0,1
-11,-15,4,1,0,1
54,39,15,1,0,1
53,41,12,1,0,1
1,-9,10,1,0,1
-2,-7,5,1,0,1
-52,-34,-18,0,0,0
-32,-31,-1,0,0,0
6,25,-19,0,0,0
22,5,17,1,0,1
7,3,4,1,0,1
12,30,-18,0,0,0
24,12,12,1,0,1
9,25,-16,0,0,0
21,33,-12,0,0,0
-31,-30,-1,0,0,0
9,13,-4,0,1,1
12,-1,13,1,1,0
47,35,12,1,1,0
53,42,11,1,1,0
30,41,-11,0,1,1
28,35,-7,0,1,1
29,16,13,1,1,0
32,37,-5,0,1,1
-1,19,-20,0,1,1
-6,-10,4,1,1,0
-3,13,-16,0,1,1
44,42,2,1,1,0
-3,11,-14,0,1,1
-23,-27,4,1,1,0
-28,-9,-19,0,1,1
-49,-42,-7,0,1,1
-36,-23,-13,0,1,1
32,27,5,1,1,0
28,33,-5,0,1,1
3,1,2,1,1,0
-36,-27,-9,0,1,1
10,20,-10,0,0,0
-47,-44,-3,0,0,0
46,27,19,1,0,1
20,36,-16,0,0,0
22,5,17,1,0,1
-11,-31,20,1,0,1
6,-8,14,1,0,1
-46,-41,-5,0,0,0
-17,-33,16,1,0,1
-1,-2,1,1,0,1
28,28,0,0,0,0
32,25,7,1,0,1
27,7,20,1,1,0
13,-1,14,1,1,0
35,43,-8,0,1,1
33,26,7,1,1,0
-13,0,-13,0,1,1
6,8,-2,0,1,1
51,36,15,1,1,0
17,31,-14,0,1,1
-5,4,-9,0,1,1
-32,-26,-6,0,1,1
-35,-23,-12,0,1,1
-25,-38,13,1,1,0
-56,-42,-14,0,1,1
37,36,1,1,1,0
-2,-9,7,1,1,0
17,27,-10,0,1,1
-17,-36,19,1,1,0
-20,-31,11,1,1,0
31,20,11,1,1,0
-10,-6,-4,0,1,1
-19,-21,2,1,1,0
2,21,-19,0,0,0
12,32,-20,0,0,0
7,-9,16,1,0,1
53,42,11,1,0,1
-31,-36,5,1,0,1
-34,-44,10,1,0,1
-11,-12,1,1,0,1
-22,-32,10,1,0,1
52,42,10,1,0,1
-48,-39,-9,0,0,0
-29,-32,3,1,0,1
16,13,3,1,0,1
-17,-22,5,1,0,1
16,23,-7,0,0,0
-4,-9,5,1,0,1
-15,-2,-13,0,0,0
23,29,-6,0,0,0
-28,-40,12,1,0,1
-23,-4,-19,0,0,0
-14,-29,15,1,0,1
-38,-19,-19,0,0,0
-5,-22,17,1,1,0
26,8,18,1,1,0
-7,-17,10,1,1,0
-28,-24,-4,0,1,1
-10,-17,7,1,1,0
28,29,-1,0,1,1
23,39,-16,0,1,1
-16,-2,-14,0,1,1
-25,-10,-15,0,1,1
-24,-13,-11,0,1,1
21,35,-14,0,1,1
58,41,17,1,1,0
43,38,5,1,1,0
-2,-13,11,1,1,0
-17,-11,-6,0,1,1
-19,-19,0,0,1,1
-5,-16,11,1,1,0
-14,-25,11,1,1,0
-2,5,-7,0,1,1
-34,-26,-8,0,0,0
16,36,-20,0,0,0
18,13,5,1,0,1
20,39,-19,0,0,0
24,42,-18,0,0,0
-6,6,-12,0,0,0
44,35,9,1,0,1
24,18,6,1,0,1
-32,-45,13,1,1,0
-33,-20,-13,0,1,1
9,-11,20,1,1,0
-7,-3,-4,0,1,1
16,15,1,1,1,0
0,8,-8,0,1,1
-6,0,-6,0,1,1
21,36,-15,0,1,1
16,36,-20,0,1,1
-15,-15,0,0,1,1
5,-1,6,1,1,0
7,-10,17,1,1,0
16,6,10,1,1,0
-11,-27,16,1,1,0
37,43,-6,0,1,1
29,21,8,1,1,0
-7,-21,14,1,1,0
12,25,-13,0,1,1
51,34,17,1,1,0
-30,-39,9,1,1,0
19,27,-8,0,1,1
13,13,0,0,0,0
20,5,15,1,0,1
-54,-37,-17,0,0,0
-43,-43,0,0,0,0
-15,-25,10,1,0,1
5,-9,14,1,0,1
-38,-39,1,1,0,1
-3,7,-10,0,0,0
7,20,-13,0,0,0
35,30,5,1,0,1
-24,-26,2,1,0,1
-18,-1,-17,0,0,0
-22,-11,-11,0,0,0
-15,-34,19,1,0,1
-35,-25,-10,0,0,0
5,2,3,1,0,1
36,20,16,1,0,1
19,39,-20,0,0,0
25,8,17,1,0,1
-13,-26,13,1,0,1
24,9,15,1,1,0
-11,-23,12,1,1,0
39,36,3,1,1,0
-28,-26,-2,0,1,1
23,39,-16,0,1,1
-30,-45,15,1,1,0
44,26,18,1,1,0
-47,-27,-20,0,1,1
42,23,19,1,1,0
16,7,9,1,0,1
37,25,12,1,0,1
-54,-36,-18,0,0,0
20,12,8,1,0,1
-47,-27,-20,0,0,0
27,30,-3,0,0,0
19,23,-4,0,0,0
-26,-21,-5,0,0,0
38,24,14,1,0,1
17,22,-5,0,0,0
-25,-20,-5,0,0,0
-1,-13,12,1,0,1
-14,-4,-10,0,0,0
-24,-5,-19,0,1,1
-29,-23,-6,0,1,1
-34,-21,-13,0,1,1
-38,-21,-17,0,1,1
-61,-45,-16,0,1,1
-1,-2,1,1,1,0
7,8,-1,0,1,1
-13,0,-13,0,1,1
-56,-36,-20,0,1,1
6,12,-6,0,0,0
50,31,19,1,0,1
-7,-18,11,1,0,1
1,8,-7,0,0,0
32,38,-6,0,0,0
50,40,10,1,0,1
-17,-8,-9,0,0,0
-43,-32,-11,0,0,0
31,22,9,1,0,1
-44,-29,-15,0,0,0
-48,-44,-4,0,0,0
21,31,-10,0,0,0
-8,4,-12,0,1,1
-13,2,-15,0,1,1
11,2,9,1,1,0
9,10,-1,0,1,1
-2,7,-9,0,1,1
40,36,4,1,1,0
-15,-27,12,1,1,0
40,23,17,1,1,0
21,19,2,1,1,0
-25,-43,18,1,1,0
14,12,2,1,1,0
6,12,-6,0,0,0
49,31,18,1,0,1
41,43,-2,0,0,0
60,42,18,1,0,1
10,4,6,1,0,1
4,21,-17,0,0,0
46,43,3,1,0,1
-18,-15,-3,0,0,0
-38,-22,-16,0,0,0
-20,-18,-2,0,0,0
18,7,11,1,0,1
28,20,8,1,1,0
-62,-42,-20,0,1,1
-32,-43,11,1,1,0
-34,-43,9,1,1,0
9,12,-3,0,1,1
36,37,-1,0,1,1
-24,-19,-5,0,1,1
-34,-36,2,1,1,0
20,37,-17,0,1,1
43,27,16,1,1,0
1,-12,13,1,1,0
5,13,-8,0,1,1
-35,-28,-7,0,1,1
21,27,-6,0,1,1
27,39,-12,0,1,1
18,-2,20,1,0,1
16,4,12,1,0,1
-19,-30,11,1,0,1
21,26,-5,0,0,0
-17,-37,20,1,0,1
33,15,18,1,0,1
-19,-32,13,1,0,1
9,8,1,1,0,1
26,16,10,1,0,1
53,37,16,1,0,1
18,0,18,1,0,1
18,12,6,1,0,1
-37,-43,6,1,0,1
-37,-20,-17,0,0,0
21,20,1,1,0,1
-31,-13,-18,0,0,0
-46,-38,-8,0,0,0
-34,-35,1,1,0,1
-37,-42,5,1,0,1
-21,-28,7,1,0,1
40,34,6,1,0,1
49,44,5,1,1,0
-3,-12,9,1,1,0
-29,-11,-18,0,1,1
21,7,14,1,1,0
-34,-42,8,1,1,0
19,8,11,1,1,0
9,18,-9,0,1,1
-36,-16,-20,0,1,1
-26,-26,0,0,1,1
-7,-25,18,1,1,0
-45,-45,0,0,1,1
21,34,-13,0,1,1
-9,-6,-3,0,1,1
-11,-20,9,1,1,0
-30,-22,-8,0,1,1
-42,-33,-9,0,1,1
-18,-19,1,1,1,0
-4,3,-7,0,1,1
32,29,3,1,1,0
20,16,4,1,0,1
31,44,-13,0,0,0
-49,-40,-9,0,0,0
22,28,-6,0,0,0
-18,-9,-9,0,0,0
11,17,-6,0,0,0
8,6,2,1,0,1
-20,-8,-12,0,0,0
31,17,14,1,0,1
-22,-6,-16,0,0,0
-42,-42,0,0,0,0
12,6,6,1,0,1
-56,-39,-17,0,1,1
21,36,-15,0,1,1
45,34,11,1,1,0
41,41,0,0,1,1
10,-6,16,1,1,0
20,3,17,1,1,0
-19,-35,16,1,1,0
-51,-38,-13,0,1,1
-13,-22,9,1,1,0
-28,-12,-16,0,1,1
37,23,14,1,1,0
-34,-28,-6,0,1,1
3,-2,5,1,1,0
21,27,-6,0,1,1
-17,-31,14,1,1,0
20,33,-13,0,1,1
-5,-25,20,1,1,0
-3,11,-14,0,1,1
-52,-39,-13,0,1,1
-25,-37,12,1,1,0
-28,-33,5,1,1,0
-11,-17,6,1,0,1
-49,-29,-20,0,0,0
33,40,-7,0,0,0
19,24,-5,0,0,0
-13,-2,-11,0,0,0
23,40,-17,0,0,0
-9,-28,19,1,0,1
1,-10,11,1,0,1
-17,-2,-15,0,0,0
-28,-27,-1,0,0,0
-45,-42,-3,0,0,0
-20,-31,11,1,0,1
13,16,-3,0,1,1
18,28,-10,0,1,1
9,0,9,1,1,0
19,27,-8,0,1,1
26,23,3,1,1,0
-39,-37,-2,0,1,1
45,27,18,1,1,0
29,10,19,1,1,0
-23,-5,-18,0,1,1
10,20,-10,0,1,1
-50,-44,-6,0,0,0
23,37,-14,0,0,0
15,10,5,1,0,1
29,11,18,1,0,1
28,8,20,1,0,1
2,7,-5,0,0,0
-16,-19,3,1,0,1
-21,-14,-7,0,0,0
-48,-34,-14,0,0,0
21,34,-13,0,0,0
-23,-38,15,1,0,1
6,0,6,1,0,1
29,16,13,1,0,1
26,42,-16,0,0,0
4,1,3,1,0,1
-22,-42,20,1,1,0
6,20,-14,0,1,1
31,19,12,1,1,0
47,36,11,1,1,0
-25,-21,-4,0,1,1
3,-11,14,1,1,0
5,-14,19,1,1,0
-29,-16,-13,0,1,1
11,20,-9,0,1,1
-40,-27,-13,0,1,1
14,20,-6,0,1,1
49,35,14,1,1,0
-51,-42,-9,0,1,1
-49,-29,-20,0,1,1
60,41,19,1,1,0
-22,-10,-12,0,0,0
51,42,9,1,0,1
-46,-33,-13,0,0,0
-6,0,-6,0,0,0
-51,-32,-19,0,0,0
-2,18,-20,0,0,0
17,19,-2,0,0,0
11,0,11,1,0,1
15,12,3,1,0,1
-9,-8,-1,0,1,1
20,16,4,1,1,0
11,23,-12,0,1,1
42,32,10,1,1,0
44,42,2,1,1,0
-2,-8,6,1,1,0
-17,-9,-8,0,1,1
-25,-11,-14,0,1,1
48,38,10,1,0,1
-62,-42,-20,0,0,0
10,16,-6,0,0,0
32,15,17,1,0,1
-37,-30,-7,0,0,0
8,14,-6,0,0,0
59,43,16,1,0,1
19,-1,20,1,0,1
45,36,9,1,0,1
-10,-15,5,1,0,1
-30,-30,0,0,0,0
38,41,-3,0,0,0
-55,-42,-13,0,0,0
-21,-14,-7,0,0,0
8,-6,14,1,0,1
-60,-42,-18,0,0,0
-9,6,-15,0,0,0
5,3,2,1,0,1
29,15,14,1,1,0
1,-5,6,1,1,0
19,36,-17,0,1,1
-11,-31,20,1,1,0
28,35,-7,0,1,1
23,5,18,1,1,0
4,24,-20,0,1,1
26,19,7,1,1,0
-11,-25,14,1,1,0
-8,6,-14,0,1,1
2,-8,10,1,1,0
-9,-17,8,1,1,0
8,27,-19,0,0,0
-24,-13,-11,0,0,0
14,10,4,1,0,1
-9,-27,18,1,0,1
37,23,14,1,0,1
-32,-41,9,1,0,1
21,17,4,1,0,1
-34,-28,-6,0,0,0
-42,-31,-11,0,0,0
-32,-19,-13,0,0,0
-53,-44,-9,0,0,0
21,40,-19,0,0,0
24,14,10,1,0,1
-51,-43,-8,0,0,0
-50,-39,-11,0,1,1
-18,1,-19,0,1,1
-23,-10,-13,0,1,1
40,23,17,1,1,0
-11,-5,-6,0,1,1
16,15,1,1,1,0
-33,-45,12,1,1,0
17,27,-10,0,1,1
20,18,2,1,1,0
-7,-23,16,1,1,0
-27,-35,8,1,1,0
12,24,-12,0,1,1
-16,-19,3,1,1,0
55,35,20,1,1,0
-2,0,-2,0,0,0
-43,-45,2,1,0,1
13,24,-11,0,0,0
-6,-24,18,1,0,1
5,4,1,1,0,1
8,23,-15,0,0,0
38,35,3,1,0,1
27,16,11,1,0,1
2,14,-12,0,0,0
-37,-37,0,0,0,0
23,23,0,0,0,0
12,-1,13,1,0,1
-27,-17,-10,0,1,1
-35,-19,-16,0,1,1
-4,-20,16,1,1,0
-5,6,-11,0,1,1
-42,-38,-4,0,1,1
-46,-36,-10,0,1,1
24,44,-20,0,1,1
44,33,11,1,1,0
46,36,10,1,1,0
-28,-18,-10,0,1,1
-20,-5,-15,0,1,1
18,5,13,1,0,1
12,21,-9,0,0,0
36,34,2,1,0,1
41,42,-1,0,0,0
30,32,-2,0,0,0
7,21,-14,0,0,0
3,13,-10,0,0,0
-46,-44,-2,0,0,0
2,5,-3,0,0,0
20,37,-17,0,0,0
-13,-15,2,1,0,1
10,-6,16,1,0,1
37,31,6,1,0,1
24,21,3,1,0,1
-27,-44,17,1,0,1
15,30,-15,0,0,0
-29,-41,12,1,0,1
14,16,-2,0,0,0
-5,-9,4,1,0,1
-32,-44,12,1,0,1
-43,-33,-10,0,0,0
13,6,7,1,1,0
11,19,-8,0,1,1
-22,-29,7,1,1,0
31,32,-1,0,1,1
-6,-5,-1,0,1,1
-7,4,-11,0,1,1
-32,-45,13,1,1,0
-32,-25,-7,0,1,1
-10,6,-16,0,1,1
35,29,6,1,1,0
-19,0,-19,0,1,1
-39,-38,-1,0,1,1
4,7,-3,0,0,0
9,-8,17,1,0,1
-18,-19,1,1,0,1
44,30,14,1,0,1
1,-17,18,1,0,1
7,-13,20,1,0,1
6,14,-8,0,0,0
-22,-5,-17,0,0,0
-19,-23,4,1,0,1
-3,7,-10,0,0,0
-33,-28,-5,0,0,0
-27,-11,-16,0,1,1
-50,-41,-9,0,1,1
25,29,-4,0,1,1
17,26,-9,0,1,1
7,17,-10,0,1,1
19,19,0,0,1,1
58,40,18,1,1,0
30,13,17,1,1,0
3,-13,16,1,0,1
11,-8,19,1,0,1
-20,-29,9,1,0,1
-38,-36,-2,0,0,0
17,27,-10,0,0,0
-27,-39,12,1,0,1
-6,-18,12,1,0,1
-38,-26,-12,0,0,0
-32,-45,13,1,0,1
-1,3,-4,0,0,0
-17,-1,-16,0,0,0
-16,-20,4,1,0,1
26,16,10,1,0,1
-5,6,-11,0,0,0
9,10,-1,0,0,0
-6,14,-20,0,0,0
8,14,-6,0,0,0
-32,-33,1,1,0,1
-12,-22,10,1,0,1
21,17,4,1,0,1
25,27,-2,0,0,0
-7,4,-11,0,1,1
43,34,9,1,1,0
-29,-34,5,1,1,0
-9,-16,7,1,1,0
49,37,12,1,1,0
-42,-44,2,1,1,0
33,29,4,1,1,0
-17,-11,-6,0,1,1
-46,-34,-12,0,1,1
-20,-18,-2,0,1,1
14,18,-4,0,1,1
26,31,-5,0,0,0
1,20,-19,0,0,0
34,18,16,1,0,1
-27,-43,16,1,0,1
-47,-44,-3,0,0,0
11,10,1,1,0,1
27,21,6,1,0,1
58,44,14,1,0,1
23,20,3,1,0,1
-5,-5,0,0,0,0
2,6,-4,0,0,0
7,2,5,1,0,1
-31,-43,12,1,0,1
9,-9,18,1,0,1
18,23,-5,0,0,0
-8,-27,19,1,0,1
-18,-7,-11,0,0,0
20,22,-2,0,0,0
13,21,-8,0,0,0
30,33,-3,0,0,0
7,8,-1,0,0,0
18,36,-18,0,1,1
49,35,14,1,1,0
-6,2,-8,0,1,1
30,39,-9,0,1,1
-9,2,-11,0,1,1
-45,-29,-16,0,1,1
10,1,9,1,1,0
-38,-21,-17,0,1,1
28,37,-9,0,1,1
21,36,-15,0,1,1
37,44,-7,0,1,1
21,37,-16,0,1,1
-25,-16,-9,0,1,1
33,32,1,1,1,0
-16,-11,-5,0,1,1
36,41,-5,0,1,1
44,39,5,1,1,0
-15,-4,-11,0,0,0
17,33,-16,0,0,0
52,32,20,1,0,1
-8,3,-11,0,0,0
-44,-30,-14,0,0,0
15,11,4,1,0,1
-37,-18,-19,0,0,0
0,-18,18,1,0,1
10,-6,16,1,0,1
34,23,11,1,0,1
-19,-37,18,1,0,1
-20,-22,2,1,0,1
-44,-38,-6,0,0,0
-3,13,-16,0,0,0
-48,-33,-15,0,0,0
-19,-39,20,1,0,1
-42,-32,-10,0,0,0
2,-7,9,1,1,0
46,39,7,1,1,0
40,28,12,1,1,0
-8,-21,13,1,1,0
6,-2,8,1,1,0
19,36,-17,0,1,1
-32,-16,-16,0,1,1
-32,-23,-9,0,1,1
46,30,16,1,1,0
-17,-4,-13,0,0,0
-51,-36,-15,0,0,0
46,42,4,1,0,1
-16,-29,13,1,0,1
6,-6,12,1,0,1
-12,1,-13,0,0,0
-26,-37,11,1,0,1
29,36,-7,0,0,0
39,28,11,1,0,1
26,22,4,1,1,0
42,27,15,1,1,0
0,7,-7,0,1,1
39,24,15,1,1,0
17,8,9,1,1,0
-6,-23,17,1,1,0
6,15,-9,0,1,1
-13,3,-16,0,1,1
-8,-12,4,1,1,0
34,44,-10,0,1,1
42,34,8,1,1,0
-13,-15,2,1,1,0
-38,-27,-11,0,1,1
16,13,3,1,1,0
-29,-16,-13,0,1,1
-29,-23,-6,0,1,1
50,32,18,1,1,0
33,37,-4,0,1,1
3,9,-6,0,1,1
-3,-2,-1,0,1,1
-35,-19,-16,0,1,1
-14,2,-16,0,0,0
26,24,2,1,0,1
38,40,-2,0,0,0
-42,-32,-10,0,0,0
-14,3,-17,0,0,0
13,18,-5,0,0,0
-10,-15,5,1,0,1
-26,-43,17,1,0,1
13,5,8,1,0,1
-6,10,-16,0,0,0
47,27,20,1,0,1
-51,-35,-16,0,0,0
6,-1,7,1,0,1
13,5,8,1,0,1
29,37,-8,0,0,0
-29,-18,-11,0,0,0
29,21,8,1,1,0
-25,-40,15,1,1,0
-1,-12,11,1,1,0
-23,-21,-2,0,1,1
-48,-44,-4,0,1,1
-6,-11,5,1,1,0
-36,-17,-19,0,1,1
-8,-25,17,1,1,0
6,4,2,1,1,0
30,32,-2,0,1,1
-11,-22,11,1,1,0
22,34,-12,0,1,1
-4,8,-12,0,1,1
17,25,-8,0,0,0
47,32,15,1,0,1
24,11,13,1,0,1
27,40,-13,0,0,0
-30,-36,6,1,0,1
-42,-40,-2,0,0,0
28,16,12,1,0,1
28,27,1,1,0,1
4,-3,7,1,0,1
-51,-32,-19,0,0,0
15,21,-6,0,0,0
17,27,-10,0,0,0
-1,7,-8,0,0,0
11,-5,16,1,0,1
21,3,18,1,0,1
0,-8,8,1,0,1
15,27,-12,0,0,0
38,18,20,1,0,1
-34,-23,-11,0,0,0
24,8,16,1,0,1
-1,6,-7,0,1,1
8,15,-7,0,1,1
30,18,12,1,1,0
-41,-33,-8,0,1,1
-9,-9,0,0,1,1
31,23,8,1,1,0
4,13,-9,0,1,1
-11,-22,11,1,1,0
-24,-8,-16,0,1,1
7,4,3,1,1,0
-1,0,-1,0,0,0
41,39,2,1,0,1
23,9,14,1,0,1
-34,-32,-2,0,0,0
-20,-29,9,1,0,1
-25,-32,7,1,0,1
16,-3,19,1,0,1
5,19,-14,0,0,0
23,11,12,1,0,1
-15,-11,-4,0,0,0
36,36,0,0,0,0
-53,-39,-14,0,0,0
-15,-27,12,1,0,1
32,40,-8,0,0,0
-28,-19,-9,0,0,0
-19,-37,18,1,0,1
-28,-15,-13,0,0,0
3,15,-12,0,1,1
0,10,-10,0,1,1
7,0,7,1,1,0
23,27,-4,0,1,1
-36,-33,-3,0,1,1
10,19,-9,0,1,1
-11,6,-17,0,1,1
-45,-32,-13,0,1,1
10,-6,16,1,1,0
3,15,-12,0,1,1
30,44,-14,0,1,1
-30,-22,-8,0,1,1
13,19,-6,0,1,1
-18,-35,17,1,1,0
-42,-37,-5,0,1,1
-8,-7,-1,0,1,1
-27,-32,5,1,1,0
-53,-36,-17,0,1,1
33,16,17,1,1,0
-52,-34,-18,0,0,0
45,35,10,1,0,1
17,-3,20,1,0,1
38,22,16,1,0,1
16,34,-18,0,0,0
19,23,-4,0,0,0
47,31,16,1,0,1
-21,-1,-20,0,0,0
-24,-13,-11,0,0,0
22,34,-12,0,1,1
-6,5,-11,0,1,1
-25,-30,5,1,1,0
-52,-42,-10,0,1,1
37,41,-4,0,1,1
45,30,15,1,1,0
-10,8,-18,0,1,1
-4,11,-15,0,1,1
3,6,-3,0,1,1
-6,-23,17,1,1,0
-52,-45,-7,0,1,1
50,32,18,1,1,0
24,38,-14,0,1,1
-28,-20,-8,0,1,1
2,-7,9,1,0,1
-59,-44,-15,0,0,0
13,17,-4,0,0,0
-7,-6,-1,0,0,0
3,4,-1,0,0,0
-14,0,-14,0,0,0
-22,-32,10,1,0,1
-17,-13,-4,0,0,0
45,26,19,1,0,1
37,26,11,1,0,1
59,43,16,1,1,0
4,-2,6,1,1,0
32,23,9,1,1,0
-11,6,-17,0,1,1
30,19,11,1,1,0
-34,-15,-19,0,1,1
-50,-35,-15,0,1,1
24,27,-3,0,1,1
-34,-18,-16,0,1,1
19,2,17,1,1,0
-34,-19,-15,0,1,1
-21,-16,-5,0,1,1
28,22,6,1,1,0
27,38,-11,0,1,1
-39,-34,-5,0,1,1
24,38,-14,0,1,1
-41,-34,-7,0,1,1
-20,-14,-6,0,1,1
7,20,-13,0,0,0
-24,-34,10,1,0,1
-37,-41,4,1,0,1
20,14,6,1,0,1
48,34,14,1,0,1
-36,-18,-18,0,0,0
-32,-14,-18,0,0,0
21,38,-17,0,0,0
48,43,5,1,0,1
10,20,-10,0,0,0
8,-3,11,1,0,1
39,32,7,1,0,1
16,1,15,1,0,1
38,39,-1,0,0,0
23,3,20,1,0,1
2,7,-5,0,0,0
34,42,-8,0,0,0
-22,-20,-2,0,0,0
-4,-4,0,0,1,1
-58,-41,-17,0,1,1
-5,-1,-4,0,1,1
-17,-13,-4,0,1,1
-3,-8,5,1,1,0
11,0,11,1,1,0
14,30,-16,0,1,1
-12,-26,14,1,1,0
12,15,-3,0,1,1
41,38,3,1,1,0
-50,-36,-14,0,1,1
30,25,5,1,1,0
-41,-32,-9,0,1,1
19,27,-8,0,1,1
-10,-15,5,1,1,0
-19,-38,19,1,1,0
0,-5,5,1,1,0
24,11,13,1,1,0
-17,1,-18,0,1,1
3,20,-17,0,1,1
31,12,19,1,1,0
-45,-26,-19,0,0,0
-2,-12,10,1,0,1
-22,-20,-2,0,0,0
23,3,20,1,0,1
24,24,0,0,0,0
-16,-7,-9,0,0,0
-7,-9,2,1,0,1
23,32,-9,0,0,0
56,44,12,1,0,1
-40,-23,-17,0,0,0
31,18,13,1,0,1
-19,-22,3,1,0,1
-53,-41,-12,0,0,0
-4,-16,12,1,0,1
5,13,-8,0,0,0
28,14,14,1,0,1
27,29,-2,0,0,0
1,-5,6,1,0,1
-13,-15,2,1,0,1
1,-19,20,1,0,1
46,27,19,1,0,1
-19,-24,5,1,1,0
6,-4,10,1,1,0
47,29,18,1,1,0
20,35,-15,0,1,1
-6,-24,18,1,1,0
-32,-18,-14,0,1,1
-2,-9,7,1,1,0
23,24,-1,0,1,1
8,27,-19,0,1,1
-8,-8,0,0,1,1
20,12,8,1,1,0
35,33,2,1,1,0
35,25,10,1,1,0
9,-6,15,1,0,1
-12,3,-15,0,0,0
-33,-40,7,1,0,1
-19,-29,10,1,0,1
41,36,5,1,0,1
-25,-20,-5,0,0,0
19,24,-5,0,0,0
44,37,7,1,0,1
24,32,-8,0,0,0
8,3,5,1,0,1
-19,-35,16,1,0,1
7,3,4,1,0,1
-32,-16,-16,0,0,0
-5,10,-15,0,0,0
-17,-20,3,1,0,1
32,44,-12,0,1,1
-8,3,-11,0,1,1
-18,-21,3,1,1,0
-24,-6,-18,0,1,1
-12,-8,-4,0,1,1
40,40,0,0,1,1
-12,-29,17,1,1,0
22,8,14,1,1,0
35,18,17,1,1,0
15,29,-14,0,1,1
-29,-20,-9,0,1,1
-9,-24,15,1,0,1
-48,-45,-3,0,0,0
23,40,-17,0,0,0
-6,14,-20,0,0,0
-47,-33,-14,0,0,0
-48,-31,-17,0,0,0
54,36,18,1,0,1
11,-1,12,1,0,1
-27,-29,2,1,0,1
-28,-37,9,1,0,1
6,1,5,1,0,1
26,39,-13,0,0,0
-33,-30,-3,0,0,0
16,18,-2,0,0,0
-50,-38,-12,0,0,0
21,24,-3,0,0,0
-30,-22,-8,0,0,0
-11,3,-14,0,0,0
-16,-12,-4,0,0,0
-42,-43,1,1,0,1
-17,-9,-8,0,0,0
-17,-37,20,1,1,0
-3,-23,20,1,1,0
11,3,8,1,1,0
10,12,-2,0,1,1
-43,-26,-17,0,1,1
-37,-37,0,0,1,1
52,33,19,1,1,0
22,40,-18,0,1,1
-14,-11,-3,0,0,0
-28,-24,-4,0,0,0
-18,-31,13,1,0,1
-7,9,-16,0,0,0
27,35,-8,0,0,0
9,10,-1,0,0,0
-23,-28,5,1,0,1
23,40,-17,0,0,0
-64,-45,-19,0,1,1
3,1,2,1,1,0
-26,-40,14,1,1,0
-11,5,-16,0,1,1
-20,-4,-16,0,1,1
33,15,18,1,1,0
-1,13,-14,0,1,1
23,9,14,1,1,0
-20,-8,-12,0,0,0
25,24,1,1,0,1
46,33,13,1,0,1
-34,-29,-5,0,0,0
49,41,8,1,0,1
5,-2,7,1,0,1
5,23,-18,0,0,0
-27,-10,-17,0,0,0
21,7,14,1,0,1
5,19,-14,0,0,0
20,37,-17,0,0,0
17,18,-1,0,0,0
40,32,8,1,0,1
-44,-45,1,1,1,0
43,28,15,1,1,0
0,-3,3,1,1,0
37,22,15,1,1,0
6,-5,11,1,1,0
0,10,-10,0,1,1
10,9,1,1,1,0
10,14,-4,0,1,1
16,-4,20,1,1,0
8,16,-8,0,1,1
-17,-18,1,1,0,1
47,29,18,1,0,1
-49,-37,-12,0,0,0
6,16,-10,0,0,0
2,22,-20,0,0,0
50,31,19,1,0,1
9,16,-7,0,0,0
-30,-45,15,1,0,1
30,44,-14,0,0,0
-1,-19,18,1,0,1
-11,-9,-2,0,0,0
-44,-28,-16,0,0,0
2,5,-3,0,0,0
-13,-23,10,1,0,1
-9,-13,4,1,0,1
-23,-5,-18,0,0,0
-15,-25,10,1,0,1
26,28,-2,0,0,0
-23,-24,1,1,0,1
6,17,-11,0,0,0
-3,-14,11,1,0,1
-9,7,-16,0,1,1
-3,8,-11,0,1,1
-13,-21,8,1,1,0
-3,-18,15,1,1,0
15,35,-20,0,1,1
-38,-41,3,1,1,0
-57,-42,-15,0,1,1
16,2,14,1,1,0
-50,-33,-17,0,1,1
4,3,1,1,1,0
-56,-37,-19,0,1,1
6,18,-12,0,1,1
20,39,-19,0,1,1
-16,-22,6,1,1,0
-24,-4,-20,0,1,1
1,17,-16,0,1,1
25,31,-6,0,1,1
-39,-44,5,1,1,0
27,14,13,1,1,0
15,30,-15,0,1,1
15,10,5,1,1,0
-4,-6,2,1,0,1
-35,-17,-18,0,0,0
-25,-22,-3,0,0,0
-5,-15,10,1,0,1
3,23,-20,0,0,0
-42,-31,-11,0,0,0
-22,-7,-15,0,0,0
4,16,-12,0,0,0
-28,-40,12,1,0,1
22,9,13,1,0,1
14,7,7,1,0,1
-16,-8,-8,0,0,0
-49,-35,-14,0,0,0
-28,-45,17,1,0,1
-14,-31,17,1,0,1
-33,-19,-14,0,0,0
54,34,20,1,1,0
30,29,1,1,1,0
-11,-25,14,1,1,0
-35,-37,2,1,1,0
16,28,-12,0,1,1
11,10,1,1,1,0
53,41,12,1,1,0
19,19,0,0,1,1
-5,-24,19,1,1,0
-29,-44,15,1,1,0
-61,-43,-18,0,1,1
-19,-20,1,1,1,0
17,2,15,1,1,0
-5,2,-7,0,1,1
-26,-18,-8,0,1,1
-21,-26,5,1,1,0
-2,-5,3,1,1,0
42,32,10,1,1,0
-8,-26,18,1,0,1
-21,-40,19,1,0,1
23,26,-3,0,0,0
-42,-43,1,1,0,1
-14,-23,9,1,0,1
-26,-16,-10,0,0,0
24,13,11,1,0,1
6,8,-2,0,0,0
-17,-26,9,1,0,1
-1,-17,16,1,0,1
21,24,-3,0,1,1
1,-12,13,1,1,0
-16,-8,-8,0,1,1
13,-5,18,1,1,0
-13,-30,17,1,1,0
56,39,17,1,1,0
-54,-45,-9,0,1,1
-9,0,-9,0,1,1
-20,-39,19,1,0,1
-19,-7,-12,0,0,0
36,22,14,1,0,1
-61,-45,-16,0,0,0
2,8,-6,0,0,0
-9,0,-9,0,0,0
18,29,-11,0,0,0
-47,-44,-3,0,0,0
43,28,15,1,1,0
-54,-34,-20,0,1,1
-47,-43,-4,0,1,1
16,0,16,1,1,0
10,-7,17,1,1,0
17,21,-4,0,1,1
45,35,10,1,1,0
-38,-29,-9,0,1,1
23,11,12,1,1,0
47,44,3,1,1,0
-33,-22,-11,0,1,1
-12,-28,16,1,1,0
-22,-40,18,1,0,1
38,29,9,1,0,1
-48,-30,-18,0,0,0
-6,-16,10,1,0,1
54,42,12,1,0,1
-2,-19,17,1,0,1
-39,-34,-5,0,0,0
21,37,-16,0,0,0
13,28,-15,0,0,0
-35,-20,-15,0,0,0
14,3,11,1,0,1
35,15,20,1,0,1
38,22,16,1,0,1
4,-15,19,1,0,1
-27,-29,2,1,0,1
11,0,11,1,0,1
-7,-14,7,1,0,1
23,22,1,1,0,1
1,18,-17,0,0,0
-42,-27,-15,0,0,0
6,3,3,1,0,1
17,30,-13,0,1,1
-31,-36,5,1,1,0
9,-8,17,1,1,0
10,30,-20,0,1,1
-35,-42,7,1,1,0
43,39,4,1,1,0
12,26,-14,0,1,1
6,23,-17,0,1,1
-31,-20,-11,0,1,1
-34,-26,-8,0,1,1
-49,-43,-6,0,0,0
5,1,4,1,0,1
10,-7,17,1,0,1
3,4,-1,0,0,0
-50,-36,-14,0,0,0
-23,-19,-4,0,0,0
27,32,-5,0,0,0
-4,8,-12,0,0,0
-1,-21,20,1,0,1
17,37,-20,0,0,0
-48,-33,-15,0,0,0
53,41,12,1,0,1
-49,-40,-9,0,0,0
-35,-18,-17,0,0,0
-24,-38,14,1,0,1
19,39,-20,0,1,1
52,44,8,1,1,0
19,12,7,1,1,0
-6,-25,19,1,1,0
19,12,7,1,1,0
11,27,-16,0,1,1
-18,-20,2,1,1,0
14,2,12,1,1,0
-3,7,-10,0,1,1
0,-16,16,1,0,1
-51,-44,-7,0,0,0
-21,-17,-4,0,0,0
18,32,-14,0,0,0
-36,-16,-20,0,0,0
-35,-45,10,1,0,1
-24,-18,-6,0,0,0
56,41,15,1,0,1
-4,13,-17,0,0,0
9,17,-8,0,1,1
17,17,0,0,1,1
-16,0,-16,0,1,1
-45,-39,-6,0,1,1
19,19,0,0,1,1
-11,-9,-2,0,1,1
-10,-6,-4,0,1,1
-3,4,-7,0,1,1
-48,-38,-10,0,1,1
-6,-20,14,1,1,0
17,9,8,1,1,0
-29,-15,-14,0,1,1
-1,-13,12,1,1,0
-11,6,-17,0,1,1
-38,-22,-16,0,0,0
24,7,17,1,0,1
-2,-10,8,1,0,1
39,30,9,1,0,1
36,29,7,1,0,1
30,29,1,1,0,1
28,9,19,1,0,1
2,12,-10,0,0,0
46,38,8,1,0,1
19,24,-5,0,1,1
-43,-35,-8,0,1,1
9,5,4,1,1,0
1,20,-19,0,1,1
-7,-11,4,1,1,0
5,-4,9,1,1,0
8,26,-18,0,1,1
-23,-43,20,1,1,0
-38,-38,0,0,1,1
1,-12,13,1,1,0
-34,-43,9,1,1,0
39,44,-5,0,1,1
-52,-39,-13,0,0,0
10,6,4,1,0,1
-40,-35,-5,0,0,0
0,11,-11,0,0,0
-33,-26,-7,0,0,0
-43,-41,-2,0,0,0
21,28,-7,0,0,0
-52,-40,-12,0,0,0
-43,-33,-10,0,0,0
-22,-19,-3,0,1,1
-31,-31,0,0,1,1
50,33,17,1,1,0
-1,6,-7,0,1,1
1,-15,16,1,1,0
-1,-2,1,1,1,0
-52,-45,-7,0,1,1
-13,-33,20,1,1,0
27,43,-16,0,1,1
-5,15,-20,0,0,0
-24,-11,-13,0,0,0
-37,-22,-15,0,0,0
-11,-27,16,1,0,1
12,-1,13,1,0,1
4,18,-14,0,0,0
-21,-15,-6,0,0,0
12,6,6,1,0,1
29,32,-3,0,1,1
-13,-9,-4,0,1,1
-37,-34,-3,0,1,1
-44,-43,-1,0,1,1
13,26,-13,0,1,1
-46,-30,-16,0,1,1
29,19,10,1,1,0
63,44,19,1,1,0
-39,-22,-17,0,1,1
-41,-42,1,1,1,0
11,8,3,1,1,0
61,43,18,1,1,0
-32,-31,-1,0,1,1
-33,-18,-15,0,1,1
-20,-21,1,1,1,0
-12,-11,-1,0,1,1
-18,-14,-4,0,0,0
-18,2,-20,0,0,0
44,28,16,1,0,1
-15,-24,9,1,0,1
-4,-6,2,1,0,1
-11,-10,-1,0,0,0
44,34,10,1,0,1
44,25,19,1,0,1
-46,-29,-17,0,0,0
-39,-20,-19,0,0,0
-1,-7,6,1,0,1
-9,-25,16,1,0,1
43,44,-1,0,1,1
-37,-24,-13,0,1,1
-4,-15,11,1,1,0
51,44,7,1,1,0
20,24,-4,0,1,1
-14,2,-16,0,1,1
-19,-15,-4,0,1,1
31,17,14,1,1,0
19,0,19,1,1,0
-2,4,-6,0,1,1
-17,-11,-6,0,1,1
23,4,19,1,1,0
-32,-34,2,1,1,0
4,3,1,1,1,0
15,0,15,1,1,0
59,42,17,1,1,0
49,32,17,1,1,0
-1,13,-14,0,1,1
10,3,7,1,0,1
14,21,-7,0,0,0
-25,-35,10,1,0,1
3,10,-7,0,0,0
-32,-27,-5,0,0,0
-44,-29,-15,0,0,0
32,25,7,1,0,1
-13,2,-15,0,0,0
9,12,-3,0,0,0
-5,-15,10,1,0,1
41,40,1,1,1,0
-47,-37,-10,0,1,1
-29,-40,11,1,1,0
-3,-3,0,0,1,1
-1,8,-9,0,1,1
21,31,-10,0,1,1
44,44,0,0,1,1
19,7,12,1,1,0
-31,-13,-18,0,1,1
-13,-13,0,0,0,0
18,36,-18,0,0,0
16,9,7,1,0,1
27,15,12,1,0,1
42,35,7,1,0,1
-59,-42,-17,0,0,0
48,36,12,1,0,1
-6,-8,2,1,0,1
-24,-43,19,1,1,0
-5,-7,2,1,1,0
23,17,6,1,1,0
-40,-28,-12,0,1,1
-13,-24,11,1,1,0
33,32,1,1,1,0
11,18,-7,0,1,1
-22,-7,-15,0,1,1
2,10,-8,0,1,1
35,16,19,1,1,0
-20,-26,6,1,1,0
-1,-16,15,1,1,0
43,44,-1,0,1,1
-2,9,-11,0,1,1
-21,-6,-15,0,1,1
-8,-14,6,1,0,1
39,31,8,1,0,1
-28,-24,-4,0,0,0
3,0,3,1,0,1
39,44,-5,0,0,0
-6,3,-9,0,0,0
7,-1,8,1,0,1
-28,-35,7,1,0,1
-27,-35,8,1,0,1
-16,-5,-11,0,0,0
-4,4,-8,0,0,0
25,12,13,1,0,1
-4,-22,18,1,0,1
27,26,1,1,0,1
-29,-36,7,1,0,1
11,12,-1,0,0,0
18,1,17,1,0,1
-6,-8,2,1,0,1
24,6,18,1,0,1
12,19,-7,0,0,0
14,13,1,1,0,1
-12,-13,1,1,1,0
1,21,-20,0,1,1
-8,5,-13,0,1,1
8,-6,14,1,1,0
14,6,8,1,1,0
0,-11,11,1,1,0
24,17,7,1,1,0
41,28,13,1,1,0
23,12,11,1,1,0
21,38,-17,0,1,1
-40,-45,5,1,1,0
-26,-25,-1,0,1,1
19,36,-17,0,1,1
26,7,19,1,1,0
-31,-29,-2,0,1,1
31,41,-10,0,1,1
-47,-27,-20,0,1,1
-7,-10,3,1,1,0
-56,-44,-12,0,1,1
-25,-32,7,1,1,0
6,-5,11,1,1,0
-19,-13,-6,0,0,0
36,23,13,1,0,1
-19,-24,5,1,0,1
4,18,-14,0,0,0
36,38,-2,0,0,0
-22,-29,7,1,0,1
13,6,7,1,0,1
3,-16,19,1,0,1
16,24,-8,0,1,1
-34,-42,8,1,1,0
6,5,1,1,1,0
24,33,-9,0,1,1
-6,9,-15,0,1,1
15,12,3,1,1,0
32,24,8,1,1,0
60,42,18,1,1,0
-7,-24,17,1,1,0
-61,-44,-17,0,1,1
32,40,-8,0,1,1
-61,-44,-17,0,1,1
48,38,10,1,1,0
-25,-25,0,0,1,1
48,34,14,1,1,0
33,26,7,1,1,0
-27,-35,8,1,0,1
-23,-28,5,1,0,1
24,30,-6,0,0,0
27,36,-9,0,0,0
45,32,13,1,0,1
40,44,-4,0,0,0
24,20,4,1,0,1
-40,-20,-20,0,0,0
-30,-39,9,1,0,1
9,11,-2,0,0,0
-41,-41,0,0,0,0
3,-8,11,1,0,1
10,16,-6,0,0,0
56,41,15,1,0,1
33,23,10,1,0,1
15,18,-3,0,0,0
6,18,-12,0,0,0
-26,-33,7,1,0,1
27,25,2,1,0,1
11,9,2,1,0,1
-14,-31,17,1,0,1
-20,-35,15,1,1,0
-14,-26,12,1,1,0
-22,-4,-18,0,1,1
-27,-42,15,1,1,0
7,-7,14,1,1,0
6,17,-11,0,1,1
-21,-39,18,1,1,0
-13,7,-20,0,1,1
-34,-21,-13,0,1,1
-25,-35,10,1,1,0
8,27,-19,0,1,1
29,24,5,1,1,0
31,12,19,1,1,0
-6,11,-17,0,1,1
-31,-42,11,1,1,0
-40,-24,-16,0,1,1
56,36,20,1,1,0
-39,-28,-11,0,1,1
14,28,-14,0,1,1
58,38,20,1,1,0
-5,-23,18,1,0,1
47,41,6,1,0,1
-51,-42,-9,0,0,0
-24,-7,-17,0,0,0
-23,-37,14,1,0,1
8,18,-10,0,0,0
18,4,14,1,0,1
3,14,-11,0,0,0
58,38,20,1,0,1
48,33,15,1,0,1
-28,-21,-7,0,0,0
-29,-27,-2,0,0,0
42,39,3,1,0,1
24,26,-2,0,0,0
20,1,19,1,0,1
-46,-27,-19,0,0,0
27,9,18,1,1,0
5,-15,20,1,1,0
-24,-23,-1,0,1,1
6,6,0,0,1,1
2,-1,3,1,1,0
47,38,9,1,1,0
43,27,16,1,1,0
-12,-15,3,1,1,0
-23,-31,8,1,0,1
-58,-38,-20,0,0,0
-2,-16,14,1,0,1
-5,-13,8,1,0,1
-6,-5,-1,0,0,0
-52,-43,-9,0,0,0
55,37,18,1,0,1
-38,-32,-6,0,0,0
20,16,4,1,0,1
13,2,11,1,0,1
-7,-20,13,1,0,1
-31,-33,2,1,0,1
10,28,-18,0,1,1
-44,-24,-20,0,1,1
-46,-42,-4,0,1,1
13,2,11,1,1,0
24,42,-18,0,1,1
-25,-37,12,1,1,0
-55,-42,-13,0,1,1
-27,-12,-15,0,1,1
11,6,5,1,1,0
5,14,-9,0,1,1
34,38,-4,0,1,1
50,40,10,1,1,0
-36,-20,-16,0,1,1
-56,-44,-12,0,1,1
6,-3,9,1,1,0
-57,-41,-16,0,0,0
22,7,15,1,0,1
-43,-38,-5,0,0,0
18,16,2,1,0,1
37,33,4,1,0,1
-27,-41,14,1,0,1
-3,5,-8,0,0,0
0,-17,17,1,0,1
-33,-43,10,1,0,1
5,17,-12,0,0,0
44,24,20,1,0,1
-12,-2,-10,0,1,1
23,27,-4,0,1,1
-3,-19,16,1,1,0
15,-1,16,1,1,0
11,14,-3,0,1,1
-45,-39,-6,0,1,1
-13,4,-17,0,1,1
-3,-5,2,1,1,0
-4,-10,6,1,1,0
-47,-27,-20,0,1,1
30,43,-13,0,1,1
-10,6,-16,0,1,1
20,9,11,1,1,0
46,36,10,1,1,0
-36,-24,-12,0,1,1
13,6,7,1,1,0
56,44,12,1,1,0
41,21,20,1,1,0
-18,-18,0,0,1,1
9,21,-12,0,1,1
28,13,15,1,0,1
18,0,18,1,0,1
-39,-33,-6,0,0,0
-51,-41,-10,0,0,0
2,14,-12,0,0,0
-16,-19,3,1,0,1
1,18,-17,0,0,0
28,33,-5,0,0,0
28,18,10,1,0,1
-15,-13,-2,0,0,0
26,35,-9,0,0,0
-25,-36,11,1,0,1
0,7,-7,0,0,0
-36,-33,-3,0,0,0
43,28,15,1,0,1
1,-12,13,1,0,1
30,31,-1,0,1,1
11,-9,20,1,1,0
-17,-4,-13,0,1,1
-34,-25,-9,0,1,1
-41,-29,-12,0,1,1
-39,-24,-15,0,1,1
-3,4,-7,0,1,1
18,14,4,1,1,0
59,40,19,1,1,0
39,32,7,1,1,0
-3,5,-8,0,1,1
14,7,7,1,1,0
-16,-4,-12,0,1,1
32,35,-3,0,1,1
-3,2,-5,0,1,1
-11,-1,-10,0,1,1
-7,12,-19,0,1,1
-28,-37,9,1,1,0
-15,-29,14,1,1,0
-14,-23,9,1,0,1
-45,-25,-20,0,0,0
-41,-24,-17,0,0,0
-43,-30,-13,0,0,0
-2,-4,2,1,0,1
7,-5,12,1,0,1
45,28,17,1,0,1
-3,6,-9,0,0,0
30,24,6,1,0,1
-14,-11,-3,0,0,0
45,29,16,1,0,1
-37,-20,-17,0,0,0
32,26,6,1,0,1
5,-14,19,1,0,1
38,19,19,1,0,1
-18,-9,-9,0,0,0
10,25,-15,0,0,0
7,-2,9,1,0,1
-22,-5,-17,0,0,0
13,23,-10,0,0,0
17,19,-2,0,0,0
12,15,-3,0,1,1
31,11,20,1,1,0
-36,-29,-7,0,1,1
48,40,8,1,1,0
-18,-28,10,1,1,0
-12,-11,-1,0,1,1
-27,-42,15,1,1,0
-20,0,-20,0,1,1
-38,-43,5,1,1,0
-64,-45,-19,0,1,1
24,29,-5,0,1,1
-32,-24,-8,0,1,1
26,34,-8,0,1,1
10,-8,18,1,1,0
-2,5,-7,0,1,1
5,20,-15,0,1,1
8,3,5,1,1,0
39,33,6,1,1,0
20,19,1,1,1,0
34,38,-4,0,1,1
-25,-18,-7,0,1,1
-10,-1,-9,0,0,0
-30,-25,-5,0,0,0
1,-16,17,1,0,1
-54,-35,-19,0,0,0
-63,-44,-19,0,0,0
-40,-31,-9,0,0,0
-39,-44,5,1,0,1
-14,-13,-1,0,0,0
2,16,-14,0,0,0
-13,-14,1,1,0,1
-28,-39,11,1,0,1
-46,-27,-19,0,0,0
-30,-24,-6,0,1,1
12,21,-9,0,1,1
-13,-33,20,1,1,0
-14,-26,12,1,1,0
41,37,4,1,1,0
-2,-5,3,1,1,0
25,20,5,1,1,0
-6,2,-8,0,1,1
-31,-44,13,1,1,0
18,30,-12,0,0,0
16,17,-1,0,0,0
13,32,-19,0,0,0
31,12,19,1,0,1
-18,-36,18,1,0,1
45,29,16,1,0,1
6,-6,12,1,0,1
17,11,6,1,0,1
50,32,18,1,0,1
12,22,-10,0,0,0
-39,-24,-15,0,0,0
22,32,-10,0,0,0
-40,-40,0,0,0,0
-17,-27,10,1,0,1
26,30,-4,0,0,0
14,28,-14,0,0,0
-6,-15,9,1,0,1
50,34,16,1,0,1
-28,-16,-12,0,0,0
64,44,20,1,0,1
26,22,4,1,0,1
15,23,-8,0,1,1
-39,-32,-7,0,1,1
17,15,2,1,1,0
11,4,7,1,1,0
-24,-16,-8,0,1,1
30,18,12,1,1,0
-11,6,-17,0,1,1
-54,-37,-17,0,1,1
-37,-20,-17,0,1,1
58,43,15,1,1,0
22,5,17,1,1,0
-7,6,-13,0,1,1
-31,-45,14,1,1,0
-23,-28,5,1,1,0
27,13,14,1,1,0
-17,-12,-5,0,0,0
-31,-35,4,1,0,1
35,22,13,1,0,1
42,28,14,1,0,1
-1,-21,20,1,0,1
31,15,16,1,0,1
9,7,2,1,0,1
-41,-28,-13,0,0,0
-47,-30,-17,0,1,1
51,42,9,1,1,0
28,43,-15,0,1,1
-10,3,-13,0,1,1
24,33,-9,0,1,1
54,44,10,1,1,0
-18,1,-19,0,1,1
-44,-32,-12,0,1,1
-26,-19,-7,0,1,1
34,25,9,1,1,0
-43,-32,-11,0,1,1
18,32,-14,0,1,1
-5,-21,16,1,1,0
35,43,-8,0,1,1
-9,-16,7,1,1,0
54,42,12,1,1,0
-18,-25,7,1,1,0
0,-2,2,1,1,0
15,14,1,1,1,0
-4,-13,9,1,1,0
-29,-21,-8,0,1,1
12,21,-9,0,0,0
-3,6,-9,0,0,0
50,40,10,1,0,1
-6,-23,17,1,0,1
-41,-36,-5,0,0,0
-37,-29,-8,0,0,0
-27,-25,-2,0,0,0
-58,-40,-18,0,0,0
-24,-7,-17,0,1,1
30,40,-10,0,1,1
34,25,9,1,1,0
21,5,16,1,1,0
-19,-33,14,1,1,0
-22,-9,-13,0,1,1
27,31,-4,0,1,1
38,20,18,1,1,0
6,10,-4,0,1,1
21,39,-18,0,1,1
-24,-7,-17,0,1,1
-40,-30,-10,0,1,1
57,44,13,1,1,0
50,31,19,1,1,0
27,15,12,1,1,0
7,9,-2,0,1,1
-11,-4,-7,0,1,1
26,6,20,1,0,1
4,11,-7,0,0,0
24,41,-17,0,0,0
18,26,-8,0,0,0
37,43,-6,0,0,0
4,22,-18,0,0,0
1,-17,18,1,0,1
27,33,-6,0,0,0
16,30,-14,0,0,0
21,14,7,1,0,1
28,11,17,1,0,1
19,16,3,1,1,0
42,34,8,1,1,0
-13,4,-17,0,1,1
-43,-25,-18,0,1,1
-2,15,-17,0,1,1
-42,-42,0,0,1,1
25,35,-10,0,1,1
25,16,9,1,1,0
-11,-6,-5,0,1,1
-58,-43,-15,0,0,0
-9,-29,20,1,0,1
14,8,6,1,0,1
-16,3,-19,0,0,0
-39,-45,6,1,0,1
-21,-20,-1,0,0,0
-14,3,-17,0,0,0
6,-8,14,1,0,1
-12,-31,19,1,0,1
-3,-14,11,1,0,1
-17,-28,11,1,0,1
5,8,-3,0,0,0
-3,3,-6,0,0,0
46,28,18,1,0,1
53,44,9,1,0,1
6,-4,10,1,0,1
17,6,11,1,0,1
-6,8,-14,0,0,0
-13,-21,8,1,1,0
-4,-22,18,1,1,0
-39,-31,-8,0,1,1
38,19,19,1,1,0
-35,-43,8,1,1,0
27,11,16,1,1,0
-44,-40,-4,0,1,1
34,14,20,1,1,0
8,17,-9,0,1,1
54,36,18,1,1,0
-15,4,-19,0,1,1
-14,-16,2,1,0,1
-9,11,-20,0,0,0
-16,0,-16,0,0,0
22,36,-14,0,0,0
41,24,17,1,0,1
42,28,14,1,0,1
-20,-31,11,1,0,1
-30,-28,-2,0,0,0
-20,-40,20,1,0,1
24,28,-4,0,0,0
-41,-30,-11,0,0,0
-11,-5,-6,0,0,0
3,2,1,1,0,1
6,18,-12,0,0,0
-5,-6,1,1,0,1
-40,-28,-12,0,0,0
-8,-1,-7,0,0,0
12,-5,17,1,0,1
18,23,-5,0,0,0
14,21,-7,0,0,0
-5,-9,4,1,0,1
17,33,-16,0,1,1
-13,5,-18,0,1,1
32,12,20,1,1,0
-29,-38,9,1,1,0
-41,-26,-15,0,1,1
-45,-44,-1,0,1,1
32,15,17,1,1,0
34,22,12,1,1,0
13,14,-1,0,0,0
28,30,-2,0,0,0
-29,-24,-5,0,0,0
-43,-25,-18,0,0,0
-4,-8,4,1,0,1
40,28,12,1,0,1
-8,-1,-7,0,0,0
33,25,8,1,0,1
-34,-29,-5,0,0,0
-43,-40,-3,0,0,0
11,17,-6,0,1,1
26,7,19,1,1,0
-34,-20,-14,0,1,1
13,-5,18,1,1,0
-13,-10,-3,0,1,1
1,18,-17,0,1,1
46,36,10,1,1,0
-57,-43,-14,0,1,1
6,26,-20,0,1,1
45,41,4,1,1,0
-25,-15,-10,0,1,1
52,37,15,1,1,0
-14,-5,-9,0,1,1
21,24,-3,0,1,1
43,41,2,1,1,0
0,-19,19,1,1,0
-49,-33,-16,0,1,1
-25,-20,-5,0,1,1
-7,-9,2,1,1,0
-17,-17,0,0,1,1
-57,-37,-20,0,1,1
-11,9,-20,0,0,0
37,44,-7,0,0,0
7,-9,16,1,0,1
8,11,-3,0,0,0
15,23,-8,0,0,0
39,38,1,1,0,1
-22,-4,-18,0,0,0
-31,-35,4,1,0,1
-36,-37,1,1,0,1
15,3,12,1,1,0
-58,-42,-16,0,1,1
16,0,16,1,1,0
-21,-7,-14,0,1,1
-25,-10,-15,0,1,1
-9,2,-11,0,1,1
22,5,17,1,1,0
23,3,20,1,1,0
36,35,1,1,1,0
-14,4,-18,0,1,1
-38,-19,-19,0,1,1
24,7,17,1,1,0
3,-16,19,1,1,0
14,0,14,1,1,0
-48,-36,-12,0,1,1
-34,-17,-17,0,1,1
-33,-42,9,1,1,0
-5,-20,15,1,1,0
40,21,19,1,1,0
21,13,8,1,1,0
-2,-5,3,1,1,0
-16,0,-16,0,0,0
38,34,4,1,0,1
12,-5,17,1,0,1
-22,-13,-9,0,0,0
-23,-34,11,1,0,1
-5,7,-12,0,0,0
-13,-9,-4,0,0,0
-22,-8,-14,0,0,0
5,9,-4,0,0,0
-52,-41,-11,0,0,0
-33,-32,-1,0,0,0
-55,-35,-20,0,0,0
36,30,6,1,0,1
41,35,6,1,0,1
45,34,11,1,0,1
20,30,-10,0,0,0
-15,-13,-2,0,0,0
7,23,-16,0,0,0
-16,-11,-5,0,0,0
-13,-16,3,1,0,1
-6,-23,17,1,0,1
-26,-11,-15,0,1,1
-15,-23,8,1,1,0
-14,-29,15,1,1,0
-28,-35,7,1,1,0
24,5,19,1,1,0
-5,-17,12,1,1,0
4,-8,12,1,1,0
32,25,7,1,1,0
7,-12,19,1,1,0
-6,6,-12,0,1,1
35,33,2,1,1,0
-42,-37,-5,0,1,1
37,43,-6,0,1,1
-26,-28,2,1,0,1
-43,-26,-17,0,0,0
-34,-14,-20,0,0,0
-30,-28,-2,0,0,0
-23,-38,15,1,0,1
39,33,6,1,0,1
-8,-7,-1,0,0,0
34,34,0,0,0,0
-11,-15,4,1,0,1
22,34,-12,0,0,0
16,5,11,1,0,1
-6,5,-11,0,0,0
-17,-22,5,1,0,1
41,34,7,1,0,1
-60,-41,-19,0,0,0
33,26,7,1,1,0
32,18,14,1,1,0
-12,-14,2,1,1,0
-46,-29,-17,0,1,1
-23,-12,-11,0,1,1
-38,-28,-10,0,1,1
55,37,18,1,1,0
55,39,16,1,1,0
20,25,-5,0,1,1
-51,-44,-7,0,1,1
37,21,16,1,1,0
-10,3,-13,0,1,1
19,30,-11,0,1,1
-9,-14,5,1,0,1
26,13,13,1,0,1
-7,-8,1,1,0,1
3,-15,18,1,0,1
47,28,19,1,0,1
24,35,-11,0,0,0
9,19,-10,0,0,0
14,31,-17,0,0,0
34,37,-3,0,0,0
-11,-31,20,1,0,1
18,9,9,1,0,1
2,-15,17,1,0,1
63,43,20,1,1,0
-10,3,-13,0,1,1
22,7,15,1,1,0
-30,-44,14,1,1,0
-57,-37,-20,0,1,1
-27,-24,-3,0,1,1
-39,-26,-13,0,1,1
44,37,7,1,1,0
33,44,-11,0,1,1
60,41,19,1,1,0
20,30,-10,0,1,1
50,36,14,1,1,0
11,11,0,0,1,1
8,10,-2,0,1,1
-49,-38,-11,0,1,1
-4,-14,10,1,1,0
36,44,-8,0,1,1
-8,-14,6,1,0,1
-3,5,-8,0,0,0
-16,0,-16,0,0,0
34,32,2,1,0,1
50,30,20,1,0,1
29,16,13,1,0,1
9,17,-8,0,0,0
-22,-34,12,1,0,1
-20,-11,-9,0,0,0
33,25,8,1,0,1
25,17,8,1,0,1
41,33,8,1,0,1
-35,-25,-10,0,0,0
25,33,-8,0,0,0
-52,-39,-13,0,0,0
31,11,20,1,0,1
21,11,10,1,0,1
56,41,15,1,0,1
-43,-34,-9,0,1,1
26,18,8,1,1,0
-12,8,-20,0,1,1
39,26,13,1,1,0
-51,-35,-16,0,1,1
-13,-17,4,1,1,0
2,14,-12,0,1,1
-11,1,-12,0,1,1
20,2,18,1,1,0
-24,-27,3,1,1,0
-4,-20,16,1,1,0
-16,-12,-4,0,1,1
-18,-26,8,1,1,0
24,6,18,1,1,0
-32,-29,-3,0,1,1
5,8,-3,0,1,1
-23,-43,20,1,1,0
28,40,-12,0,1,1
-37,-40,3,1,0,1
22,39,-17,0,0,0
6,-10,16,1,0,1
40,31,9,1,0,1
-4,-23,19,1,0,1
18,5,13,1,0,1
-40,-45,5,1,0,1
-33,-27,-6,0,0,0
-13,-17,4,1,0,1
-2,-1,-1,0,0,0
-26,-26,0,0,0,0
-2,6,-8,0,0,0
29,32,-3,0,0,0
-7,12,-19,0,0,0
21,36,-15,0,1,1
33,38,-5,0,1,1
41,37,4,1,1,0
-41,-43,2,1,1,0
-13,-29,16,1,1,0
44,38,6,1,1,0
14,6,8,1,1,0
28,9,19,1,1,0
-28,-8,-20,0,1,1
-12,-30,18,1,1,0
-14,-10,-4,0,1,1
49,34,15,1,0,1
-22,-17,-5,0,0,0
5,-2,7,1,0,1
-41,-32,-9,0,0,0
51,38,13,1,0,1
-27,-31,4,1,0,1
10,24,-14,0,0,0
-19,-35,16,1,0,1
33,38,-5,0,0,0
49,43,6,1,0,1
-4,7,-11,0,0,0
24,36,-12,0,0,0
31,16,15,1,0,1
-42,-45,3,1,0,1
-46,-43,-3,0,0,0
15,25,-10,0,0,0
36,43,-7,0,0,0
2,22,-20,0,0,0
-25,-44,19,1,0,1
44,32,12,1,0,1
27,29,-2,0,0,0
39,21,18,1,1,0
33,24,9,1,1,0
-29,-36,7,1,1,0
38,29,9,1,1,0
20,40,-20,0,1,1
9,5,4,1,1,0
25,35,-10,0,1,1
1,17,-16,0,1,1
3,20,-17,0,1,1
4,19,-15,0,1,1
47,29,18,1,1,0
-15,-33,18,1,1,0
6,-3,9,1,1,0
-10,1,-11,0,1,1
27,15,12,1,1,0
-45,-33,-12,0,1,1
26,31,-5,0,1,1
19,26,-7,0,1,1
2,5,-3,0,1,1
52,37,15,1,1,0
-25,-6,-19,0,1,1
25,39,-14,0,0,0
11,-8,19,1,0,1
-17,-33,16,1,0,1
-24,-35,11,1,0,1
-19,-18,-1,0,0,0
25,30,-5,0,0,0
-3,11,-14,0,0,0
-30,-25,-5,0,0,0
-12,-17,5,1,0,1
7,24,-17,0,0,0
32,17,15,1,0,1
-36,-20,-16,0,0,0
-40,-33,-7,0,0,0
-47,-39,-8,0,0,0
-32,-17,-15,0,0,0
12,11,1,1,0,1
-46,-38,-8,0,0,0
0,-20,20,1,0,1
-21,-27,6,1,0,1
34,37,-3,0,0,0
-43,-31,-12,0,0,0
37,23,14,1,1,0
-8,4,-12,0,1,1
-17,-11,-6,0,1,1
1,7,-6,0,1,1
-10,-21,11,1,1,0
-46,-35,-11,0,1,1
0,-5,5,1,1,0
13,7,6,1,1,0
10,-10,20,1,1,0
43,30,13,1,1,0
-24,-25,1,1,1,0
39,41,-2,0,0,0
3,-9,12,1,0,1
55,39,16,1,0,1
13,27,-14,0,0,0
-7,-9,2,1,0,1
26,13,13,1,0,1
-50,-37,-13,0,0,0
-45,-37,-8,0,0,0
39,19,20,1,0,1
-48,-42,-6,0,1,1
41,28,13,1,1,0
-24,-22,-2,0,1,1
24,14,10,1,1,0
-19,-38,19,1,1,0
0,11,-11,0,1,1
-22,-35,13,1,1,0
-30,-17,-13,0,1,1
-19,0,-19,0,1,1
44,40,4,1,1,0
27,21,6,1,0,1
-3,11,-14,0,0,0
7,25,-18,0,0,0
-4,-17,13,1,0,1
33,19,14,1,0,1
30,39,-9,0,0,0
-53,-33,-20,0,0,0
-50,-40,-10,0,0,0
26,20,6,1,0,1
-38,-43,5,1,0,1
19,1,18,1,0,1
21,14,7,1,0,1
3,-10,13,1,0,1
-32,-23,-9,0,0,0
-7,-12,5,1,0,1
38,24,14,1,0,1
23,17,6,1,0,1
-56,-37,-19,0,0,0
10,0,10,1,0,1
-12,-20,8,1,0,1
23,14,9,1,1,0
42,29,13,1,1,0
-25,-16,-9,0,1,1
12,-5,17,1,1,0
-29,-45,16,1,1,0
41,24,17,1,1,0
41,36,5,1,1,0
-5,7,-12,0,1,1
-31,-42,11,1,1,0
18,7,11,1,1,0
-5,-20,15,1,1,0
2,5,-3,0,1,1
30,18,12,1,1,0
-10,-28,18,1,1,0
-17,-12,-5,0,1,1
18,14,4,1,0,1
-8,-10,2,1,0,1
6,9,-3,0,0,0
-37,-17,-20,0,0,0
0,3,-3,0,0,0
13,7,6,1,0,1
44,29,15,1,0,1
25,20,5,1,0,1
-22,-2,-20,0,0,0
49,29,20,1,0,1
-41,-38,-3,0,0,0
-10,-5,-5,0,1,1
-25,-7,-18,0,1,1
-24,-43,19,1,1,0
-5,4,-9,0,1,1
-16,-10,-6,0,1,1
25,28,-3,0,1,1
11,30,-19,0,1,1
-3,-16,13,1,1,0
-26,-19,-7,0,1,1
54,37,17,1,0,1
-20,-17,-3,0,0,0
-47,-42,-5,0,0,0
-5,15,-20,0,0,0
-2,-6,4,1,0,1
-4,11,-15,0,0,0
46,27,19,1,0,1
-26,-17,-9,0,0,0
-21,-19,-2,0,0,0
2,6,-4,0,0,0
-20,0,-20,0,0,0
-17,3,-20,0,0,0
-18,-10,-8,0,0,0
21,10,11,1,1,0
5,-14,19,1,1,0
47,34,13,1,1,0
27,12,15,1,1,0
14,-3,17,1,1,0
49,44,5,1,1,0
33,34,-1,0,1,1
-27,-13,-14,0,1,1
-34,-34,0,0,1,1
-5,7,-12,0,1,1
60,42,18,1,1,0
-3,-11,8,1,1,0
-15,-21,6,1,0,1
-1,-10,9,1,0,1
-7,-6,-1,0,0,0
27,23,4,1,0,1
6,-6,12,1,0,1
-7,-21,14,1,0,1
11,16,-5,0,0,0
19,4,15,1,0,1
64,44,20,1,0,1
23,17,6,1,0,1
33,35,-2,0,0,0
-44,-34,-10,0,0,0
-40,-38,-2,0,0,0
15,12,3,1,1,0
19,3,16,1,1,0
18,9,9,1,1,0
-7,9,-16,0,1,1
-15,-24,9,1,1,0
-12,-32,20,1,1,0
7,13,-6,0,1,1
-9,10,-19,0,1,1
-10,5,-15,0,1,1
33,43,-10,0,1,1
30,15,15,1,1,0
60,40,20,1,1,0
-26,-32,6,1,1,0
-17,0,-17,0,1,1
-10,-25,15,1,1,0
12,15,-3,0,1,1
-40,-32,-8,0,1,1
-15,-10,-5,0,1,1
-55,-39,-16,0,1,1
55,35,20,1,1,0
11,2,9,1,1,0
-34,-36,2,1,0,1
24,26,-2,0,0,0
31,44,-13,0,0,0
-10,5,-15,0,0,0
-63,-43,-20,0,0,0
-40,-26,-14,0,0,0
-11,-5,-6,0,0,0
-29,-37,8,1,0,1
-37,-18,-19,0,0,0
-51,-32,-19,0,0,0
-31,-41,10,1,1,0
16,3,13,1,1,0
39,23,16,1,1,0
-3,-1,-2,0,1,1
-6,10,-16,0,1,1
-6,-2,-4,0,1,1
11,9,2,1,1,0
-21,-12,-9,0,1,1
-6,-14,8,1,0,1
-48,-40,-8,0,0,0
5,13,-8,0,0,0
22,31,-9,0,0,0
40,33,7,1,0,1
51,33,18,1,0,1
-62,-43,-19,0,0,0
28,11,17,1,0,1
-47,-42,-5,0,1,1
-20,-13,-7,0,1,1
6,6,0,0,1,1
9,4,5,1,1,0
39,35,4,1,1,0
2,16,-14,0,1,1
6,-6,12,1,1,0
-1,-7,6,1,1,0
15,30,-15,0,1,1
-15,1,-16,0,0,0
34,34,0,0,0,0
20,40,-20,0,0,0
21,23,-2,0,0,0
-19,-38,19,1,0,1
39,29,10,1,0,1
-18,-33,15,1,0,1
24,9,15,1,0,1
-17,-22,5,1,0,1
-15,-15,0,0,0,0
-29,-40,11,1,0,1
20,37,-17,0,0,0
-11,-29,18,1,0,1
48,32,16,1,0,1
37,29,8,1,0,1
-9,-3,-6,0,0,0
-47,-32,-15,0,0,0
7,11,-4,0,0,0
18,21,-3,0,0,0
-47,-30,-17,0,0,0
15,20,-5,0,0,0
7,4,3,1,1,0
6,19,-13,0,1,1
8,23,-15,0,1,1
34,23,11,1,1,0
-31,-41,10,1,1,0
42,25,17,1,1,0
34,41,-7,0,1,1
-14,-13,-1,0,1,1
-34,-27,-7,0,1,1
-2,16,-18,0,1,1
40,39,1,1,1,0
-11,-19,8,1,1,0
27,22,5,1,1,0
33,28,5,1,0,1
10,11,-1,0,0,0
27,35,-8,0,0,0
-28,-22,-6,0,0,0
14,12,2,1,0,1
22,41,-19,0,0,0
51,39,12,1,0,1
-12,-14,2,1,0,1
6,14,-8,0,1,1
2,0,2,1,1,0
-6,-20,14,1,1,0
17,36,-19,0,1,1
-49,-37,-12,0,1,1
26,34,-8,0,1,1
-44,-31,-13,0,1,1
22,4,18,1,1,0
-30,-41,11,1,1,0
-21,-16,-5,0,1,1
36,38,-2,0,0,0
26,10,16,1,0,1
12,4,8,1,0,1
-37,-34,-3,0,0,0
44,32,12,1,0,1
-27,-34,7,1,0,1
5,-13,18,1,0,1
28,17,11,1,0,1
27,11,16,1,0,1
17,36,-19,0,0,0
20,39,-19,0,0,0
39,19,20,1,0,1
-43,-45,2,1,0,1
45,31,14,1,0,1
-24,-15,-9,0,0,0
8,7,1,1,0,1
-40,-33,-7,0,0,0
-18,-31,13,1,0,1
-16,-17,1,1,0,1
-21,-36,15,1,0,1
35,27,8,1,0,1
-19,-19,0,0,1,1
40,41,-1,0,1,1
15,12,3,1,1,0
-16,-29,13,1,1,0
-55,-39,-16,0,1,1
25,30,-5,0,1,1
33,39,-6,0,1,1
46,36,10,1,1,0
5,22,-17,0,1,1
0,2,-2,0,1,1
11,10,1,1,0,1
23,20,3,1,0,1
22,6,16,1,0,1
-25,-10,-15,0,0,0
-31,-36,5,1,0,1
-5,-22,17,1,0,1
27,20,7,1,0,1
-43,-37,-6,0,0,0
31,38,-7,0,0,0
27,38,-11,0,0,0
-1,17,-18,0,0,0
5,12,-7,0,0,0
16,31,-15,0,0,0
23,31,-8,0,0,0
4,-8,12,1,0,1
13,5,8,1,0,1
-3,-6,3,1,1,0
1,9,-8,0,1,1
-56,-39,-17,0,1,1
24,15,9,1,1,0
27,33,-6,0,1,1
-44,-33,-11,0,1,1
1,-5,6,1,1,0
46,35,11,1,1,0
28,25,3,1,1,0
8,-6,14,1,1,0
-20,-35,15,1,1,0
-28,-36,8,1,1,0
25,17,8,1,1,0
20,35,-15,0,1,1
4,-8,12,1,1,0
-20,-30,10,1,1,0
-8,6,-14,0,1,1
31,17,14,1,1,0
-19,-21,2,1,1,0
-4,-1,-3,0,1,1
-50,-45,-5,0,1,1
-31,-14,-17,0,0,0
27,36,-9,0,0,0
4,-13,17,1,0,1
-2,2,-4,0,0,0
-10,-5,-5,0,0,0
29,38,-9,0,0,0
28,40,-12,0,0,0
-38,-41,3,1,0,1
24,32,-8,0,0,0
0,20,-20,0,0,0
-27,-29,2,1,0,1
1,-3,4,1,0,1
-41,-45,4,1,0,1
32,33,-1,0,0,0
-39,-24,-15,0,0,0
23,21,2,1,0,1
-41,-23,-18,0,0,0
31,24,7,1,0,1
-32,-36,4,1,0,1
-15,-16,1,1,0,1
30,41,-11,0,0,0
20,1,19,1,1,0
-14,-2,-12,0,1,1
-23,-18,-5,0,1,1
-30,-40,10,1,1,0
-31,-36,5,1,1,0
54,35,19,1,1,0
-12,-28,16,1,1,0
34,38,-4,0,1,1
10,16,-6,0,1,1
40,38,2,1,1,0
10,-4,14,1,1,0
6,5,1,1,1,0
-20,-13,-7,0,1,1
49,43,6,1,1,0
-19,-12,-7,0,1,1
-25,-6,-19,0,0,0
53,44,9,1,0,1
-15,-18,3,1,0,1
1,0,1,1,0,1
-13,7,-20,0,0,0
-44,-35,-9,0,0,0
59,39,20,1,0,1
-50,-44,-6,0,0,0
14,2,12,1,0,1
15,-5,20,1,0,1
36,21,15,1,0,1
-24,-17,-7,0,0,0
-9,-5,-4,0,1,1
14,6,8,1,1,0
18,3,15,1,1,0
-38,-40,2,1,1,0
-25,-17,-8,0,1,1
-15,0,-15,0,1,1
13,19,-6,0,1,1
6,-2,8,1,1,0
5,18,-13,0,0,0
-25,-32,7,1,0,1
-15,-16,1,1,0,1
-45,-30,-15,0,0,0
-7,9,-16,0,0,0
-36,-32,-4,0,0,0
16,11,5,1,0,1
-35,-24,-11,0,0,0
-37,-43,6,1,0,1
36,27,9,1,0,1
-17,-5,-12,0,0,0
39,32,7,1,0,1
-39,-38,-1,0,0,0
-19,-1,-18,0,0,0
20,14,6,1,0,1
-23,-28,5,1,1,0
-15,-3,-12,0,1,1
-45,-29,-16,0,1,1
-1,10,-11,0,1,1
-30,-18,-12,0,1,1
40,34,6,1,1,0
-24,-29,5,1,1,0
-22,-8,-14,0,1,1
-1,-3,2,1,1,0
-22,-3,-19,0,1,1
-16,-2,-14,0,1,1
-33,-27,-6,0,0,0
-21,-32,11,1,0,1
13,18,-5,0,0,0
-38,-28,-10,0,0,0
21,23,-2,0,0,0
-4,12,-16,0,0,0
-14,-8,-6,0,0,0
17,6,11,1,0,1
-42,-24,-18,0,0,0
-40,-24,-16,0,0,0
-22,-37,15,1,0,1
-23,-31,8,1,0,1
11,-4,15,1,1,0
15,22,-7,0,1,1
1,6,-5,0,1,1
-13,-21,8,1,1,0
-24,-38,14,1,1,0
31,14,17,1,1,0
-46,-44,-2,0,1,1
29,17,12,1,1,0
9,-8,17,1,1,0
26,11,15,1,1,0
25,13,12,1,1,0
-4,-4,0,0,1,1
-10,-17,7,1,1,0
11,12,-1,0,1,1
15,6,9,1,1,0
-17,-31,14,1,1,0
-2,-18,16,1,1,0
-24,-29,5,1,1,0
-55,-37,-18,0,0,0
1,-1,2,1,0,1
-6,-2,-4,0,0,0
43,31,12,1,0,1
14,15,-1,0,0,0
29,24,5,1,0,1
33,14,19,1,0,1
-34,-40,6,1,0,1
-9,-28,19,1,0,1
28,12,16,1,1,0
49,38,11,1,1,0
46,28,18,1,1,0
27,25,2,1,1,0
46,43,3,1,1,0
-56,-42,-14,0,1,1
-40,-25,-15,0,1,1
-53,-45,-8,0,1,1
-37,-39,2,1,1,0
-20,-16,-4,0,0,0
-50,-37,-13,0,0,0
-16,4,-20,0,0,0
-19,-27,8,1,0,1
52,32,20,1,0,1
42,41,1,1,0,1
-36,-21,-15,0,0,0
28,21,7,1,0,1
-10,-18,8,1,0,1
-46,-37,-9,0,0,0
-2,-21,19,1,0,1
34,42,-8,0,0,0
-44,-30,-14,0,0,0
-17,3,-20,0,0,0
-7,-12,5,1,0,1
-7,-20,13,1,0,1
1,13,-12,0,0,0
-7,-3,-4,0,0,0
-42,-27,-15,0,0,0
-22,-40,18,1,0,1
20,40,-20,0,0,0
-42,-40,-2,0,1,1
12,15,-3,0,1,1
-12,-22,10,1,1,0
9,15,-6,0,1,1
8,0,8,1,1,0
27,37,-10,0,1,1
29,33,-4,0,1,1
-2,2,-4,0,1,1
25,39,-14,0,1,1
-8,-23,15,1,1,0
27,35,-8,0,1,1
16,11,5,1,1,0
-28,-25,-3,0,1,1
-41,-45,4,1,0,1
-1,4,-5,0,0,0
-56,-39,-17,0,0,0
0,-11,11,1,0,1
3,9,-6,0,0,0
33,32,1,1,0,1
-23,-32,9,1,0,1
31,36,-5,0,0,0
-2,-20,18,1,0,1
-22,-12,-10,0,0,0
45,36,9,1,0,1
19,18,1,1,0,1
-17,-17,0,0,0,0
35,18,17,1,0,1
-8,-17,9,1,1,0
9,13,-4,0,1,1
29,17,12,1,1,0
-20,-12,-8,0,1,1
2,9,-7,0,1,1
31,14,17,1,1,0
2,-17,19,1,1,0
-28,-33,5,1,1,0
-14,-13,-1,0,1,1
28,35,-7,0,1,1
27,17,10,1,1,0
21,40,-19,0,1,1
-29,-33,4,1,1,0
-9,-2,-7,0,1,1
45,38,7,1,1,0
34,37,-3,0,1,1
19,39,-20,0,1,1
17,28,-11,0,1,1
39,40,-1,0,1,1
-3,-23,20,1,1,0
42,40,2,1,1,0
-4,-6,2,1,0,1
-48,-29,-19,0,0,0
-35,-25,-10,0,0,0
36,25,11,1,0,1
35,32,3,1,0,1
15,0,15,1,0,1
-36,-33,-3,0,0,0
33,43,-10,0,0,0
0,-7,7,1,0,1
-30,-26,-4,0,0,0
-14,-10,-4,0,0,0
-8,8,-16,0,0,0
-21,-26,5,1,0,1
-3,-23,20,1,0,1
-11,-12,1,1,0,1
31,35,-4,0,0,0
-20,-27,7,1,0,1
-45,-38,-7,0,0,0
-20,-5,-15,0,0,0
-46,-34,-12,0,0,0
5,8,-3,0,0,0
12,-6,18,1,1,0
-9,-6,-3,0,1,1
10,16,-6,0,1,1
32,41,-9,0,1,1
52,38,14,1,1,0
25,39,-14,0,1,1
1,-16,17,1,1,0
-28,-42,14,1,1,0
16,16,0,0,1,1
-45,-39,-6,0,1,1
-5,-10,5,1,1,0
14,33,-19,0,1,1
13,11,2,1,1,0
-43,-36,-7,0,1,1
-30,-18,-12,0,1,1
-19,-1,-18,0,0,0
41,41,0,0,0,0
-6,-11,5,1,0,1
-42,-29,-13,0,0,0
4,19,-15,0,0,0
9,22,-13,0,0,0
52,41,11,1,0,1
-10,-8,-2,0,0,0
-5,15,-20,0,0,0
-4,-12,8,1,0,1
-16,-15,-1,0,0,0
46,30,16,1,0,1
-31,-24,-7,0,1,1
-15,-1,-14,0,1,1
1,9,-8,0,1,1
15,17,-2,0,1,1
44,36,8,1,1,0
4,6,-2,0,1,1
-2,15,-17,0,1,1
-34,-34,0,0,1,1
-6,-1,-5,0,1,1
-22,-37,15,1,1,0
3,-3,6,1,1,0
6,9,-3,0,1,1
23,27,-4,0,1,1
19,3,16,1,1,0
-30,-35,5,1,1,0
21,1,20,1,1,0
10,11,-1,0,1,1
-17,-28,11,1,1,0
33,23,10,1,1,0
42,28,14,1,1,0
-6,-16,10,1,1,0
-21,-6,-15,0,0,0
-61,-41,-20,0,0,0
5,16,-11,0,0,0
2,17,-15,0,0,0
-36,-16,-20,0,0,0
50,44,6,1,0,1
-6,-3,-3,0,0,0
-32,-22,-10,0,0,0
17,21,-4,0,0,0
-53,-41,-12,0,0,0
11,-4,15,1,0,1
-24,-11,-13,0,0,0
-39,-43,4,1,0,1
4,16,-12,0,0,0
5,6,-1,0,0,0
-5,6,-11,0,0,0
-35,-17,-18,0,0,0
9,2,7,1,0,1
-17,-28,11,1,0,1
-49,-45,-4,0,0,0
35,32,3,1,1,0
6,-6,12,1,1,0
42,32,10,1,1,0
5,-12,17,1,1,0
-43,-24,-19,0,1,1
-28,-8,-20,0,1,1
-3,3,-6,0,1,1
-54,-34,-20,0,1,1
16,31,-15,0,1,1
-37,-32,-5,0,1,1
-28,-19,-9,0,1,1
49,29,20,1,1,0
-10,-28,18,1,0,1
44,37,7,1,0,1
27,16,11,1,0,1
10,-9,19,1,0,1
16,25,-9,0,0,0
-31,-35,4,1,0,1
62,42,20,1,0,1
-35,-41,6,1,0,1
9,25,-16,0,0,0
-48,-41,-7,0,0,0
23,39,-16,0,0,0
17,37,-20,0,0,0
17,1,16,1,0,1
5,22,-17,0,0,0
-46,-34,-12,0,0,0
49,38,11,1,0,1
-5,-18,13,1,0,1
55,39,16,1,0,1
34,23,11,1,0,1
-33,-24,-9,0,0,0
4,-2,6,1,0,1
-16,-2,-14,0,1,1
-41,-29,-12,0,1,1
35,20,15,1,1,0
-19,0,-19,0,1,1
13,6,7,1,1,0
4,23,-19,0,1,1
-9,-27,18,1,1,0
19,20,-1,0,1,1
22,3,19,1,1,0
4,12,-8,0,1,1
-51,-38,-13,0,1,1
-19,-12,-7,0,1,1
-9,-20,11,1,1,0
5,-13,18,1,1,0
-23,-21,-2,0,1,1
-7,0,-7,0,1,1
-6,-7,1,1,0,1
11,13,-2,0,0,0
12,18,-6,0,0,0
25,41,-16,0,0,0
24,41,-17,0,0,0
35,21,14,1,0,1
-4,13,-17,0,0,0
14,2,12,1,0,1
9,4,5,1,0,1
-60,-42,-18,0,0,0
0,-13,13,1,0,1
-48,-36,-12,0,0,0
-8,3,-11,0,0,0
-16,-16,0,0,1,1
-15,-12,-3,0,1,1
-23,-40,17,1,1,0
-4,-13,9,1,1,0
-21,-18,-3,0,1,1
-10,-10,0,0,1,1
6,-12,18,1,1,0
-9,-16,7,1,1,0
-52,-44,-8,0,1,1
-10,-2,-8,0,1,1
-32,-14,-18,0,1,1
48,44,4,1,1,0
-1,14,-15,0,1,1
-43,-43,0,0,1,1
15,15,0,0,1,1
-47,-44,-3,0,1,1
-21,-26,5,1,1,0
-19,-39,20,1,1,0
-9,-2,-7,0,1,1
-3,-8,5,1,1,0
-25,-40,15,1,1,0
40,40,0,0,0,0
41,43,-2,0,0,0
-11,-31,20,1,0,1
-28,-11,-17,0,0,0
-17,-7,-10,0,0,0
36,17,19,1,0,1
2,20,-18,0,0,0
2,9,-7,0,0,0
53,36,17,1,0,1
-2,3,-5,0,0,0
-23,-9,-14,0,0,0
-23,-42,19,1,0,1
-2,3,-5,0,0,0
-29,-14,-15,0,0,0
-34,-17,-17,0,0,0
13,11,2,1,1,0
23,38,-15,0,1,1
36,20,16,1,1,0
-13,2,-15,0,1,1
49,32,17,1,1,0
1,6,-5,0,1,1
0,-3,3,1,1,0
-5,15,-20,0,1,1
-26,-10,-16,0,1,1
28,23,5,1,1,0
5,-14,19,1,0,1
10,-5,15,1,0,1
-7,-20,13,1,0,1
4,-2,6,1,0,1
-44,-41,-3,0,0,0
22,16,6,1,0,1
-38,-21,-17,0,0,0
-28,-25,-3,0,0,0
-4,-18,14,1,0,1
-23,-19,-4,0,0,0
-22,-35,13,1,1,0
-10,-5,-5,0,1,1
59,44,15,1,1,0
-57,-45,-12,0,1,1
-26,-25,-1,0,1,1
17,17,0,0,1,1
11,12,-1,0,1,1
23,3,20,1,1,0
-14,3,-17,0,1,1
-15,4,-19,0,1,1
-44,-30,-14,0,1,1
-27,-24,-3,0,1,1
18,12,6,1,1,0
-14,-31,17,1,0,1
-39,-45,6,1,0,1
-2,-18,16,1,0,1
7,6,1,1,0,1
20,14,6,1,0,1
5,-7,12,1,0,1
-59,-40,-19,0,0,0
-39,-33,-6,0,0,0
-34,-28,-6,0,1,1
11,25,-14,0,1,1
36,21,15,1,1,0
22,33,-11,0,1,1
47,32,15,1,1,0
5,-9,14,1,1,0
-23,-15,-8,0,1,1
-25,-35,10,1,1,0
51,40,11,1,1,0
43,39,4,1,1,0
28,28,0,0,1,1
46,31,15,1,1,0
31,20,11,1,1,0
-47,-42,-5,0,1,1
33,39,-6,0,1,1
54,36,18,1,1,0
26,26,0,0,0,0
18,31,-13,0,0,0
0,-4,4,1,0,1
-12,-11,-1,0,0,0
-4,-1,-3,0,0,0
-6,-21,15,1,0,1
13,23,-10,0,0,0
-15,-12,-3,0,0,0
9,-8,17,1,0,1
-29,-34,5,1,0,1
-7,-9,2,1,0,1
11,22,-11,0,0,0
40,42,-2,0,0,0
-61,-43,-18,0,0,0
24,22,2,1,0,1
7,17,-10,0,0,0
-27,-22,-5,0,0,0
-13,-9,-4,0,0,0
-30,-38,8,1,0,1
23,42,-19,0,1,1
26,7,19,1,1,0
-26,-41,15,1,1,0
24,36,-12,0,1,1
9,2,7,1,1,0
-22,-17,-5,0,1,1
49,29,20,1,1,0
4,-2,6,1,1,0
47,31,16,1,1,0
29,43,-14,0,0,0
-10,-30,20,1,0,1
-41,-30,-11,0,0,0
-11,-28,17,1,0,1
-6,-22,16,1,0,1
-13,-28,15,1,0,1
18,-2,20,1,0,1
42,37,5,1,0,1
-35,-31,-4,0,0,0
-8,11,-19,0,0,0
-48,-41,-7,0,0,0
27,27,0,0,0,0
-3,5,-8,0,0,0
-42,-31,-11,0,0,0
33,29,4,1,0,1
8,-5,13,1,0,1
54,35,19,1,0,1
27,19,8,1,0,1
16,-2,18,1,0,1
-25,-29,4,1,0,1
43,30,13,1,0,1
-43,-40,-3,0,1,1
-30,-10,-20,0,1,1
8,-9,17,1,1,0
7,1,6,1,1,0
57,39,18,1,1,0
-4,3,-7,0,1,1
36,26,10,1,1,0
9,-9,18,1,1,0
-35,-24,-11,0,1,1
13,0,13,1,1,0
-36,-23,-13,0,1,1
6,-14,20,1,1,0
-37,-21,-16,0,1,1
-11,8,-19,0,1,1
-49,-40,-9,0,1,1
18,12,6,1,1,0
56,44,12,1,1,0
9,-10,19,1,1,0
25,8,17,1,1,0
-48,-38,-10,0,1,1
24,35,-11,0,0,0
36,38,-2,0,0,0
-32,-40,8,1,0,1
-27,-13,-14,0,0,0
40,33,7,1,0,1
-15,-8,-7,0,0,0
-4,-15,11,1,0,1
-27,-26,-1,0,0,0
33,41,-8,0,0,0
-12,-31,19,1,1,0
-15,-5,-10,0,1,1
49,31,18,1,1,0
-30,-25,-5,0,1,1
11,25,-14,0,1,1
-27,-17,-10,0,1,1
22,7,15,1,1,0
9,0,9,1,1,0
24,44,-20,0,1,1
-21,-36,15,1,1,0
-2,16,-18,0,1,1
29,41,-12,0,1,1
23,42,-19,0,1,1
21,2,19,1,1,0
8,-2,10,1,1,0
5,15,-10,0,1,1
-24,-19,-5,0,1,1
24,41,-17,0,1,1
-1,17,-18,0,1,1
-2,5,-7,0,1,1
31,41,-10,0,0,0
-3,0,-3,0,0,0
20,17,3,1,0,1
1,1,0,0,0,0
4,-6,10,1,0,1
-1,-7,6,1,0,1
-13,-32,19,1,0,1
22,21,1,1,0,1
-31,-28,-3,0,1,1
-21,-27,6,1,1,0
-16,-32,16,1,1,0
-26,-34,8,1,1,0
61,43,18,1,1,0
-13,-10,-3,0,1,1
-25,-38,13,1,1,0
-29,-43,14,1,1,0
27,23,4,1,1,0
39,36,3,1,1,0
54,37,17,1,1,0
45,43,2,1,1,0
27,7,20,1,1,0
-10,9,-19,0,0,0
-22,-41,19,1,0,1
-15,-35,20,1,0,1
30,11,19,1,0,1
21,12,9,1,0,1
-11,-28,17,1,0,1
-51,-37,-14,0,0,0
-34,-38,4,1,0,1
35,15,20,1,0,1
29,19,10,1,0,1
-24,-33,9,1,0,1
-51,-38,-13,0,0,0
-26,-11,-15,0,0,0
-14,2,-16,0,0,0
-44,-30,-14,0,0,0
-55,-40,-15,0,0,0
42,24,18,1,0,1
0,-8,8,1,0,1
36,24,12,1,0,1
4,12,-8,0,0,0
-31,-14,-17,0,0,0
8,5,3,1,1,0
14,-1,15,1,1,0
-58,-44,-14,0,1,1
9,6,3,1,1,0
-9,-4,-5,0,1,1
36,37,-1,0,1,1
-15,-23,8,1,1,0
33,32,1,1,1,0
-26,-30,4,1,1,0
25,8,17,1,1,0
0,-20,20,1,1,0
8,21,-13,0,1,1
5,4,1,1,1,0
57,39,18,1,1,0
15,31,-16,0,0,0
-55,-43,-12,0,0,0
-37,-29,-8,0,0,0
12,31,-19,0,0,0
-19,-30,11,1,0,1
2,-8,10,1,0,1
-39,-25,-14,0,0,0
-34,-41,7,1,0,1
-41,-44,3,1,0,1
12,31,-19,0,0,0
16,4,12,1,0,1
43,32,11,1,0,1
39,19,20,1,0,1
48,42,6,1,0,1
8,0,8,1,0,1
-10,-11,1,1,0,1
24,32,-8,0,0,0
-49,-29,-20,0,0,0
-55,-38,-17,0,1,1
-39,-45,6,1,1,0
49,33,16,1,1,0
-19,-6,-13,0,1,1
41,27,14,1,1,0
15,8,7,1,1,0
54,44,10,1,1,0
6,15,-9,0,1,1
-21,-23,2,1,1,0
33,37,-4,0,1,1
45,31,14,1,1,0
-58,-42,-16,0,1,1
-1,13,-14,0,1,1
-39,-39,0,0,1,1
-20,-18,-2,0,1,1
-24,-23,-1,0,1,1
-25,-6,-19,0,1,1
48,38,10,1,1,0
20,14,6,1,1,0
15,15,0,0,1,1
12,23,-11,0,1,1
0,11,-11,0,0,0
21,25,-4,0,0,0
-60,-45,-15,0,0,0
-1,-15,14,1,0,1
28,21,7,1,0,1
-17,-28,11,1,0,1
-2,11,-13,0,0,0
-7,-19,12,1,0,1
-3,-6,3,1,0,1
-9,-14,5,1,0,1
39,42,-3,0,0,0
-26,-6,-20,0,1,1
-22,-20,-2,0,1,1
-33,-31,-2,0,1,1
-33,-23,-10,0,1,1
-2,-6,4,1,1,0
-17,-35,18,1,1,0
-52,-43,-9,0,1,1
-2,0,-2,0,1,1
8,14,-6,0,1,1
-34,-34,0,0,1,1
33,42,-9,0,1,1
-23,-29,6,1,1,0
-28,-16,-12,0,0,0
-39,-34,-5,0,0,0
31,37,-6,0,0,0
27,35,-8,0,0,0
-5,7,-12,0,0,0
33,36,-3,0,0,0
-5,-6,1,1,0,1
-14,6,-20,0,0,0
-4,-7,3,1,0,1
-25,-26,1,1,0,1
2,4,-2,0,0,0
-15,-28,13,1,1,0
-42,-42,0,0,1,1
-17,-29,12,1,1,0
59,44,15,1,1,0
-10,-29,19,1,1,0
-55,-38,-17,0,1,1
-32,-38,6,1,1,0
57,37,20,1,1,0
-12,-26,14,1,1,0
-57,-39,-18,0,1,1
-14,-4,-10,0,1,1
-4,-7,3,1,1,0
6,10,-4,0,1,1
-12,-16,4,1,1,0
21,21,0,0,1,1
34,17,17,1,1,0
-17,3,-20,0,1,1
25,36,-11,0,1,1
-20,-23,3,1,1,0
37,26,11,1,1,0
-17,-33,16,1,1,0
58,41,17,1,0,1
-52,-33,-19,0,0,0
7,-5,12,1,0,1
5,4,1,1,0,1
38,44,-6,0,0,0
-46,-43,-3,0,0,0
-35,-15,-20,0,0,0
-2,-5,3,1,0,1
-37,-37,0,0,1,1
-46,-26,-20,0,1,1
-22,-13,-9,0,1,1
16,6,10,1,1,0
48,30,18,1,1,0
-22,-28,6,1,1,0
50,43,7,1,1,0
-1,-16,15,1,1,0
24,10,14,1,1,0
-1,-8,7,1,1,0
-6,-24,18,1,1,0
-12,-22,10,1,1,0
3,-11,14,1,1,0
-43,-33,-10,0,1,1
-27,-25,-2,0,1,1
-17,-7,-10,0,1,1
-47,-36,-11,0,1,1
-12,-18,6,1,1,0
-40,-41,1,1,1,0
42,28,14,1,1,0
35,40,-5,0,1,1
23,42,-19,0,0,0
-31,-12,-19,0,0,0
-19,-24,5,1,0,1
-50,-32,-18,0,0,0
-5,11,-16,0,0,0
3,-12,15,1,0,1
25,38,-13,0,0,0
-47,-38,-9,0,0,0
-12,-13,1,1,0,1
38,40,-2,0,0,0
-50,-41,-9,0,0,0
4,18,-14,0,0,0
-50,-44,-6,0,0,0
1,-18,19,1,0,1
-50,-45,-5,0,0,0
-26,-34,8,1,0,1
-2,13,-15,0,0,0
-23,-19,-4,0,0,0
-4,-22,18,1,0,1
-24,-27,3,1,0,1
-17,-36,19,1,0,1
-53,-39,-14,0,1,1
21,10,11,1,1,0
63,44,19,1,1,0
-30,-19,-11,0,1,1
-24,-43,19,1,1,0
36,21,15,1,1,0
-29,-43,14,1,1,0
50,37,13,1,1,0
17,35,-18,0,1,1
39,41,-2,0,1,1
39,43,-4,0,1,1
13,12,1,1,1,0
-6,0,-6,0,1,1
14,34,-20,0,1,1
28,21,7,1,1,0
-56,-44,-12,0,1,1
-35,-32,-3,0,1,1
58,38,20,1,1,0
11,19,-8,0,1,1
32,18,14,1,1,0
-44,-40,-4,0,0,0
9,4,5,1,0,1
-40,-43,3,1,0,1
-18,-37,19,1,0,1
7,21,-14,0,0,0
-50,-31,-19,0,0,0
-3,-17,14,1,0,1
-16,-22,6,1,0,1
28,31,-3,0,0,0
25,19,6,1,0,1
33,44,-11,0,0,0
51,41,10,1,0,1
37,23,14,1,0,1
-28,-42,14,1,0,1
-1,-17,16,1,0,1
21,14,7,1,0,1
-16,1,-17,0,0,0
19,17,2,1,0,1
-17,-22,5,1,0,1
6,22,-16,0,0,0
-22,-15,-7,0,1,1
36,40,-4,0,1,1
20,39,-19,0,1,1
-31,-17,-14,0,1,1
-30,-20,-10,0,1,1
-48,-43,-5,0,1,1
23,32,-9,0,1,1
-5,-3,-2,0,1,1
1,16,-15,0,1,1
30,11,19,1,1,0
-34,-35,1,1,1,0
-5,7,-12,0,1,1
-61,-44,-17,0,1,1
33,21,12,1,1,0
7,4,3,1,1,0
-40,-40,0,0,1,1
33,44,-11,0,1,1
5,12,-7,0,1,1
-7,-13,6,1,1,0
24,10,14,1,1,0
19,27,-8,0,1,1
-56,-44,-12,0,0,0
-40,-41,1,1,0,1
-1,8,-9,0,0,0
18,18,0,0,0,0
47,44,3,1,0,1
43,39,4,1,0,1
4,-13,17,1,0,1
-28,-13,-15,0,0,0
35,19,16,1,0,1
25,15,10,1,0,1
4,-8,12,1,0,1
22,26,-4,0,0,0
-30,-25,-5,0,0,0
29,13,16,1,0,1
28,38,-10,0,0,0
-38,-19,-19,0,0,0
24,23,1,1,0,1
-40,-43,3,1,0,1
-34,-44,10,1,0,1
59,39,20,1,0,1
14,4,10,1,0,1
7,15,-8,0,1,1
-14,-32,18,1,1,0
-34,-44,10,1,1,0
-3,17,-20,0,1,1
-11,-26,15,1,1,0
38,30,8,1,1,0
24,19,5,1,1,0
-23,-4,-19,0,1,1
63,43,20,1,1,0
-47,-33,-14,0,1,1
-20,-39,19,1,1,0
15,-1,16,1,1,0
-30,-11,-19,0,1,1
-24,-9,-15,0,1,1
-19,-30,11,1,1,0
49,39,10,1,1,0
-33,-14,-19,0,1,1
12,1,11,1,0,1
-46,-28,-18,0,0,0
-53,-35,-18,0,0,0
-53,-35,-18,0,0,0
-53,-38,-15,0,0,0
31,11,20,1,0,1
44,35,9,1,0,1
-20,-3,-17,0,0,0
12,27,-15,0,1,1
21,9,12,1,1,0
2,20,-18,0,1,1
9,-10,19,1,1,0
-2,-20,18,1,1,0
16,18,-2,0,1,1
10,22,-12,0,1,1
23,27,-4,0,1,1
39,20,19,1,1,0
29,17,12,1,1,0
7,-4,11,1,1,0
-34,-28,-6,0,1,1
-12,-26,14,1,1,0
51,43,8,1,1,0
-7,-2,-5,0,1,1
-19,-26,7,1,1,0
-28,-39,11,1,1,0
27,7,20,1,1,0
25,41,-16,0,1,1
38,24,14,1,1,0
31,27,4,1,0,1
42,29,13,1,0,1
20,17,3,1,0,1
38,21,17,1,0,1
-18,-9,-9,0,0,0
-13,0,-13,0,0,0
56,42,14,1,0,1
16,9,7,1,0,1
-37,-39,2,1,0,1
-28,-31,3,1,0,1
22,4,18,1,0,1
-33,-42,9,1,0,1
-17,-34,17,1,1,0
-4,-3,-1,0,1,1
-42,-45,3,1,1,0
-1,1,-2,0,1,1
-21,-25,4,1,1,0
-16,-3,-13,0,1,1
39,43,-4,0,1,1
-12,-12,0,0,1,1
-54,-40,-14,0,1,1
-5,8,-13,0,1,1
42,37,5,1,1,0
-57,-40,-17,0,1,1
22,7,15,1,1,0
15,34,-19,0,1,1
-13,-15,2,1,1,0
-25,-16,-9,0,1,1
-48,-40,-8,0,1,1
10,7,3,1,1,0
4,18,-14,0,1,1
8,15,-7,0,1,1
12,18,-6,0,1,1
8,15,-7,0,0,0
22,15,7,1,0,1
20,11,9,1,0,1
-44,-34,-10,0,0,0
3,23,-20,0,0,0
27,38,-11,0,0,0
29,43,-14,0,0,0
-32,-12,-20,0,0,0
-18,-5,-13,0,1,1
-46,-38,-8,0,1,1
4,-16,20,1,1,0
-10,-27,17,1,1,0
-19,-22,3,1,1,0
23,30,-7,0,1,1
2,18,-16,0,1,1
41,22,19,1,1,0
60,42,18,1,1,0
-6,1,-7,0,0,0
-28,-13,-15,0,0,0
31,30,1,1,0,1
-13,-19,6,1,0,1
22,33,-11,0,0,0
-28,-40,12,1,0,1
12,19,-7,0,0,0
-2,12,-14,0,0,0
-35,-21,-14,0,0,0
-24,-18,-6,0,0,0
-39,-21,-18,0,1,1
-13,-11,-2,0,1,1
35,24,11,1,1,0
9,-10,19,1,1,0
-56,-39,-17,0,1,1
10,-3,13,1,1,0
-39,-29,-10,0,1,1
44,30,14,1,1,0
3,1,2,1,0,1
-15,-18,3,1,0,1
-23,-17,-6,0,0,0
-17,-28,11,1,0,1
-36,-25,-11,0,0,0
27,44,-17,0,0,0
8,1,7,1,0,1
35,17,18,1,0,1
-23,-13,-10,0,0,0
-6,-12,6,1,0,1
-57,-41,-16,0,0,0
-27,-15,-12,0,0,0
-11,9,-20,0,0,0
-29,-15,-14,0,0,0
25,15,10,1,0,1
-25,-43,18,1,0,1
-29,-27,-2,0,0,0
-35,-28,-7,0,0,0
14,30,-16,0,0,0
45,26,19,1,0,1
46,27,19,1,0,1
9,-4,13,1,1,0
-25,-14,-11,0,1,1
-16,-32,16,1,1,0
26,17,9,1,1,0
16,0,16,1,1,0
8,-10,18,1,1,0
-35,-23,-12,0,1,1
7,26,-19,0,1,1
47,28,19,1,1,0
51,34,17,1,1,0
-2,-7,5,1,0,1
1,16,-15,0,0,0
-35,-40,5,1,0,1
-22,-33,11,1,0,1
-47,-39,-8,0,0,0
34,41,-7,0,0,0
-2,-19,17,1,0,1
22,29,-7,0,0,0
-13,-11,-2,0,0,0
-31,-29,-2,0,0,0
25,41,-16,0,0,0
-8,-15,7,1,1,0
15,26,-11,0,1,1
23,11,12,1,1,0
-16,-12,-4,0,1,1
-16,-11,-5,0,1,1
17,32,-15,0,1,1
15,32,-17,0,1,1
12,7,5,1,1,0
-13,-13,0,0,1,1
-33,-18,-15,0,1,1
1,19,-18,0,1,1
-8,-14,6,1,1,0
-10,-19,9,1,1,0
-37,-25,-12,0,1,1
-20,-23,3,1,0,1
-20,-9,-11,0,0,0
9,1,8,1,0,1
3,23,-20,0,0,0
6,5,1,1,0,1
26,24,2,1,0,1
16,10,6,1,0,1
-8,-1,-7,0,0,0
-24,-27,3,1,1,0
14,14,0,0,1,1
-30,-30,0,0,1,1
41,21,20,1,1,0
2,-12,14,1,1,0
0,-11,11,1,1,0
10,-2,12,1,1,0
-40,-20,-20,0,1,1
-12,8,-20,0,0,0
23,3,20,1,0,1
6,20,-14,0,0,0
-34,-15,-19,0,0,0
31,14,17,1,0,1
-31,-43,12,1,0,1
1,12,-11,0,0,0
-9,-13,4,1,0,1
32,20,12,1,0,1
6,-1,7,1,0,1
1,2,-1,0,0,0
-35,-39,4,1,0,1
34,24,10,1,0,1
7,25,-18,0,0,0
-4,11,-15,0,0,0
-39,-27,-12,0,1,1
36,40,-4,0,1,1
9,8,1,1,1,0
-30,-33,3,1,1,0
-28,-29,1,1,1,0
-20,-9,-11,0,1,1
2,-7,9,1,1,0
-16,-1,-15,0,1,1
14,17,-3,0,1,1
-17,-9,-8,0,0,0
30,12,18,1,0,1
36,34,2,1,0,1
-17,-6,-11,0,0,0
-10,1,-11,0,0,0
2,-14,16,1,0,1
15,22,-7,0,0,0
36,40,-4,0,0,0
10,11,-1,0,0,0
-56,-44,-12,0,1,1
28,18,10,1,1,0
46,37,9,1,1,0
-14,-26,12,1,1,0
-1,-2,1,1,1,0
54,34,20,1,1,0
-7,12,-19,0,1,1
8,21,-13,0,1,1
-10,-12,2,1,1,0
-12,-1,-11,0,1,1
24,12,12,1,1,0
44,38,6,1,1,0
-46,-29,-17,0,1,1
-16,-17,1,1,1,0
-23,-29,6,1,1,0
-38,-22,-16,0,1,1
28,34,-6,0,1,1
-24,-19,-5,0,1,1
24,25,-1,0,1,1
-12,-11,-1,0,1,1
31,39,-8,0,1,1
3,3,0,0,0,0
-26,-27,1,1,0,1
-20,-13,-7,0,0,0
-11,-31,20,1,0,1
-33,-42,9,1,0,1
14,7,7,1,0,1
7,11,-4,0,0,0
14,17,-3,0,0,0
-6,-4,-2,0,0,0
0,8,-8,0,0,0
38,31,7,1,0,1
25,18,7,1,0,1
27,19,8,1,0,1
3,21,-18,0,0,0
-12,-18,6,1,1,0
-26,-11,-15,0,1,1
-22,-5,-17,0,1,1
-38,-37,-1,0,1,1
-14,-21,7,1,1,0
-1,-1,0,0,1,1
37,33,4,1,1,0
-24,-34,10,1,1,0
-27,-17,-10,0,1,1
1,-6,7,1,1,0
17,31,-14,0,1,1
-16,-8,-8,0,0,0
47,29,18,1,0,1
-7,-17,10,1,0,1
-5,2,-7,0,0,0
35,37,-2,0,0,0
-49,-34,-15,0,0,0
0,0,0,0,0,0
32,36,-4,0,0,0
-21,-23,2,1,0,1
23,27,-4,0,0,0
-6,-6,0,0,0,0
13,21,-8,0,0,0
-7,-26,19,1,0,1
45,27,18,1,0,1
-4,-5,1,1,0,1
-34,-31,-3,0,0,0
-45,-39,-6,0,1,1
-27,-20,-7,0,1,1
-18,-17,-1,0,1,1
-23,-22,-1,0,1,1
-41,-25,-16,0,1,1
-47,-45,-2,0,1,1
23,35,-12,0,1,1
-46,-28,-18,0,1,1
24,8,16,1,1,0
25,26,-1,0,1,1
44,27,17,1,1,0
9,12,-3,0,1,1
-3,5,-8,0,1,1
4,13,-9,0,1,1
26,21,5,1,1,0
-45,-33,-12,0,1,1
-26,-35,9,1,1,0
37,44,-7,0,1,1
-42,-41,-1,0,1,1
45,36,9,1,1,0
4,-2,6,1,1,0
20,35,-15,0,0,0
-44,-26,-18,0,0,0
21,4,17,1,0,1
-55,-44,-11,0,0,0
-41,-40,-1,0,0,0
25,12,13,1,0,1
12,24,-12,0,0,0
6,18,-12,0,0,0
37,26,11,1,0,1
-17,-16,-1,0,0,0
-39,-25,-14,0,1,1
-16,-22,6,1,1,0
-12,-8,-4,0,1,1
1,7,-6,0,1,1
-1,-4,3,1,1,0
19,-1,20,1,1,0
-2,-21,19,1,1,0
33,23,10,1,1,0
3,7,-4,0,1,1
16,25,-9,0,1,1
50,40,10,1,1,0
-19,-36,17,1,1,0
46,36,10,1,1,0
17,8,9,1,1,0
-32,-19,-13,0,1,1
19,20,-1,0,1,1
48,41,7,1,1,0
16,19,-3,0,0,0
20,10,10,1,0,1
5,9,-4,0,0,0
-50,-30,-20,0,0,0
13,0,13,1,0,1
-2,-9,7,1,0,1
-29,-32,3,1,0,1
20,17,3,1,0,1
0,4,-4,0,0,0
-30,-27,-3,0,0,0
-9,-8,-1,0,0,0
-8,-13,5,1,0,1
39,24,15,1,0,1
-52,-32,-20,0,0,0
-51,-39,-12,0,0,0
16,2,14,1,0,1
-4,4,-8,0,0,0
39,35,4,1,0,1
-22,-13,-9,0,0,0
-26,-17,-9,0,0,0
-7,-24,17,1,0,1
-26,-35,9,1,1,0
-46,-39,-7,0,1,1
38,42,-4,0,1,1
34,28,6,1,1,0
-45,-40,-5,0,1,1
-30,-14,-16,0,1,1
12,-2,14,1,1,0
-18,-9,-9,0,1,1
48,44,4,1,1,0
-58,-43,-15,0,1,1
27,15,12,1,1,0
-20,-16,-4,0,1,1
11,-9,20,1,1,0
2,20,-18,0,1,1
23,31,-8,0,1,1
22,32,-10,0,1,1
-29,-9,-20,0,0,0
18,-2,20,1,0,1
-19,-33,14,1,0,1
11,6,5,1,0,1
45,29,16,1,0,1
23,22,1,1,0,1
-11,-11,0,0,0,0
40,44,-4,0,0,0
-17,-35,18,1,1,0
12,0,12,1,1,0
18,4,14,1,1,0
19,15,4,1,1,0
6,19,-13,0,1,1
20,10,10,1,1,0
6,-4,10,1,1,0
7,7,0,0,1,1
-9,-15,6,1,1,0
-11,-6,-5,0,0,0
-11,-12,1,1,0,1
-16,-22,6,1,0,1
29,29,0,0,0,0
-56,-36,-20,0,0,0
-60,-41,-19,0,0,0
10,10,0,0,0,0
11,14,-3,0,0,0
-21,-11,-10,0,0,0
-1,-3,2,1,0,1
17,0,17,1,0,1
-19,-39,20,1,0,1
23,24,-1,0,0,0
-25,-21,-4,0,0,0
-26,-29,3,1,1,0
2,-4,6,1,1,0
27,32,-5,0,1,1
3,22,-19,0,1,1
-43,-35,-8,0,1,1
23,19,4,1,1,0
-10,1,-11,0,1,1
17,5,12,1,1,0
2,-1,3,1,1,0
13,9,4,1,1,0
-32,-29,-3,0,1,1
5,-12,17,1,1,0
-30,-22,-8,0,1,1
-1,6,-7,0,1,1
-26,-39,13,1,1,0
29,23,6,1,0,1
-26,-14,-12,0,0,0
-21,-12,-9,0,0,0
13,-5,18,1,0,1
3,22,-19,0,0,0
39,40,-1,0,0,0
-39,-24,-15,0,0,0
25,44,-19,0,0,0
18,37,-19,0,0,0
31,38,-7,0,0,0
19,33,-14,0,0,0
-1,3,-4,0,0,0
-61,-43,-18,0,0,0
-60,-40,-20,0,1,1
-5,-16,11,1,1,0
-25,-21,-4,0,1,1
0,7,-7,0,1,1
-9,-20,11,1,1,0
-1,-11,10,1,1,0
52,34,18,1,1,0
-10,-23,13,1,1,0
-24,-38,14,1,0,1
-17,-16,-1,0,0,0
-11,-7,-4,0,0,0
23,5,18,1,0,1
2,9,-7,0,0,0
7,7,0,0,0,0
9,4,5,1,0,1
-10,0,-10,0,0,0
21,34,-13,0,0,0
34,19,15,1,0,1
-41,-26,-15,0,0,0
-43,-41,-2,0,0,0
8,-1,9,1,0,1
6,8,-2,0,0,0
17,20,-3,0,0,0
23,23,0,0,0,0
27,20,7,1,0,1
31,20,11,1,0,1
-23,-35,12,1,1,0
14,14,0,0,1,1
2,10,-8,0,1,1
-20,-10,-10,0,1,1
-3,10,-13,0,1,1
-14,-24,10,1,1,0
-30,-30,0,0,1,1
17,37,-20,0,1,1
-33,-34,1,1,1,0
-25,-21,-4,0,1,1
20,5,15,1,1,0
33,26,7,1,1,0
20,11,9,1,1,0
17,24,-7,0,1,1
-21,-34,13,1,1,0
-52,-38,-14,0,1,1
33,42,-9,0,1,1
-31,-43,12,1,1,0
26,16,10,1,1,0
-41,-37,-4,0,1,1
18,6,12,1,1,0
-44,-39,-5,0,0,0
-39,-29,-10,0,0,0
-11,-30,19,1,0,1
56,43,13,1,0,1
-27,-37,10,1,0,1
41,41,0,0,0,0
-3,4,-7,0,0,0
30,33,-3,0,0,0
24,27,-3,0,0,0
12,13,-1,0,0,0
24,28,-4,0,0,0
-10,1,-11,0,0,0
-2,0,-2,0,0,0
-44,-39,-5,0,0,0
-36,-24,-12,0,0,0
-38,-23,-15,0,0,0
29,9,20,1,0,1
12,-2,14,1,0,1
-9,-28,19,1,0,1
19,21,-2,0,0,0
0,-5,5,1,0,1
8,18,-10,0,1,1
-5,-6,1,1,1,0
-33,-38,5,1,1,0
-52,-44,-8,0,1,1
9,8,1,1,1,0
26,29,-3,0,1,1
-9,-4,-5,0,1,1
42,38,4,1,1,0
22,19,3,1,0,1
27,19,8,1,0,1
11,4,7,1,0,1
23,4,19,1,0,1
-7,-11,4,1,0,1
53,43,10,1,0,1
-30,-41,11,1,0,1
31,28,3,1,0,1
-19,-21,2,1,0,1
45,34,11,1,0,1
-2,-19,17,1,0,1
-1,-15,14,1,0,1
15,-1,16,1,0,1
22,39,-17,0,0,0
13,28,-15,0,0,0
25,7,18,1,0,1
64,44,20,1,0,1
30,42,-12,0,1,1
29,37,-8,0,1,1
8,20,-12,0,1,1
32,38,-6,0,1,1
14,2,12,1,1,0
8,15,-7,0,1,1
0,13,-13,0,1,1
1,8,-7,0,1,1
30,12,18,1,1,0
25,15,10,1,1,0
-14,-26,12,1,1,0
-26,-8,-18,0,1,1
-24,-24,0,0,1,1
-16,-11,-5,0,1,1
15,6,9,1,1,0
4,-8,12,1,1,0
8,26,-18,0,1,1
7,21,-14,0,1,1
-39,-23,-16,0,0,0
4,12,-8,0,0,0
-4,-17,13,1,0,1
-55,-39,-16,0,0,0
26,7,19,1,0,1
-26,-10,-16,0,0,0
-22,-31,9,1,0,1
-31,-18,-13,0,0,0
-40,-44,4,1,1,0
16,26,-10,0,1,1
-2,-1,-1,0,1,1
16,23,-7,0,1,1
-45,-38,-7,0,1,1
-19,-27,8,1,1,0
42,24,18,1,1,0
21,40,-19,0,1,1
-35,-19,-16,0,1,1
15,14,1,1,1,0
3,20,-17,0,1,1
23,26,-3,0,1,1
46,32,14,1,1,0
24,41,-17,0,1,1
-7,-24,17,1,1,0
-18,-14,-4,0,1,1
11,17,-6,0,1,1
2,13,-11,0,1,1
3,-14,17,1,1,0
-40,-39,-1,0,1,1
37,38,-1,0,1,1
19,36,-17,0,0,0
48,31,17,1,0,1
-50,-37,-13,0,0,0
-40,-37,-3,0,0,0
37,43,-6,0,0,0
-29,-29,0,0,0,0
-49,-34,-15,0,0,0
57,44,13,1,0,1
-53,-34,-19,0,0,0
43,25,18,1,0,1
-56,-39,-17,0,0,0
20,33,-13,0,0,0
15,28,-13,0,0,0
-3,6,-9,0,0,0
3,6,-3,0,0,0
16,16,0,0,0,0
10,-7,17,1,0,1
34,17,17,1,0,1
55,38,17,1,0,1
-38,-39,1,1,0,1
26,8,18,1,0,1
17,36,-19,0,1,1
-18,-19,1,1,1,0
-7,-19,12,1,1,0
6,16,-10,0,1,1
41,22,19,1,1,0
-11,2,-13,0,1,1
0,-9,9,1,1,0
-16,4,-20,0,1,1
-13,6,-19,0,1,1
17,-3,20,1,1,0
31,17,14,1,1,0
-20,-36,16,1,1,0
-3,12,-15,0,1,1
-33,-22,-11,0,1,1
-24,-24,0,0,0,0
-7,-17,10,1,0,1
-2,-10,8,1,0,1
-24,-43,19,1,0,1
23,25,-2,0,0,0
-9,-28,19,1,0,1
3,-11,14,1,0,1
-23,-40,17,1,0,1
43,43,0,0,0,0
-42,-40,-2,0,1,1
9,7,2,1,1,0
5,24,-19,0,1,1
-22,-9,-13,0,1,1
6,22,-16,0,1,1
-23,-24,1,1,1,0
-5,-18,13,1,1,0
-30,-13,-17,0,1,1
13,29,-16,0,1,1
11,-4,15,1,1,0
24,38,-14,0,1,1
6,3,3,1,1,0
-3,4,-7,0,1,1
27,21,6,1,1,0
33,16,17,1,1,0
-10,-2,-8,0,1,1
-24,-20,-4,0,1,1
-23,-12,-11,0,1,1
15,35,-20,0,1,1
40,21,19,1,1,0
-40,-37,-3,0,0,0
0,12,-12,0,0,0
43,31,12,1,0,1
-20,-8,-12,0,0,0
31,25,6,1,0,1
19,28,-9,0,0,0
-4,-5,1,1,0,1
10,30,-20,0,0,0
5,-8,13,1,0,1
-11,2,-13,0,0,0
32,38,-6,0,0,0
30,27,3,1,0,1
3,3,0,0,0,0
-12,2,-14,0,0,0
-46,-32,-14,0,0,0
6,-12,18,1,0,1
-21,-38,17,1,1,0
7,-12,19,1,1,0
-5,-9,4,1,1,0
7,27,-20,0,1,1
32,30,2,1,1,0
-10,5,-15,0,1,1
-17,-34,17,1,1,0
-30,-22,-8,0,1,1
-15,-21,6,1,1,0
22,5,17,1,1,0
-3,-20,17,1,1,0
-27,-17,-10,0,1,1
41,33,8,1,1,0
11,-7,18,1,1,0
25,20,5,1,1,0
-34,-29,-5,0,1,1
43,39,4,1,1,0
44,32,12,1,1,0
4,-4,8,1,1,0
-20,-1,-19,0,0,0
-27,-34,7,1,0,1
-27,-9,-18,0,0,0
34,29,5,1,0,1
11,13,-2,0,0,0
-4,7,-11,0,0,0
-6,1,-7,0,0,0
-10,-4,-6,0,0,0
19,38,-19,0,0,0
12,-6,18,1,0,1
-4,-1,-3,0,0,0
-42,-24,-18,0,0,0
11,12,-1,0,0,0
4,11,-7,0,0,0
47,40,7,1,0,1
-63,-43,-20,0,0,0
28,42,-14,0,0,0
28,39,-11,0,0,0
40,28,12,1,0,1
-2,-22,20,1,0,1
6,11,-5,0,0,0
-52,-38,-14,0,1,1
-23,-11,-12,0,1,1
21,25,-4,0,1,1
-46,-30,-16,0,1,1
7,20,-13,0,1,1
11,11,0,0,1,1
31,15,16,1,1,0
28,41,-13,0,1,1
38,27,11,1,1,0
-11,-19,8,1,1,0
51,31,20,1,1,0
28,12,16,1,1,0
2,11,-9,0,1,1
22,32,-10,0,1,1
-15,-5,-10,0,1,1
-36,-45,9,1,1,0
4,-3,7,1,1,0
56,42,14,1,1,0
10,4,6,1,0,1
25,6,19,1,0,1
30,26,4,1,0,1
-50,-34,-16,0,0,0
-8,-13,5,1,0,1
-57,-38,-19,0,0,0
-10,-13,3,1,0,1
-11,-27,16,1,0,1
52,37,15,1,0,1
0,13,-13,0,0,0
24,34,-10,0,0,0
7,1,6,1,0,1
15,-5,20,1,0,1
-49,-41,-8,0,0,0
22,40,-18,0,0,0
3,20,-17,0,0,0
-8,1,-9,0,0,0
0,-10,10,1,0,1
-11,-12,1,1,0,1
-11,-19,8,1,0,1
45,36,9,1,0,1
-17,-36,19,1,1,0
-31,-35,4,1,1,0
-1,10,-11,0,1,1
20,2,18,1,1,0
26,44,-18,0,1,1
15,33,-18,0,1,1
29,17,12,1,1,0
-46,-40,-6,0,1,1
40,26,14,1,1,0
52,43,9,1,1,0
-40,-28,-12,0,1,1
-21,-1,-20,0,0,0
-45,-32,-13,0,0,0
49,37,12,1,0,1
-11,9,-20,0,0,0
22,38,-16,0,0,0
30,28,2,1,0,1
7,-1,8,1,0,1
8,5,3,1,0,1
-52,-35,-17,0,0,0
-20,-27,7,1,0,1
18,33,-15,0,0,0
6,-9,15,1,0,1
-20,-10,-10,0,0,0
14,-2,16,1,0,1
-20,-40,20,1,0,1
22,15,7,1,0,1
14,27,-13,0,0,0
9,1,8,1,0,1
-28,-38,10,1,0,1
10,-9,19,1,0,1
39,20,19,1,0,1
-26,-18,-8,0,1,1
-33,-15,-18,0,1,1
-18,-11,-7,0,1,1
-48,-42,-6,0,1,1
-48,-32,-16,0,1,1
-44,-30,-14,0,1,1
43,29,14,1,1,0
-29,-13,-16,0,1,1
-13,1,-14,0,1,1
-28,-25,-3,0,1,1
-52,-40,-12,0,1,1
14,8,6,1,1,0
-27,-40,13,1,1,0
18,38,-20,0,1,1
-16,3,-19,0,0,0
-3,-3,0,0,0,0
28,13,15,1,0,1
15,-4,19,1,0,1
16,26,-10,0,0,0
-15,-10,-5,0,0,0
31,25,6,1,0,1
-25,-6,-19,0,0,0
24,35,-11,0,0,0
35,19,16,1,0,1
-20,-23,3,1,0,1
-12,7,-19,0,0,0
-3,-10,7,1,0,1
1,18,-17,0,0,0
-7,5,-12,0,0,0
-30,-27,-3,0,0,0
10,18,-8,0,0,0
-2,10,-12,0,0,0
7,27,-20,0,1,1
-11,-31,20,1,1,0
13,-4,17,1,1,0
46,28,18,1,1,0
-46,-34,-12,0,1,1
17,0,17,1,1,0
25,37,-12,0,1,1
-1,-19,18,1,1,0
6,-3,9,1,1,0
44,37,7,1,1,0
-21,-11,-10,0,1,1
34,41,-7,0,1,1
45,37,8,1,1,0
2,8,-6,0,1,1
54,38,16,1,1,0
13,6,7,1,0,1
-23,-20,-3,0,0,0
-24,-18,-6,0,0,0
-58,-40,-18,0,0,0
-30,-26,-4,0,0,0
18,9,9,1,0,1
-23,-16,-7,0,0,0
24,8,16,1,0,1
-2,-5,3,1,0,1
37,27,10,1,0,1
-1,-3,2,1,0,1
8,0,8,1,0,1
-40,-34,-6,0,1,1
-12,-16,4,1,1,0
14,0,14,1,1,0
-10,-7,-3,0,1,1
-8,-5,-3,0,1,1
46,35,11,1,1,0
-36,-35,-1,0,1,1
13,-1,14,1,1,0
20,39,-19,0,1,1
52,44,8,1,1,0
-36,-30,-6,0,1,1
16,-2,18,1,1,0
33,24,9,1,1,0
-39,-37,-2,0,1,1
-23,-14,-9,0,1,1
22,21,1,1,1,0
32,44,-12,0,1,1
40,38,2,1,1,0
-50,-36,-14,0,1,1
-25,-16,-9,0,1,1
-29,-17,-12,0,1,1
-12,-15,3,1,0,1
30,42,-12,0,0,0
-15,-18,3,1,0,1
-55,-39,-16,0,0,0
-6,-6,0,0,0,0
24,21,3,1,0,1
33,19,14,1,0,1
-8,-12,4,1,0,1
-7,-14,7,1,1,0
-17,-3,-14,0,1,1
35,38,-3,0,1,1
-5,-14,9,1,1,0
30,21,9,1,1,0
43,44,-1,0,1,1
40,28,12,1,1,0
9,24,-15,0,1,1
-54,-36,-18,0,1,1
-33,-23,-10,0,1,1
10,16,-6,0,1,1
-26,-9,-17,0,1,1
44,36,8,1,1,0
39,23,16,1,1,0
17,24,-7,0,1,1
-29,-15,-14,0,0,0
7,8,-1,0,0,0
-10,-9,-1,0,0,0
42,39,3,1,0,1
25,9,16,1,0,1
1,-14,15,1,0,1
-49,-39,-10,0,0,0
29,15,14,1,0,1
35,41,-6,0,0,0
11,-7,18,1,0,1
-42,-24,-18,0,0,0
-14,-26,12,1,0,1
-5,3,-8,0,0,0
45,42,3,1,0,1
10,-9,19,1,0,1
25,17,8,1,0,1
-45,-44,-1,0,1,1
-19,-16,-3,0,1,1
23,17,6,1,1,0
52,44,8,1,1,0
37,24,13,1,1,0
-21,-17,-4,0,1,1
-6,-9,3,1,1,0
25,44,-19,0,1,1
43,27,16,1,1,0
6,-14,20,1,1,0
-1,13,-14,0,1,1
-18,-9,-9,0,1,1
18,17,1,1,1,0
30,27,3,1,1,0
37,38,-1,0,1,1
42,36,6,1,1,0
-38,-23,-15,0,0,0
-48,-40,-8,0,0,0
16,1,15,1,0,1
-51,-39,-12,0,0,0
4,-14,18,1,0,1
-14,-33,19,1,0,1
-35,-22,-13,0,0,0
-3,-3,0,0,0,0
-5,13,-18,0,0,0
-3,4,-7,0,0,0
-54,-42,-12,0,0,0
0,-8,8,1,0,1
3,-1,4,1,0,1
-47,-41,-6,0,0,0
-14,-28,14,1,0,1
-27,-15,-12,0,0,0
-16,-17,1,1,0,1
58,40,18,1,0,1
2,4,-2,0,1,1
-39,-28,-11,0,1,1
13,0,13,1,1,0
-56,-41,-15,0,1,1
11,18,-7,0,1,1
-4,12,-16,0,1,1
-14,-9,-5,0,1,1
-48,-37,-11,0,1,1
33,27,6,1,1,0
-3,14,-17,0,1,1
-45,-41,-4,0,1,1
-26,-28,2,1,1,0
24,10,14,1,1,0
-17,-2,-15,0,1,1
-34,-25,-9,0,1,1
47,33,14,1,1,0
28,11,17,1,1,0
31,16,15,1,1,0
7,19,-12,0,1,1
-4,1,-5,0,1,1
-26,-26,0,0,1,1
12,-8,20,1,0,1
12,32,-20,0,0,0
34,26,8,1,0,1
21,5,16,1,0,1
-28,-45,17,1,0,1
-34,-32,-2,0,0,0
-52,-33,-19,0,0,0
-23,-3,-20,0,0,0
15,7,8,1,0,1
10,14,-4,0,0,0
-20,-5,-15,0,0,0
-37,-36,-1,0,0,0
15,32,-17,0,1,1
-59,-45,-14,0,1,1
0,-20,20,1,1,0
-33,-40,7,1,1,0
-22,-19,-3,0,1,1
-19,-24,5,1,1,0
-25,-15,-10,0,1,1
-63,-44,-19,0,1,1
16,28,-12,0,1,1
5,-10,15,1,1,0
19,28,-9,0,1,1
-46,-34,-12,0,1,1
28,24,4,1,0,1
35,41,-6,0,0,0
-53,-34,-19,0,0,0
-35,-38,3,1,0,1
5,18,-13,0,0,0
0,-6,6,1,0,1
-19,-27,8,1,0,1
16,5,11,1,0,1
32,43,-11,0,1,1
-45,-42,-3,0,1,1
-28,-33,5,1,1,0
-43,-28,-15,0,1,1
-21,-27,6,1,1,0
-47,-30,-17,0,1,1
-45,-27,-18,0,1,1
-57,-41,-16,0,1,1
-5,-8,3,1,1,0
-45,-25,-20,0,1,1
34,32,2,1,1,0
46,31,15,1,1,0
-14,-23,9,1,1,0
-47,-36,-11,0,1,1
4,0,4,1,1,0
-28,-40,12,1,1,0
-16,-3,-13,0,1,1
3,-16,19,1,1,0
-29,-18,-11,0,1,1
-23,-40,17,1,1,0
-13,-11,-2,0,1,1
33,22,11,1,0,1
-22,-19,-3,0,0,0
-6,-4,-2,0,0,0
-38,-21,-17,0,0,0
28,24,4,1,0,1
-27,-10,-17,0,0,0
29,9,20,1,0,1
0,11,-11,0,0,0
-2,15,-17,0,0,0
21,39,-18,0,0,0
-8,10,-18,0,0,0
-31,-36,5,1,0,1
-34,-39,5,1,0,1
-29,-37,8,1,0,1
19,36,-17,0,0,0
-39,-44,5,1,0,1
-4,-4,0,0,0,0
17,14,3,1,0,1
-8,12,-20,0,1,1
29,33,-4,0,1,1
32,23,9,1,1,0
6,6,0,0,1,1
-13,-7,-6,0,1,1
-39,-35,-4,0,1,1
55,40,15,1,1,0
-3,5,-8,0,1,1
43,40,3,1,1,0
26,14,12,1,1,0
-18,-2,-16,0,1,1
41,42,-1,0,1,1
-30,-17,-13,0,1,1
-27,-36,9,1,1,0
-45,-41,-4,0,1,1
-13,-20,7,1,1,0
22,6,16,1,1,0
-52,-39,-13,0,1,1
55,37,18,1,1,0
13,7,6,1,1,0
-9,-25,16,1,1,0
28,36,-8,0,0,0
-22,-12,-10,0,0,0
-44,-31,-13,0,0,0
-18,-20,2,1,0,1
-6,-18,12,1,0,1
-9,8,-17,0,0,0
55,41,14,1,0,1
-1,2,-3,0,0,0
8,15,-7,0,0,0
-16,-24,8,1,0,1
-30,-24,-6,0,0,0
14,2,12,1,0,1
17,32,-15,0,0,0
-25,-38,13,1,0,1
-17,-22,5,1,0,1
24,30,-6,0,0,0
-12,-13,1,1,0,1
-53,-44,-9,0,0,0
-40,-34,-6,0,0,0
11,23,-12,0,0,0
-27,-43,16,1,0,1
39,29,10,1,1,0
-21,-36,15,1,1,0
-3,14,-17,0,1,1
-1,5,-6,0,1,1
21,23,-2,0,1,1
7,-2,9,1,1,0
29,22,7,1,1,0
15,31,-16,0,1,1
-6,-1,-5,0,1,1
19,35,-16,0,1,1
17,22,-5,0,1,1
14,-6,20,1,1,0
-28,-24,-4,0,1,1
-32,-17,-15,0,1,1
-34,-16,-18,0,1,1
-55,-44,-11,0,0,0
59,42,17,1,0,1
14,3,11,1,0,1
-48,-41,-7,0,0,0
-32,-41,9,1,0,1
-47,-34,-13,0,0,0
10,2,8,1,0,1
32,15,17,1,0,1
18,37,-19,0,0,0
-8,-14,6,1,0,1
-45,-44,-1,0,0,0
-21,-38,17,1,0,1
16,0,16,1,0,1
-1,-14,13,1,0,1
10,30,-20,0,0,0
28,16,12,1,0,1
-41,-23,-18,0,1,1
-17,-21,4,1,1,0
-53,-36,-17,0,1,1
7,18,-11,0,1,1
-7,-16,9,1,1,0
50,37,13,1,1,0
16,11,5,1,1,0
-42,-22,-20,0,1,1
-25,-35,10,1,1,0
5,0,5,1,0,1
2,6,-4,0,0,0
31,14,17,1,0,1
-32,-16,-16,0,0,0
-6,-12,6,1,0,1
-17,1,-18,0,0,0
44,41,3,1,0,1
46,26,20,1,0,1
-34,-36,2,1,1,0
24,14,10,1,1,0
16,15,1,1,1,0
-34,-27,-7,0,1,1
-40,-40,0,0,1,1
6,4,2,1,1,0
21,32,-11,0,1,1
-17,-14,-3,0,1,1
23,38,-15,0,1,1
-25,-33,8,1,1,0
39,43,-4,0,1,1
-7,5,-12,0,1,1
29,39,-10,0,1,1
31,34,-3,0,1,1
32,31,1,1,1,0
-10,-26,16,1,1,0
-17,-10,-7,0,1,1
-10,-18,8,1,1,0
-49,-35,-14,0,1,1
-33,-15,-18,0,0,0
47,33,14,1,0,1
-13,-29,16,1,0,1
17,0,17,1,0,1
42,31,11,1,0,1
-27,-11,-16,0,0,0
32,26,6,1,0,1
-10,-10,0,0,0,0
-35,-26,-9,0,0,0
5,-9,14,1,0,1
39,20,19,1,1,0
-25,-42,17,1,1,0
40,24,16,1,1,0
53,41,12,1,1,0
13,28,-15,0,1,1
-29,-12,-17,0,1,1
29,43,-14,0,1,1
0,6,-6,0,1,1
-17,-17,0,0,1,1
-5,-6,1,1,1,0
-60,-43,-17,0,1,1
-10,-1,-9,0,1,1
-14,-20,6,1,1,0
-31,-25,-6,0,1,1
6,21,-15,0,1,1
10,13,-3,0,0,0
9,12,-3,0,0,0
27,14,13,1,0,1
-9,-15,6,1,0,1
20,37,-17,0,0,0
-26,-39,13,1,0,1
43,37,6,1,0,1
-24,-31,7,1,0,1
-18,-13,-5,0,0,0
-42,-39,-3,0,0,0
25,26,-1,0,0,0
-25,-23,-2,0,0,0
-38,-20,-18,0,0,0
5,14,-9,0,0,0
34,15,19,1,0,1
-25,-23,-2,0,0,0
13,12,1,1,0,1
-37,-19,-18,0,1,1
60,44,16,1,1,0
-2,-14,12,1,1,0
54,35,19,1,1,0
-37,-29,-8,0,1,1
11,10,1,1,1,0
20,15,5,1,1,0
12,12,0,0,1,1
33,20,13,1,1,0
28,20,8,1,1,0
35,17,18,1,1,0
29,41,-12,0,0,0
-7,-2,-5,0,0,0
-39,-37,-2,0,0,0
-23,-9,-14,0,0,0
-43,-27,-16,0,0,0
-43,-24,-19,0,0,0
-23,-20,-3,0,0,0
-21,-40,19,1,0,1
-9,-5,-4,0,0,0
-6,12,-18,0,0,0
43,35,8,1,0,1
-54,-36,-18,0,1,1
28,9,19,1,1,0
-13,-25,12,1,1,0
-27,-41,14,1,1,0
5,8,-3,0,1,1
13,27,-14,0,1,1
-16,-17,1,1,1,0
-46,-45,-1,0,1,1
-46,-38,-8,0,1,1
-33,-13,-20,0,0,0
3,-14,17,1,0,1
54,42,12,1,0,1
-9,11,-20,0,0,0
48,44,4,1,0,1
34,35,-1,0,0,0
0,-11,11,1,0,1
46,38,8,1,0,1
57,40,17,1,0,1
44,30,14,1,1,0
18,25,-7,0,1,1
29,36,-7,0,1,1
45,40,5,1,1,0
-47,-36,-11,0,1,1
-19,-16,-3,0,1,1
-3,-7,4,1,1,0
3,-12,15,1,1,0
20,7,13,1,0,1
-27,-29,2,1,0,1
-6,-13,7,1,0,1
-41,-26,-15,0,0,0
23,11,12,1,0,1
48,30,18,1,0,1
-37,-44,7,1,0,1
-5,-9,4,1,0,1
12,-5,17,1,0,1
15,15,0,0,0,0
-52,-33,-19,0,0,0
-2,3,-5,0,0,0
-14,-27,13,1,0,1
17,0,17,1,0,1
-50,-31,-19,0,0,0
-17,-34,17,1,0,1
-46,-30,-16,0,0,0
15,5,10,1,0,1
40,24,16,1,0,1
-8,-28,20,1,0,1
-46,-30,-16,0,0,0
-15,2,-17,0,1,1
-3,7,-10,0,1,1
-35,-23,-12,0,1,1
20,7,13,1,1,0
-5,-19,14,1,1,0
26,8,18,1,1,0
24,7,17,1,1,0
-13,-10,-3,0,1,1
-25,-19,-6,0,1,1
-20,-26,6,1,1,0
27,22,5,1,1,0
-30,-43,13,1,1,0
-42,-31,-11,0,1,1
-62,-44,-18,0,0,0
-24,-4,-20,0,0,0
-2,13,-15,0,0,0
-23,-17,-6,0,0,0
21,8,13,1,0,1
-13,-26,13,1,0,1
22,14,8,1,0,1
21,23,-2,0,0,0
-15,-9,-6,0,0,0
-39,-23,-16,0,0,0
1,-18,19,1,0,1
17,35,-18,0,1,1
9,12,-3,0,1,1
-23,-33,10,1,1,0
55,44,11,1,1,0
4,3,1,1,1,0
25,31,-6,0,1,1
16,22,-6,0,1,1
45,38,7,1,1,0
61,44,17,1,1,0
40,23,17,1,1,0
-3,5,-8,0,1,1
61,43,18,1,1,0
38,31,7,1,1,0
-11,-20,9,1,1,0
-27,-24,-3,0,0,0
45,38,7,1,0,1
15,7,8,1,0,1
-45,-45,0,0,0,0
33,39,-6,0,0,0
21,32,-11,0,0,0
26,31,-5,0,0,0
-19,-27,8,1,0,1
-24,-20,-4,0,0,0
-41,-26,-15,0,0,0
19,31,-12,0,0,0
-18,-16,-2,0,0,0
4,-10,14,1,0,1
-7,-14,7,1,0,1
33,36,-3,0,0,0
19,26,-7,0,0,0
-32,-27,-5,0,0,0
18,-2,20,1,0,1
-2,-19,17,1,0,1
-12,-18,6,1,0,1
7,-4,11,1,0,1
-8,-25,17,1,1,0
31,36,-5,0,1,1
-5,-15,10,1,1,0
11,5,6,1,1,0
2,14,-12,0,1,1
-40,-26,-14,0,1,1
25,21,4,1,1,0
0,-8,8,1,1,0
-19,-30,11,1,1,0
9,14,-5,0,1,1
32,23,9,1,1,0
-40,-34,-6,0,1,1
0,15,-15,0,1,1
25,38,-13,0,1,1
-20,-24,4,1,1,0
-62,-45,-17,0,1,1
22,8,14,1,1,0
-2,-11,9,1,0,1
-10,-29,19,1,0,1
-14,-10,-4,0,0,0
14,-2,16,1,0,1
-43,-39,-4,0,0,0
34,39,-5,0,0,0
40,29,11,1,0,1
-30,-39,9,1,0,1
31,39,-8,0,0,0
-28,-23,-5,0,0,0
-29,-40,11,1,0,1
15,30,-15,0,0,0
24,24,0,0,0,0
21,5,16,1,0,1
38,32,6,1,0,1
6,7,-1,0,0,0
20,6,14,1,0,1
23,25,-2,0,0,0
8,22,-14,0,0,0
-23,-24,1,1,1,0
25,27,-2,0,1,1
4,18,-14,0,1,1
3,5,-2,0,1,1
-48,-31,-17,0,1,1
-22,-42,20,1,1,0
-21,-35,14,1,1,0
45,42,3,1,1,0
-23,-14,-9,0,1,1
26,14,12,1,0,1
-40,-23,-17,0,0,0
-45,-34,-11,0,0,0
52,40,12,1,0,1
36,40,-4,0,0,0
10,-1,11,1,0,1
33,44,-11,0,0,0
23,24,-1,0,0,0
35,18,17,1,0,1
9,-11,20,1,1,0
24,7,17,1,1,0
-12,-15,3,1,1,0
4,0,4,1,1,0
-47,-27,-20,0,1,1
5,22,-17,0,1,1
-48,-36,-12,0,1,1
-30,-44,14,1,1,0
-16,-33,17,1,1,0
-38,-36,-2,0,1,1
-31,-24,-7,0,1,1
7,-12,19,1,1,0
-28,-39,11,1,1,0
14,17,-3,0,1,1
-5,-18,13,1,1,0
-23,-18,-5,0,1,1
1,-17,18,1,1,0
-1,-17,16,1,1,0
-10,-28,18,1,1,0
-20,-6,-14,0,1,1
-32,-45,13,1,1,0
35,17,18,1,0,1
27,39,-12,0,0,0
-14,-15,1,1,0,1
19,23,-4,0,0,0
19,11,8,1,0,1
-25,-23,-2,0,0,0
26,30,-4,0,0,0
-12,-32,20,1,0,1
-5,4,-9,0,0,0
-10,4,-14,0,0,0
39,44,-5,0,1,1
15,1,14,1,1,0
-11,2,-13,0,1,1
-39,-20,-19,0,1,1
-6,-24,18,1,1,0
-20,-6,-14,0,1,1
10,2,8,1,1,0
8,19,-11,0,1,1
-40,-31,-9,0,1,1
35,23,12,1,1,0
15,5,10,1,1,0
-3,-19,16,1,0,1
-16,1,-17,0,0,0
52,40,12,1,0,1
4,23,-19,0,0,0
20,12,8,1,0,1
4,1,3,1,0,1
29,23,6,1,0,1
-7,-10,3,1,0,1
43,34,9,1,0,1
0,-16,16,1,1,0
22,41,-19,0,1,1
-16,-32,16,1,1,0
-40,-43,3,1,1,0
-10,-9,-1,0,1,1
2,8,-6,0,1,1
-20,-29,9,1,1,0
-34,-20,-14,0,1,1
56,38,18,1,1,0
39,40,-1,0,1,1
0,11,-11,0,1,1
5,7,-2,0,1,1
-25,-24,-1,0,1,1
-40,-41,1,1,1,0
29,28,1,1,0,1
-3,8,-11,0,0,0
3,8,-5,0,0,0
-22,-21,-1,0,0,0
12,24,-12,0,0,0
-21,-2,-19,0,0,0
-20,-17,-3,0,0,0
4,-6,10,1,0,1
-2,18,-20,0,0,0
46,43,3,1,1,0
7,14,-7,0,1,1
31,26,5,1,1,0
28,23,5,1,1,0
33,26,7,1,1,0
25,26,-1,0,1,1
-18,-5,-13,0,1,1
-20,-31,11,1,1,0
-16,-21,5,1,1,0
37,36,1,1,1,0
6,-6,12,1,1,0
9,3,6,1,1,0
-46,-30,-16,0,1,1
-9,-21,12,1,1,0
3,17,-14,0,1,1
-13,-7,-6,0,1,1
18,23,-5,0,1,1
-6,8,-14,0,1,1
-32,-31,-1,0,1,1
21,19,2,1,1,0
-19,-13,-6,0,1,1
-5,13,-18,0,0,0
28,15,13,1,0,1
-10,-18,8,1,0,1
-20,-38,18,1,0,1
60,40,20,1,0,1
-28,-39,11,1,0,1
-16,0,-16,0,0,0
35,26,9,1,0,1
-3,11,-14,0,0,0
24,21,3,1,0,1
-11,-27,16,1,0,1
-13,-11,-2,0,0,0
-21,-26,5,1,0,1
-25,-16,-9,0,0,0
-27,-21,-6,0,0,0
8,28,-20,0,0,0
-8,-19,11,1,0,1
-12,-20,8,1,0,1
-26,-31,5,1,0,1
-10,-3,-7,0,0,0
-8,-15,7,1,0,1
15,32,-17,0,1,1
34,16,18,1,1,0
34,37,-3,0,1,1
30,13,17,1,1,0
-13,5,-18,0,1,1
29,11,18,1,1,0
-36,-35,-1,0,1,1
-11,-4,-7,0,1,1
-52,-38,-14,0,1,1
13,-1,14,1,1,0
-11,-7,-4,0,0,0
-9,-14,5,1,0,1
6,-9,15,1,0,1
-3,5,-8,0,0,0
24,18,6,1,0,1
-1,2,-3,0,0,0
33,21,12,1,0,1
20,19,1,1,0,1
-24,-31,7,1,0,1
37,39,-2,0,0,0
25,28,-3,0,0,0
-1,-4,3,1,0,1
-20,-29,9,1,0,1
-30,-12,-18,0,0,0
0,-16,16,1,0,1
49,29,20,1,0,1
27,13,14,1,0,1
-19,-30,11,1,0,1
-33,-45,12,1,1,0
4,24,-20,0,1,1
9,11,-2,0,1,1
-6,-2,-4,0,1,1
-14,0,-14,0,1,1
-23,-21,-2,0,1,1
-35,-20,-15,0,1,1
-39,-35,-4,0,1,1
-21,-39,18,1,1,0
-42,-25,-17,0,1,1
13,32,-19,0,1,1
-24,-11,-13,0,1,1
-31,-27,-4,0,1,1
11,31,-20,0,1,1
-24,-42,18,1,1,0
26,40,-14,0,1,1
-8,11,-19,0,1,1
25,9,16,1,1,0
-37,-21,-16,0,1,1
9,20,-11,0,1,1
-19,-30,11,1,1,0
-25,-11,-14,0,0,0
-35,-28,-7,0,0,0
0,12,-12,0,0,0
47,33,14,1,0,1
13,7,6,1,0,1
-11,-25,14,1,0,1
41,29,12,1,0,1
-39,-39,0,0,0,0
-33,-39,6,1,0,1
-32,-25,-7,0,0,0
-36,-36,0,0,0,0
8,-6,14,1,0,1
23,43,-20,0,0,0
-33,-14,-19,0,0,0
37,23,14,1,0,1
-32,-38,6,1,0,1
-41,-38,-3,0,0,0
11,22,-11,0,0,0
8,3,5,1,0,1
-25,-7,-18,0,0,0
-29,-34,5,1,0,1
1,-19,20,1,1,0
8,-12,20,1,1,0
8,-7,15,1,1,0
33,26,7,1,1,0
-19,-7,-12,0,1,1
41,27,14,1,1,0
-8,7,-15,0,1,1
-27,-12,-15,0,1,1
22,22,0,0,1,1
45,27,18,1,1,0
-3,-1,-2,0,1,1
16,19,-3,0,0,0
-21,-13,-8,0,0,0
-22,-33,11,1,0,1
10,-4,14,1,0,1
4,5,-1,0,0,0
1,-2,3,1,0,1
23,40,-17,0,0,0
-54,-44,-10,0,0,0
-15,-18,3,1,0,1
51,31,20,1,0,1
13,-3,16,1,0,1
-42,-22,-20,0,0,0
3,23,-20,0,0,0
-19,-12,-7,0,0,0
-2,-10,8,1,0,1
46,30,16,1,1,0
-21,-33,12,1,1,0
38,21,17,1,1,0
-14,-31,17,1,1,0
-10,-28,18,1,1,0
-33,-13,-20,0,1,1
24,33,-9,0,1,1
-10,3,-13,0,1,1
-2,11,-13,0,1,1
32,23,9,1,1,0
-29,-35,6,1,1,0
-5,-12,7,1,1,0
-37,-43,6,1,1,0
-24,-12,-12,0,1,1
51,42,9,1,1,0
-49,-35,-14,0,1,1
20,8,12,1,1,0
21,23,-2,0,1,1
30,36,-6,0,1,1
24,20,4,1,1,0
-25,-21,-4,0,1,1
-11,-15,4,1,0,1
14,15,-1,0,0,0
0,7,-7,0,0,0
46,39,7,1,0,1
0,16,-16,0,0,0
27,37,-10,0,0,0
24,30,-6,0,0,0
-37,-17,-20,0,0,0
-43,-34,-9,0,0,0
5,-9,14,1,0,1
31,37,-6,0,0,0
-38,-24,-14,0,0,0
7,0,7,1,0,1
-2,-1,-1,0,0,0
34,14,20,1,0,1
3,13,-10,0,0,0
22,39,-17,0,0,0
-9,-22,13,1,0,1
-27,-28,1,1,0,1
-8,-5,-3,0,0,0
-29,-9,-20,0,0,0
-16,-24,8,1,1,0
-18,-15,-3,0,1,1
-54,-40,-14,0,1,1
42,38,4,1,1,0
-26,-31,5,1,1,0
58,39,19,1,1,0
46,26,20,1,1,0
58,44,14,1,1,0
-5,8,-13,0,1,1
19,7,12,1,1,0
-49,-41,-8,0,1,1
38,24,14,1,1,0
-20,-9,-11,0,1,1
14,34,-20,0,1,1
-28,-13,-15,0,1,1
16,5,11,1,1,0
1,6,-5,0,1,1
-29,-44,15,1,1,0
-29,-44,15,1,1,0
41,44,-3,0,1,1
30,12,18,1,1,0
-38,-20,-18,0,0,0
31,26,5,1,0,1
9,7,2,1,0,1
1,15,-14,0,0,0
-23,-25,2,1,0,1
-15,-33,18,1,0,1
-17,-4,-13,0,0,0
46,31,15,1,0,1
38,38,0,0,0,0
22,16,6,1,0,1
-13,-28,15,1,0,1
-15,-34,19,1,0,1
-31,-40,9,1,0,1
-42,-34,-8,0,0,0
49,42,7,1,1,0
31,28,3,1,1,0
-18,-20,2,1,1,0
16,18,-2,0,1,1
9,11,-2,0,1,1
-9,10,-19,0,1,1
-59,-41,-18,0,1,1
-30,-23,-7,0,1,1
-13,-20,7,1,1,0
41,34,7,1,1,0
46,27,19,1,1,0
18,10,8,1,0,1
-14,-6,-8,0,0,0
35,42,-7,0,0,0
-20,-4,-16,0,0,0
7,16,-9,0,0,0
16,6,10,1,0,1
-5,-15,10,1,0,1
2,18,-16,0,0,0
26,24,2,1,0,1
-27,-15,-12,0,0,0
-38,-41,3,1,0,1
22,40,-18,0,0,0
-14,2,-16,0,0,0
37,22,15,1,0,1
3,-11,14,1,0,1
-56,-44,-12,0,0,0
28,22,6,1,0,1
36,30,6,1,0,1
-32,-23,-9,0,0,0
-58,-40,-18,0,0,0
27,40,-13,0,0,0
-36,-36,0,0,1,1
3,13,-10,0,1,1
-33,-31,-2,0,1,1
-6,7,-13,0,1,1
-50,-38,-12,0,1,1
-8,-13,5,1,1,0
10,9,1,1,1,0
30,28,2,1,1,0
55,39,16,1,1,0
25,8,17,1,1,0
2,1,1,1,0,1
-24,-10,-14,0,0,0
19,35,-16,0,0,0
-7,-17,10,1,0,1
-20,-1,-19,0,0,0
-39,-37,-2,0,0,0
-27,-20,-7,0,0,0
-14,3,-17,0,0,0
-40,-44,4,1,0,1
14,18,-4,0,0,0
2,4,-2,0,0,0
-15,3,-18,0,0,0
-8,-23,15,1,0,1
-11,-2,-9,0,0,0
48,38,10,1,0,1
10,27,-17,0,0,0
7,8,-1,0,0,0
-63,-45,-18,0,0,0
10,29,-19,0,0,0
-34,-38,4,1,0,1
30,38,-8,0,0,0
6,19,-13,0,1,1
-27,-29,2,1,1,0
-36,-22,-14,0,1,1
-1,11,-12,0,1,1
16,14,2,1,1,0
30,40,-10,0,1,1
-44,-45,1,1,1,0
10,-1,11,1,1,0
8,-4,12,1,1,0
27,19,8,1,1,0
49,35,14,1,1,0
54,44,10,1,1,0
22,32,-10,0,1,1
21,12,9,1,1,0
3,-16,19,1,1,0
-16,-27,11,1,1,0
41,31,10,1,1,0
-37,-32,-5,0,1,1
-3,-3,0,0,1,1
25,16,9,1,1,0
1,-6,7,1,1,0
-11,-16,5,1,0,1
46,41,5,1,0,1
-5,-10,5,1,0,1
34,38,-4,0,0,0
-14,6,-20,0,0,0
9,15,-6,0,0,0
17,-2,19,1,0,1
4,24,-20,0,0,0
-33,-13,-20,0,0,0
19,19,0,0,0,0
4,-14,18,1,0,1
29,27,2,1,0,1
-18,-35,17,1,0,1
-6,-2,-4,0,0,0
-34,-42,8,1,0,1
21,26,-5,0,0,0
-3,-20,17,1,0,1
-17,-33,16,1,0,1
-34,-15,-19,0,0,0
-41,-43,2,1,0,1
41,28,13,1,0,1
17,12,5,1,1,0
19,5,14,1,1,0
-19,-30,11,1,1,0
33,20,13,1,1,0
9,-6,15,1,1,0
52,35,17,1,1,0
-35,-42,7,1,1,0
17,30,-13,0,1,1
21,17,4,1,1,0
45,39,6,1,1,0
-42,-31,-11,0,1,1
7,-2,9,1,1,0
-30,-22,-8,0,1,1
-47,-34,-13,0,1,1
57,40,17,1,1,0
-26,-14,-12,0,1,1
19,30,-11,0,1,1
-55,-39,-16,0,1,1
-31,-22,-9,0,1,1
51,38,13,1,1,0
-1,-6,5,1,1,0
44,41,3,1,0,1
38,34,4,1,0,1
32,16,16,1,0,1
23,39,-16,0,0,0
-44,-32,-12,0,0,0
5,-5,10,1,0,1
11,20,-9,0,0,0
-5,12,-17,0,0,0
-52,-32,-20,0,0,0
19,28,-9,0,0,0
43,28,15,1,0,1
51,44,7,1,0,1
-29,-22,-7,0,0,0
-49,-33,-16,0,0,0
-31,-21,-10,0,0,0
36,32,4,1,1,0
-9,-11,2,1,1,0
-32,-15,-17,0,1,1
-20,-40,20,1,1,0
-35,-39,4,1,1,0
-52,-44,-8,0,1,1
-28,-12,-16,0,1,1
-27,-29,2,1,1,0
-26,-8,-18,0,1,1
-4,10,-14,0,1,1
-20,-37,17,1,1,0
-21,-28,7,1,1,0
-64,-45,-19,0,1,1
12,25,-13,0,1,1
-1,-21,20,1,1,0
23,18,5,1,1,0
-26,-43,17,1,1,0
-13,4,-17,0,1,1
-30,-42,12,1,1,0
-14,-32,18,1,1,0
-25,-27,2,1,1,0
-21,-34,13,1,0,1
23,7,16,1,0,1
28,40,-12,0,0,0
-35,-35,0,0,0,0
2,1,1,1,0,1
8,-10,18,1,0,1
-19,-39,20,1,0,1
-49,-44,-5,0,0,0
7,-9,16,1,0,1
32,18,14,1,1,0
-9,6,-15,0,1,1
-16,-15,-1,0,1,1
14,32,-18,0,1,1
11,2,9,1,1,0
-53,-41,-12,0,1,1
-39,-32,-7,0,1,1
55,35,20,1,1,0
-39,-43,4,1,0,1
-34,-37,3,1,0,1
21,2,19,1,0,1
19,23,-4,0,0,0
-8,-28,20,1,0,1
-54,-35,-19,0,0,0
-2,-14,12,1,0,1
45,42,3,1,0,1
18,13,5,1,0,1
14,-4,18,1,0,1
39,19,20,1,0,1
-24,-33,9,1,0,1
-25,-14,-11,0,0,0
27,35,-8,0,0,0
-20,-1,-19,0,0,0
-9,-24,15,1,0,1
-1,9,-10,0,1,1
-10,-25,15,1,1,0
-38,-29,-9,0,1,1
47,43,4,1,1,0
2,11,-9,0,1,1
8,25,-17,0,1,1
51,37,14,1,1,0
-20,-19,-1,0,1,1
2,4,-2,0,1,1
-19,-10,-9,0,1,1
-40,-30,-10,0,1,1
12,20,-8,0,1,1
39,20,19,1,1,0
44,41,3,1,1,0
9,26,-17,0,1,1
-12,-22,10,1,1,0
-31,-27,-4,0,1,1
-16,-1,-15,0,1,1
-63,-45,-18,0,1,1
-30,-36,6,1,1,0
-17,1,-18,0,1,1
-47,-45,-2,0,0,0
35,23,12,1,0,1
-43,-32,-11,0,0,0
-1,10,-11,0,0,0
-22,-33,11,1,0,1
-1,5,-6,0,0,0
-34,-14,-20,0,0,0
31,19,12,1,0,1
-21,-29,8,1,1,0
-16,-12,-4,0,1,1
3,14,-11,0,1,1
-24,-39,15,1,1,0
-45,-45,0,0,1,1
-8,6,-14,0,1,1
-19,-28,9,1,1,0
-6,11,-17,0,1,1
4,2,2,1,1,0
-11,4,-15,0,1,1
26,39,-13,0,1,1
19,2,17,1,1,0
15,-5,20,1,1,0
-23,-21,-2,0,1,1
-2,10,-12,0,1,1
9,23,-14,0,1,1
24,40,-16,0,1,1
-44,-36,-8,0,0,0
-31,-28,-3,0,0,0
29,23,6,1,0,1
17,3,14,1,0,1
-31,-27,-4,0,0,0
50,44,6,1,0,1
13,28,-15,0,0,0
-6,-20,14,1,0,1
9,22,-13,0,0,0
-7,5,-12,0,0,0
26,27,-1,0,0,0
22,2,20,1,0,1
10,10,0,0,0,0
37,38,-1,0,0,0
46,30,16,1,0,1
31,33,-2,0,0,0
-65,-45,-20,0,0,0
-5,6,-11,0,0,0
-4,-1,-3,0,0,0
-33,-23,-10,0,0,0
25,14,11,1,0,1
-33,-36,3,1,1,0
-26,-17,-9,0,1,1
13,30,-17,0,1,1
34,19,15,1,1,0
32,35,-3,0,1,1
-28,-11,-17,0,1,1
-12,-11,-1,0,1,1
-24,-5,-19,0,1,1
9,9,0,0,1,1
48,31,17,1,1,0
19,8,11,1,0,1
-31,-31,0,0,0,0
-16,4,-20,0,0,0
50,36,14,1,0,1
-17,1,-18,0,0,0
40,40,0,0,0,0
1,19,-18,0,0,0
-30,-27,-3,0,0,0
11,-9,20,1,0,1
35,30,5,1,0,1
31,21,10,1,0,1
-46,-44,-2,0,0,0
13,-7,20,1,0,1
15,8,7,1,0,1
-3,4,-7,0,0,0
-39,-40,1,1,0,1
-7,7,-14,0,0,0
44,44,0,0,0,0
-12,7,-19,0,1,1
-14,3,-17,0,1,1
30,33,-3,0,1,1
-4,-10,6,1,1,0
-34,-14,-20,0,1,1
-9,-3,-6,0,1,1
-27,-45,18,1,1,0
-32,-26,-6,0,1,1
-15,-20,5,1,0,1
23,16,7,1,0,1
-25,-35,10,1,0,1
41,22,19,1,0,1
4,12,-8,0,0,0
-6,14,-20,0,0,0
-38,-30,-8,0,0,0
-46,-37,-9,0,0,0
-60,-43,-17,0,0,0
35,16,19,1,0,1
-54,-44,-10,0,0,0
-23,-8,-15,0,0,0
40,21,19,1,0,1
22,29,-7,0,1,1
15,6,9,1,1,0
-36,-33,-3,0,1,1
-45,-30,-15,0,1,1
53,41,12,1,1,0
-7,-18,11,1,1,0
-1,-6,5,1,1,0
19,0,19,1,1,0
-42,-45,3,1,0,1
33,25,8,1,0,1
-42,-35,-7,0,0,0
17,22,-5,0,0,0
21,9,12,1,0,1
28,32,-4,0,0,0
48,34,14,1,0,1
14,25,-11,0,0,0
9,16,-7,0,0,0
23,43,-20,0,0,0
20,2,18,1,0,1
15,17,-2,0,0,0
24,5,19,1,0,1
-1,-11,10,1,0,1
33,24,9,1,0,1
-2,6,-8,0,0,0
-18,-24,6,1,0,1
53,41,12,1,0,1
4,8,-4,0,0,0
4,17,-13,0,0,0
-7,-21,14,1,0,1
-45,-37,-8,0,1,1
-25,-36,11,1,1,0
-40,-33,-7,0,1,1
-8,-9,1,1,1,0
34,16,18,1,1,0
-30,-44,14,1,1,0
-22,-25,3,1,1,0
26,28,-2,0,1,1
-6,9,-15,0,1,1
-22,-35,13,1,1,0
18,15,3,1,1,0
0,7,-7,0,1,1
1,-16,17,1,1,0
20,35,-15,0,1,1
-6,11,-17,0,1,1
-16,-12,-4,0,1,1
33,37,-4,0,1,1
-4,-14,10,1,1,0
-2,-8,6,1,1,0
-25,-20,-5,0,1,1
-10,7,-17,0,1,1
47,43,4,1,0,1
44,37,7,1,0,1
35,17,18,1,0,1
-8,-8,0,0,0,0
30,25,5,1,0,1
18,9,9,1,0,1
1,21,-20,0,0,0
-19,-10,-9,0,0,0
-42,-42,0,0,0,0
-20,-5,-15,0,0,0
2,4,-2,0,0,0
25,43,-18,0,0,0
-40,-42,2,1,0,1
-28,-9,-19,0,1,1
-24,-22,-2,0,1,1
24,11,13,1,1,0
-31,-38,7,1,1,0
-15,-14,-1,0,1,1
-50,-43,-7,0,1,1
-19,-7,-12,0,1,1
-18,-37,19,1,1,0
29,10,19,1,1,0
36,35,1,1,1,0
10,-8,18,1,1,0
5,-13,18,1,1,0
41,34,7,1,1,0
34,27,7,1,1,0
-7,-2,-5,0,1,1
-61,-41,-20,0,1,1
-3,-9,6,1,1,0
-15,-3,-12,0,1,1
-24,-23,-1,0,1,1
-18,-37,19,1,1,0
17,5,12,1,1,0
5,11,-6,0,0,0
-10,-24,14,1,0,1
37,19,18,1,0,1
-28,-38,10,1,0,1
-50,-41,-9,0,0,0
-3,12,-15,0,0,0
-33,-16,-17,0,0,0
9,19,-10,0,0,0
52,35,17,1,0,1
6,15,-9,0,1,1
-16,-28,12,1,1,0
-28,-34,6,1,1,0
53,33,20,1,1,0
18,19,-1,0,1,1
-39,-43,4,1,1,0
21,34,-13,0,1,1
-52,-37,-15,0,1,1
-28,-45,17,1,1,0
-18,-12,-6,0,1,1
-28,-28,0,0,1,1
56,42,14,1,1,0
-14,-3,-11,0,1,1
-32,-42,10,1,1,0
16,19,-3,0,1,1
-19,-35,16,1,1,0
-31,-38,7,1,1,0
20,6,14,1,1,0
15,7,8,1,1,0
-14,-4,-10,0,1,1
19,25,-6,0,1,1
-56,-36,-20,0,0,0
-24,-23,-1,0,0,0
1,16,-15,0,0,0
-60,-41,-19,0,0,0
21,13,8,1,0,1
-4,-15,11,1,0,1
-23,-22,-1,0,0,0
-7,-24,17,1,0,1
-31,-34,3,1,0,1
17,33,-16,0,0,0
0,-8,8,1,0,1
16,3,13,1,0,1
-36,-27,-9,0,0,0
15,17,-2,0,0,0
-32,-16,-16,0,0,0
23,12,11,1,0,1
-62,-44,-18,0,0,0
4,13,-9,0,0,0
9,29,-20,0,0,0
53,35,18,1,0,1
22,25,-3,0,0,0
-23,-35,12,1,1,0
-20,-17,-3,0,1,1
38,23,15,1,1,0
-10,-29,19,1,1,0
37,21,16,1,1,0
-35,-44,9,1,1,0
-9,11,-20,0,1,1
-35,-35,0,0,1,1
-6,0,-6,0,1,1
42,30,12,1,1,0
-10,-9,-1,0,1,1
-41,-41,0,0,1,1
-7,-10,3,1,1,0
-27,-14,-13,0,1,1
-14,-8,-6,0,1,1
39,19,20,1,1,0
57,41,16,1,0,1
-60,-45,-15,0,0,0
6,2,4,1,0,1
9,-10,19,1,0,1
-18,-2,-16,0,0,0
-16,-36,20,1,0,1
14,33,-19,0,0,0
-36,-30,-6,0,0,0
-38,-21,-17,0,0,0
-12,-7,-5,0,0,0
-31,-16,-15,0,1,1
-51,-34,-17,0,1,1
-13,3,-16,0,1,1
47,40,7,1,1,0
14,-5,19,1,1,0
-55,-35,-20,0,1,1
33,14,19,1,1,0
-25,-15,-10,0,1,1
2,-1,3,1,1,0
-52,-41,-11,0,1,1
27,44,-17,0,1,1
11,1,10,1,1,0
35,21,14,1,1,0
34,39,-5,0,1,1
21,7,14,1,1,0
-12,-16,4,1,1,0
-27,-30,3,1,0,1
-25,-13,-12,0,0,0
0,-20,20,1,0,1
1,9,-8,0,0,0
16,3,13,1,0,1
20,18,2,1,0,1
-33,-21,-12,0,0,0
33,40,-7,0,0,0
17,15,2,1,0,1
25,32,-7,0,0,0
-15,-29,14,1,0,1
-25,-12,-13,0,0,0
27,41,-14,0,0,0
42,38,4,1,0,1
-50,-40,-10,0,0,0
29,24,5,1,0,1
-8,-26,18,1,0,1
16,26,-10,0,0,0
49,29,20,1,0,1
-13,-7,-6,0,0,0
-31,-30,-1,0,0,0
-3,12,-15,0,1,1
41,30,11,1,1,0
-45,-27,-18,0,1,1
18,16,2,1,1,0
-11,-13,2,1,1,0
0,17,-17,0,1,1
29,16,13,1,1,0
-22,-17,-5,0,1,1
39,25,14,1,1,0
30,44,-14,0,1,1
-54,-37,-17,0,1,1
52,44,8,1,1,0
-34,-40,6,1,1,0
18,37,-19,0,1,1
-50,-34,-16,0,1,1
-37,-33,-4,0,1,1
45,39,6,1,1,0
13,29,-16,0,0,0
-15,-5,-10,0,0,0
-58,-44,-14,0,0,0
0,-13,13,1,0,1
-23,-36,13,1,0,1
-31,-16,-15,0,0,0
-7,-15,8,1,0,1
-16,-29,13,1,0,1
-59,-45,-14,0,0,0
-30,-20,-10,0,0,0
20,34,-14,0,0,0
-19,-9,-10,0,1,1
15,-2,17,1,1,0
-37,-23,-14,0,1,1
-2,-15,13,1,1,0
-30,-15,-15,0,1,1
18,25,-7,0,1,1
50,31,19,1,1,0
22,26,-4,0,1,1
-44,-42,-2,0,1,1
-45,-29,-16,0,1,1
21,24,-3,0,0,0
-28,-39,11,1,0,1
-15,-28,13,1,0,1
29,20,9,1,0,1
-16,-36,20,1,0,1
41,35,6,1,0,1
35,19,16,1,0,1
10,18,-8,0,0,0
16,14,2,1,1,0
7,21,-14,0,1,1
-22,-6,-16,0,1,1
-3,-15,12,1,1,0
-28,-43,15,1,1,0
-45,-39,-6,0,1,1
24,30,-6,0,1,1
42,27,15,1,1,0
30,36,-6,0,1,1
-30,-26,-4,0,1,1
-62,-44,-18,0,1,1
19,3,16,1,1,0
-2,10,-12,0,1,1
55,38,17,1,1,0
50,43,7,1,1,0
40,22,18,1,1,0
-5,0,-5,0,1,1
-4,-3,-1,0,1,1
41,22,19,1,1,0
-29,-15,-14,0,1,1
52,44,8,1,1,0
-2,-16,14,1,0,1
19,21,-2,0,0,0
-20,-27,7,1,0,1
28,30,-2,0,0,0
-3,8,-11,0,0,0
-47,-40,-7,0,0,0
32,16,16,1,0,1
5,2,3,1,0,1
17,7,10,1,0,1
7,-6,13,1,0,1
14,-6,20,1,0,1
-24,-9,-15,0,0,0
33,35,-2,0,0,0
36,26,10,1,0,1
27,40,-13,0,0,0
22,26,-4,0,0,0
-36,-36,0,0,0,0
-13,-20,7,1,0,1
6,15,-9,0,0,0
-16,-7,-9,0,0,0
42,36,6,1,1,0
-34,-23,-11,0,1,1
-21,-36,15,1,1,0
42,35,7,1,1,0
-61,-45,-16,0,1,1
18,16,2,1,1,0
0,19,-19,0,1,1
4,14,-10,0,1,1
-44,-40,-4,0,1,1
-21,-35,14,1,1,0
57,42,15,1,1,0
33,44,-11,0,0,0
39,23,16,1,0,1
-25,-18,-7,0,0,0
-24,-28,4,1,0,1
37,22,15,1,0,1
7,9,-2,0,0,0
-47,-38,-9,0,0,0
-31,-44,13,1,0,1
1,14,-13,0,0,0
41,34,7,1,0,1
45,28,17,1,1,0
41,43,-2,0,1,1
-24,-26,2,1,1,0
4,-13,17,1,1,0
-35,-29,-6,0,1,1
22,3,19,1,1,0
-28,-8,-20,0,1,1
-2,1,-3,0,1,1
-21,-24,3,1,0,1
23,39,-16,0,0,0
-48,-34,-14,0,0,0
10,-9,19,1,0,1
-49,-44,-5,0,0,0
14,28,-14,0,0,0
45,29,16,1,0,1
20,16,4,1,0,1
-25,-19,-6,0,0,0
-18,-2,-16,0,0,0
-39,-25,-14,0,0,0
-45,-28,-17,0,0,0
-13,-27,14,1,0,1
-7,0,-7,0,0,0
24,6,18,1,0,1
1,11,-10,0,0,0
-41,-27,-14,0,0,0
32,16,16,1,0,1
-47,-39,-8,0,0,0
-39,-19,-20,0,0,0
-29,-12,-17,0,0,0
-21,-16,-5,0,1,1
25,42,-17,0,1,1
-26,-35,9,1,1,0
-14,-15,1,1,1,0
43,39,4,1,1,0
-8,-22,14,1,1,0
-15,-20,5,1,1,0
57,44,13,1,1,0
56,41,15,1,1,0
-47,-30,-17,0,0,0
-1,-13,12,1,0,1
-4,7,-11,0,0,0
-5,0,-5,0,0,0
-61,-44,-17,0,0,0
-19,-24,5,1,0,1
18,22,-4,0,0,0
-39,-38,-1,0,0,0
-8,-22,14,1,0,1
-33,-44,11,1,0,1
-37,-17,-20,0,1,1
-55,-43,-12,0,1,1
0,-3,3,1,1,0
-20,-25,5,1,1,0
14,26,-12,0,1,1
-53,-42,-11,0,1,1
38,23,15,1,1,0
-14,6,-20,0,1,1
-17,-13,-4,0,1,1
3,5,-2,0,1,1
14,26,-12,0,1,1
-20,-27,7,1,1,0
-6,-22,16,1,1,0
14,29,-15,0,1,1
-11,1,-12,0,1,1
4,18,-14,0,1,1
-23,-22,-1,0,1,1
-45,-44,-1,0,1,1
-33,-36,3,1,1,0
-16,-25,9,1,1,0
22,9,13,1,1,0
-15,-27,12,1,0,1
-5,-7,2,1,0,1
40,21,19,1,0,1
-13,0,-13,0,0,0
25,37,-12,0,0,0
48,37,11,1,0,1
-5,-8,3,1,0,1
-18,-18,0,0,0,0
-33,-25,-8,0,0,0
22,20,2,1,0,1
-43,-42,-1,0,0,0
-39,-28,-11,0,0,0
36,36,0,0,0,0
20,32,-12,0,0,0
57,42,15,1,0,1
19,38,-19,0,0,0
-8,-14,6,1,0,1
34,15,19,1,0,1
-10,9,-19,0,0,0
-41,-45,4,1,0,1
38,29,9,1,0,1
-5,-10,5,1,1,0
48,31,17,1,1,0
-15,-2,-13,0,1,1
21,10,11,1,1,0
-23,-43,20,1,1,0
42,25,17,1,1,0
28,26,2,1,1,0
-21,-27,6,1,1,0
24,35,-11,0,1,1
42,40,2,1,1,0
-5,-22,17,1,1,0
6,-5,11,1,1,0
13,13,0,0,1,1
32,25,7,1,0,1
45,39,6,1,0,1
-33,-31,-2,0,0,0
-1,7,-8,0,0,0
24,34,-10,0,0,0
29,23,6,1,0,1
-7,-5,-2,0,0,0
23,29,-6,0,0,0
50,32,18,1,0,1
-10,-28,18,1,0,1
-28,-8,-20,0,0,0
-32,-43,11,1,0,1
17,18,-1,0,0,0
-49,-39,-10,0,0,0
1,1,0,0,0,0
-28,-34,6,1,0,1
-29,-15,-14,0,0,0
-35,-40,5,1,0,1
26,44,-18,0,0,0
-54,-35,-19,0,0,0
-45,-27,-18,0,0,0
35,18,17,1,1,0
13,3,10,1,1,0
-48,-42,-6,0,1,1
19,16,3,1,1,0
-12,-12,0,0,1,1
50,34,16,1,1,0
-32,-28,-4,0,1,1
-5,-9,4,1,1,0
18,23,-5,0,1,1
-31,-17,-14,0,1,1
-22,-15,-7,0,1,1
-2,4,-6,0,1,1
7,22,-15,0,1,1
-4,14,-18,0,1,1
-23,-20,-3,0,1,1
6,13,-7,0,1,1
34,15,19,1,1,0
47,44,3,1,1,0
13,22,-9,0,1,1
18,6,12,1,1,0
5,12,-7,0,1,1
-5,-4,-1,0,0,0
55,41,14,1,0,1
43,31,12,1,0,1
9,23,-14,0,0,0
38,37,1,1,0,1
-23,-27,4,1,0,1
29,34,-5,0,0,0
20,31,-11,0,0,0
-12,-20,8,1,0,1
0,-20,20,1,0,1
36,22,14,1,0,1
56,40,16,1,0,1
47,38,9,1,0,1
46,40,6,1,1,0
-26,-8,-18,0,1,1
43,36,7,1,1,0
55,35,20,1,1,0
11,20,-9,0,1,1
-26,-21,-5,0,1,1
-22,-19,-3,0,1,1
-23,-5,-18,0,1,1
-8,-10,2,1,1,0
-25,-19,-6,0,1,1
-25,-13,-12,0,1,1
16,20,-4,0,1,1
45,26,19,1,1,0
19,6,13,1,0,1
-37,-18,-19,0,0,0
8,24,-16,0,0,0
13,0,13,1,0,1
31,43,-12,0,0,0
16,2,14,1,0,1
-5,-5,0,0,0,0
-23,-27,4,1,0,1
6,22,-16,0,0,0
2,5,-3,0,1,1
22,33,-11,0,1,1
45,44,1,1,1,0
-2,0,-2,0,1,1
17,17,0,0,1,1
-12,2,-14,0,1,1
9,-5,14,1,1,0
0,-18,18,1,1,0
-22,-22,0,0,1,1
-22,-42,20,1,1,0
-14,4,-18,0,1,1
26,7,19,1,1,0
-15,-27,12,1,1,0
-27,-16,-11,0,1,1
17,11,6,1,1,0
-30,-21,-9,0,1,1
-18,-23,5,1,0,1
40,26,14,1,0,1
22,2,20,1,0,1
-50,-41,-9,0,0,0
-9,-22,13,1,0,1
-57,-37,-20,0,0,0
10,15,-5,0,0,0
-26,-13,-13,0,0,0
-30,-43,13,1,0,1
-34,-25,-9,0,0,0
28,15,13,1,0,1
-18,0,-18,0,0,0
-39,-30,-9,0,0,0
-16,-34,18,1,1,0
-20,-24,4,1,1,0
8,20,-12,0,1,1
-48,-34,-14,0,1,1
-33,-45,12,1,1,0
-58,-42,-16,0,1,1
55,44,11,1,1,0
-29,-19,-10,0,1,1
-2,3,-5,0,1,1
9,-4,13,1,1,0
37,18,19,1,1,0
-47,-43,-4,0,1,1
57,40,17,1,1,0
18,2,16,1,1,0
-54,-41,-13,0,1,1
-50,-44,-6,0,1,1
-22,-18,-4,0,1,1
9,14,-5,0,1,1
-12,-14,2,1,1,0
-1,-1,0,0,1,1
25,30,-5,0,1,1
18,22,-4,0,0,0
32,26,6,1,0,1
53,41,12,1,0,1
-12,5,-17,0,0,0
17,11,6,1,0,1
6,7,-1,0,0,0
-44,-28,-16,0,0,0
-29,-22,-7,0,0,0
-54,-37,-17,0,0,0
-2,-6,4,1,0,1
-36,-40,4,1,1,0
6,3,3,1,1,0
-3,13,-16,0,1,1
14,4,10,1,1,0
-29,-22,-7,0,1,1
-15,-16,1,1,1,0
-23,-34,11,1,1,0
-17,-37,20,1,1,0
40,25,15,1,1,0
5,10,-5,0,1,1
21,6,15,1,1,0
15,34,-19,0,1,1
-14,-2,-12,0,1,1
23,24,-1,0,1,1
-62,-42,-20,0,0,0
-34,-35,1,1,0,1
9,28,-19,0,0,0
-8,-15,7,1,0,1
-10,-16,6,1,0,1
-22,-26,4,1,0,1
17,13,4,1,0,1
-22,-21,-1,0,0,0
16,34,-18,0,0,0
28,43,-15,0,0,0
-3,15,-18,0,0,0
-32,-13,-19,0,0,0
-26,-22,-4,0,0,0
22,2,20,1,0,1
-13,-16,3,1,0,1
-24,-41,17,1,1,0
-34,-42,8,1,1,0
-9,-10,1,1,1,0
30,34,-4,0,1,1
16,12,4,1,1,0
-50,-36,-14,0,1,1
-23,-42,19,1,1,0
29,42,-13,0,1,1
37,24,13,1,1,0
-12,-11,-1,0,1,1
46,34,12,1,1,0
-2,-2,0,0,1,1
0,-18,18,1,1,0
24,8,16,1,1,0
24,10,14,1,1,0
11,2,9,1,1,0
-31,-11,-20,0,1,1
-7,7,-14,0,1,1
32,44,-12,0,1,1
-2,-12,10,1,0,1
-19,-12,-7,0,0,0
39,41,-2,0,0,0
10,25,-15,0,0,0
25,11,14,1,0,1
-25,-19,-6,0,0,0
-41,-29,-12,0,0,0
-19,-34,15,1,0,1
-46,-30,-16,0,0,0
44,24,20,1,1,0
21,29,-8,0,1,1
-14,-1,-13,0,1,1
11,-7,18,1,1,0
-20,-17,-3,0,1,1
16,13,3,1,1,0
47,40,7,1,1,0
7,6,1,1,1,0
-58,-39,-19,0,1,1
7,18,-11,0,1,1
-28,-12,-16,0,1,1
25,30,-5,0,1,1
58,44,14,1,1,0
36,27,9,1,1,0
2,7,-5,0,1,1
14,19,-5,0,0,0
20,23,-3,0,0,0
5,21,-16,0,0,0
-5,-14,9,1,0,1
-14,-31,17,1,0,1
43,43,0,0,0,0
32,32,0,0,0,0
58,43,15,1,0,1
52,40,12,1,0,1
57,42,15,1,0,1
-37,-43,6,1,0,1
-25,-6,-19,0,0,0
4,11,-7,0,0,0
-11,-29,18,1,0,1
-3,5,-8,0,0,0
4,-3,7,1,0,1
55,39,16,1,0,1
37,28,9,1,1,0
-21,-14,-7,0,1,1
21,21,0,0,1,1
44,44,0,0,1,1
14,20,-6,0,1,1
14,8,6,1,1,0
8,15,-7,0,1,1
35,23,12,1,1,0
-41,-35,-6,0,1,1
6,-9,15,1,1,0
38,24,14,1,1,0
4,-16,20,1,1,0
10,1,9,1,1,0
-32,-26,-6,0,1,1
-30,-11,-19,0,0,0
-40,-32,-8,0,0,0
18,30,-12,0,0,0
-6,4,-10,0,0,0
43,23,20,1,0,1
-17,-1,-16,0,0,0
5,3,2,1,0,1
21,38,-17,0,0,0
3,-17,20,1,0,1
-18,-22,4,1,0,1
-13,-2,-11,0,0,0
30,10,20,1,0,1
-4,-6,2,1,0,1
-11,9,-20,0,0,0
12,2,10,1,0,1
-8,3,-11,0,0,0
16,-1,17,1,0,1
23,26,-3,0,0,0
-19,-34,15,1,0,1
-1,-18,17,1,0,1
-26,-14,-12,0,0,0
0,-18,18,1,1,0
6,22,-16,0,1,1
28,27,1,1,1,0
-40,-26,-14,0,1,1
-35,-43,8,1,1,0
5,23,-18,0,1,1
-23,-12,-11,0,1,1
6,-12,18,1,1,0
-47,-43,-4,0,1,1
-41,-23,-18,0,1,1
-33,-19,-14,0,1,1
12,29,-17,0,1,1
16,19,-3,0,1,1
26,8,18,1,1,0
31,13,18,1,1,0
36,42,-6,0,1,1
0,-20,20,1,1,0
22,35,-13,0,1,1
-47,-39,-8,0,1,1
32,25,7,1,1,0
-26,-35,9,1,1,0
32,41,-9,0,0,0
-40,-23,-17,0,0,0
-15,-35,20,1,0,1
41,21,20,1,0,1
-13,-8,-5,0,0,0
35,22,13,1,0,1
-55,-43,-12,0,0,0
-44,-40,-4,0,0,0
-25,-5,-20,0,0,0
13,9,4,1,0,1
20,17,3,1,0,1
9,18,-9,0,0,0
31,15,16,1,0,1
48,34,14,1,0,1
-19,-20,1,1,0,1
-21,-35,14,1,0,1
-14,-1,-13,0,1,1
-7,-23,16,1,1,0
2,-12,14,1,1,0
58,39,19,1,1,0
-43,-30,-13,0,1,1
-23,-3,-20,0,1,1
7,-8,15,1,1,0
-15,5,-20,0,1,1
33,22,11,1,1,0
13,9,4,1,1,0
-2,-5,3,1,1,0
-35,-29,-6,0,1,1
-25,-35,10,1,1,0
14,-5,19,1,1,0
36,38,-2,0,1,1
1,12,-11,0,1,1
-20,-2,-18,0,1,1
-55,-37,-18,0,1,1
-38,-35,-3,0,1,1
21,21,0,0,1,1
-50,-43,-7,0,1,1
37,22,15,1,0,1
-1,9,-10,0,0,0
-40,-23,-17,0,0,0
-44,-29,-15,0,0,0
-22,-27,5,1,0,1
11,1,10,1,0,1
47,39,8,1,0,1
-46,-39,-7,0,0,0
-51,-32,-19,0,0,0
-23,-28,5,1,0,1
16,8,8,1,0,1
22,9,13,1,0,1
33,18,15,1,1,0
-24,-24,0,0,1,1
42,38,4,1,1,0
28,16,12,1,1,0
0,1,-1,0,1,1
43,44,-1,0,1,1
-32,-38,6,1,1,0
20,4,16,1,1,0
31,22,9,1,1,0
61,42,19,1,1,0
1,-9,10,1,1,0
45,36,9,1,1,0
41,27,14,1,1,0
-47,-31,-16,0,1,1
18,10,8,1,1,0
-8,-8,0,0,1,1
44,43,1,1,1,0
21,41,-20,0,1,1
-26,-13,-13,0,1,1
15,18,-3,0,1,1
-25,-39,14,1,1,0
-35,-25,-10,0,0,0
31,31,0,0,0,0
39,35,4,1,0,1
-5,-10,5,1,0,1
16,7,9,1,0,1
-30,-15,-15,0,0,0
12,2,10,1,0,1
-23,-9,-14,0,0,0
20,23,-3,0,0,0
-60,-45,-15,0,0,0
-9,-5,-4,0,1,1
-33,-40,7,1,1,0
2,19,-17,0,1,1
11,18,-7,0,1,1
-46,-36,-10,0,1,1
34,27,7,1,1,0
14,6,8,1,1,0
-47,-37,-10,0,1,1
-38,-32,-6,0,1,1
-45,-45,0,0,0,0
11,5,6,1,0,1
1,12,-11,0,0,0
12,5,7,1,0,1
17,-3,20,1,0,1
-35,-37,2,1,0,1
-31,-39,8,1,0,1
-4,-10,6,1,0,1
45,37,8,1,1,0
16,-2,18,1,1,0
-46,-29,-17,0,1,1
-28,-28,0,0,1,1
28,34,-6,0,1,1
22,27,-5,0,1,1
0,2,-2,0,1,1
1,3,-2,0,1,1
48,39,9,1,1,0
13,-4,17,1,1,0
-62,-42,-20,0,1,1
7,27,-20,0,1,1
21,4,17,1,1,0
22,26,-4,0,1,1
10,21,-11,0,0,0
33,35,-2,0,0,0
-28,-44,16,1,0,1
27,20,7,1,0,1
0,-13,13,1,0,1
26,35,-9,0,0,0
-30,-25,-5,0,0,0
36,24,12,1,0,1
-13,-33,20,1,0,1
-50,-40,-10,0,0,0
53,42,11,1,0,1
4,-7,11,1,0,1
39,41,-2,0,0,0
-29,-31,2,1,0,1
-18,-30,12,1,0,1
-5,8,-13,0,0,0
44,35,9,1,0,1
-39,-37,-2,0,0,0
2,17,-15,0,0,0
4,-11,15,1,1,0
-21,-25,4,1,1,0
34,31,3,1,1,0
38,34,4,1,1,0
-31,-15,-16,0,1,1
34,38,-4,0,1,1
7,19,-12,0,1,1
-38,-26,-12,0,1,1
-43,-40,-3,0,1,1
-18,-27,9,1,1,0
9,21,-12,0,1,1
-15,-20,5,1,1,0
40,40,0,0,1,1
-26,-35,9,1,1,0
5,-10,15,1,1,0
14,19,-5,0,1,1
-37,-38,1,1,1,0
-23,-26,3,1,0,1
38,18,20,1,0,1
-41,-21,-20,0,0,0
57,40,17,1,0,1
12,30,-18,0,0,0
5,14,-9,0,0,0
-21,-38,17,1,0,1
-35,-40,5,1,0,1
55,36,19,1,0,1
-22,-33,11,1,0,1
-18,-2,-16,0,0,0
-49,-32,-17,0,0,0
-28,-12,-16,0,0,0
-40,-43,3,1,0,1
-9,-11,2,1,0,1
-3,11,-14,0,1,1
-12,-29,17,1,1,0
28,27,1,1,1,0
-13,-4,-9,0,1,1
-1,-5,4,1,1,0
-22,-2,-20,0,1,1
6,0,6,1,1,0
47,38,9,1,1,0
15,15,0,0,1,1
42,40,2,1,1,0
23,22,1,1,0,1
42,38,4,1,0,1
-25,-20,-5,0,0,0
16,0,16,1,0,1
-47,-39,-8,0,0,0
-41,-26,-15,0,0,0
37,35,2,1,0,1
-23,-19,-4,0,0,0
-43,-37,-6,0,0,0
32,41,-9,0,0,0
-28,-41,13,1,0,1
2,2,0,0,0,0
-48,-45,-3,0,0,0
51,41,10,1,0,1
-14,-5,-9,0,1,1
4,-7,11,1,1,0
-17,-5,-12,0,1,1
50,37,13,1,1,0
15,29,-14,0,1,1
44,25,19,1,1,0
12,-3,15,1,1,0
0,-14,14,1,1,0
-33,-45,12,1,1,0
46,41,5,1,1,0
-50,-43,-7,0,1,1
-21,-10,-11,0,1,1
-14,-5,-9,0,1,1
8,2,6,1,1,0
21,12,9,1,1,0
24,39,-15,0,1,1
25,42,-17,0,0,0
-9,9,-18,0,0,0
-3,-19,16,1,0,1
-15,-26,11,1,0,1
46,26,20,1,0,1
14,34,-20,0,0,0
42,29,13,1,0,1
49,39,10,1,0,1
52,38,14,1,0,1
27,44,-17,0,0,0
30,35,-5,0,0,0
42,28,14,1,0,1
-3,13,-16,0,0,0
33,39,-6,0,0,0
40,32,8,1,1,0
-25,-25,0,0,1,1
3,11,-8,0,1,1
22,10,12,1,1,0
-21,-25,4,1,1,0
-26,-16,-10,0,1,1
24,44,-20,0,1,1
-35,-39,4,1,1,0
-36,-43,7,1,1,0
-4,-19,15,1,0,1
-9,-19,10,1,0,1
5,1,4,1,0,1
20,1,19,1,0,1
40,34,6,1,0,1
29,27,2,1,0,1
-16,-26,10,1,0,1
30,11,19,1,0,1
7,13,-6,0,0,0
25,33,-8,0,0,0
44,41,3,1,0,1
29,32,-3,0,0,0
29,16,13,1,0,1
-25,-9,-16,0,0,0
-12,2,-14,0,0,0
-29,-12,-17,0,0,0
-15,1,-16,0,0,0
15,30,-15,0,1,1
-10,2,-12,0,1,1
-27,-30,3,1,1,0
39,37,2,1,1,0
35,25,10,1,1,0
28,24,4,1,1,0
-58,-43,-15,0,1,1
-63,-45,-18,0,1,1
-26,-20,-6,0,1,1
14,17,-3,0,1,1
-15,3,-18,0,0,0
-36,-19,-17,0,0,0
-49,-45,-4,0,0,0
-52,-38,-14,0,0,0
-60,-42,-18,0,0,0
-15,-9,-6,0,0,0
-1,-21,20,1,0,1
-21,-3,-18,0,0,0
-9,0,-9,0,0,0
3,13,-10,0,0,0
-3,-2,-1,0,0,0
-4,-16,12,1,0,1
-57,-37,-20,0,0,0
53,44,9,1,0,1
1,-8,9,1,0,1
9,29,-20,0,0,0
43,42,1,1,0,1
24,4,20,1,0,1
1,13,-12,0,0,0
-39,-28,-11,0,0,0
-17,-35,18,1,0,1
-35,-40,5,1,1,0
37,42,-5,0,1,1
52,44,8,1,1,0
36,17,19,1,1,0
-43,-25,-18,0,1,1
-23,-8,-15,0,1,1
-32,-42,10,1,1,0
-39,-42,3,1,1,0
7,4,3,1,1,0
29,39,-10,0,1,1
17,12,5,1,1,0
49,31,18,1,1,0
-14,3,-17,0,1,1
7,19,-12,0,1,1
-36,-43,7,1,1,0
47,37,10,1,1,0
-24,-22,-2,0,1,1
-45,-25,-20,0,1,1
-4,10,-14,0,1,1
-33,-16,-17,0,1,1
-25,-32,7,1,0,1
-7,-22,15,1,0,1
44,31,13,1,0,1
-46,-35,-11,0,0,0
-4,-18,14,1,0,1
-11,-14,3,1,0,1
-16,-28,12,1,0,1
49,38,11,1,0,1
10,5,5,1,0,1
-12,-32,20,1,0,1
11,11,0,0,0,0
-33,-21,-12,0,0,0
-32,-20,-12,0,1,1
-9,-10,1,1,1,0
41,34,7,1,1,0
28,41,-13,0,1,1
0,10,-10,0,1,1
-24,-19,-5,0,1,1
22,32,-10,0,1,1
-23,-36,13,1,1,0
32,40,-8,0,1,1
3,9,-6,0,1,1
37,35,2,1,1,0
12,1,11,1,1,0
12,31,-19,0,1,1
-37,-41,4,1,0,1
46,34,12,1,0,1
14,17,-3,0,0,0
43,39,4,1,0,1
-24,-42,18,1,0,1
-11,-20,9,1,0,1
-11,-7,-4,0,0,0
29,14,15,1,0,1
39,36,3,1,0,1
-44,-32,-12,0,0,0
2,-14,16,1,1,0
7,6,1,1,1,0
-49,-30,-19,0,1,1
-5,-13,8,1,1,0
-38,-28,-10,0,1,1
-40,-45,5,1,1,0
-27,-22,-5,0,1,1
-28,-23,-5,0,1,1
-27,-22,-5,0,0,0
2,-12,14,1,0,1
44,37,7,1,0,1
-42,-27,-15,0,0,0
-60,-41,-19,0,0,0
24,41,-17,0,0,0
-27,-16,-11,0,0,0
-24,-36,12,1,0,1
-45,-34,-11,0,0,0
-26,-14,-12,0,0,0
-31,-20,-11,0,1,1
13,20,-7,0,1,1
-57,-45,-12,0,1,1
7,11,-4,0,1,1
-11,-13,2,1,1,0
15,9,6,1,1,0
-9,10,-19,0,1,1
-24,-16,-8,0,1,1
38,30,8,1,1,0
4,7,-3,0,1,1
-1,15,-16,0,0,0
12,22,-10,0,0,0
-28,-42,14,1,0,1
49,40,9,1,0,1
21,31,-10,0,0,0
12,15,-3,0,0,0
-38,-36,-2,0,0,0
9,17,-8,0,0,0
31,42,-11,0,0,0
-4,-19,15,1,0,1
-33,-25,-8,0,0,0
-1,-12,11,1,0,1
-28,-19,-9,0,0,0
-31,-28,-3,0,0,0
48,30,18,1,0,1
32,35,-3,0,0,0
-44,-31,-13,0,0,0
0,15,-15,0,0,0
-29,-43,14,1,0,1
-7,0,-7,0,0,0
26,9,17,1,0,1
-13,-26,13,1,1,0
55,40,15,1,1,0
-33,-43,10,1,1,0
-22,-29,7,1,1,0
35,43,-8,0,1,1
31,22,9,1,1,0
42,44,-2,0,1,1
32,37,-5,0,1,1
15,7,8,1,1,0
30,20,10,1,1,0
-38,-45,7,1,1,0
-42,-37,-5,0,1,1
-41,-21,-20,0,1,1
-13,-1,-12,0,1,1
-50,-32,-18,0,1,1
2,2,0,0,1,1
-7,-21,14,1,1,0
-11,-5,-6,0,1,1
-2,-10,8,1,1,0
-45,-40,-5,0,1,1
-27,-33,6,1,1,0
-21,-22,1,1,0,1
-38,-26,-12,0,0,0
-26,-21,-5,0,0,0
-8,-24,16,1,0,1
32,19,13,1,0,1
22,10,12,1,0,1
61,42,19,1,0,1
-7,-10,3,1,0,1
-22,-27,5,1,1,0
2,20,-18,0,1,1
24,34,-10,0,1,1
-53,-37,-16,0,1,1
33,33,0,0,1,1
18,21,-3,0,1,1
39,23,16,1,1,0
10,6,4,1,1,0
34,32,2,1,1,0
-2,-17,15,1,1,0
11,-5,16,1,1,0
-33,-42,9,1,1,0
32,26,6,1,1,0
17,22,-5,0,1,1
34,16,18,1,1,0
-13,-11,-2,0,1,1
33,33,0,0,1,1
12,23,-11,0,1,1
33,16,17,1,1,0
-50,-41,-9,0,0,0
38,36,2,1,0,1
-63,-45,-18,0,0,0
-33,-22,-11,0,0,0
17,34,-17,0,0,0
-65,-45,-20,0,0,0
38,35,3,1,0,1
21,24,-3,0,0,0
8,14,-6,0,1,1
28,12,16,1,1,0
-7,-5,-2,0,1,1
-27,-38,11,1,1,0
17,31,-14,0,1,1
21,19,2,1,1,0
-16,-15,-1,0,1,1
-2,-14,12,1,1,0
-30,-38,8,1,1,0
39,26,13,1,1,0
40,41,-1,0,1,1
-3,8,-11,0,1,1
11,11,0,0,1,1
-26,-45,19,1,1,0
-7,11,-18,0,1,1
32,29,3,1,1,0
-16,-34,18,1,1,0
-11,-14,3,1,1,0
9,16,-7,0,0,0
-43,-26,-17,0,0,0
34,15,19,1,0,1
33,33,0,0,0,0
-20,-28,8,1,0,1
28,28,0,0,0,0
-18,-33,15,1,0,1
-14,-4,-10,0,0,0
23,36,-13,0,0,0
56,42,14,1,0,1
-19,-37,18,1,0,1
-62,-45,-17,0,0,0
1,-15,16,1,0,1
-2,-14,12,1,0,1
-22,-21,-1,0,0,0
19,10,9,1,0,1
-27,-23,-4,0,0,0
-19,-1,-18,0,0,0
19,6,13,1,0,1
43,44,-1,0,1,1
21,24,-3,0,1,1
7,2,5,1,1,0
-8,-14,6,1,1,0
34,22,12,1,1,0
42,39,3,1,1,0
-28,-15,-13,0,1,1
-25,-12,-13,0,1,1
-37,-43,6,1,1,0
23,25,-2,0,1,1
5,-10,15,1,1,0
-22,-39,17,1,1,0
17,12,5,1,1,0
-21,-12,-9,0,1,1
-37,-33,-4,0,1,1
-16,-19,3,1,1,0
15,16,-1,0,1,1
26,20,6,1,1,0
0,7,-7,0,1,1
-51,-34,-17,0,1,1
1,-1,2,1,1,0
-60,-41,-19,0,0,0
41,33,8,1,0,1
30,35,-5,0,0,0
-55,-39,-16,0,0,0
-6,-15,9,1,0,1
-35,-39,4,1,0,1
-24,-14,-10,0,0,0
43,34,9,1,0,1
22,37,-15,0,0,0
3,-10,13,1,0,1
14,22,-8,0,0,0
-16,-27,11,1,0,1
-33,-37,4,1,0,1
-6,-1,-5,0,0,0
-44,-29,-15,0,0,0
5,10,-5,0,0,0
17,20,-3,0,0,0
43,38,5,1,0,1
26,24,2,1,0,1
7,16,-9,0,0,0
11,23,-12,0,0,0
-33,-34,1,1,1,0
27,11,16,1,1,0
-5,2,-7,0,1,1
-16,-1,-15,0,1,1
-2,16,-18,0,1,1
21,39,-18,0,1,1
-18,0,-18,0,1,1
29,9,20,1,1,0
23,13,10,1,1,0
26,33,-7,0,1,1
-10,9,-19,0,1,1
18,-1,19,1,0,1
0,5,-5,0,0,0
-7,-16,9,1,0,1
48,37,11,1,0,1
-1,-18,17,1,0,1
-3,5,-8,0,0,0
-22,-2,-20,0,0,0
13,-2,15,1,0,1
56,39,17,1,0,1
57,39,18,1,0,1
-28,-28,0,0,0,0
-47,-43,-4,0,0,0
-1,16,-17,0,0,0
9,-6,15,1,0,1
45,38,7,1,0,1
-49,-44,-5,0,0,0
-30,-28,-2,0,0,0
-43,-29,-14,0,0,0
15,22,-7,0,0,0
-42,-37,-5,0,0,0
43,25,18,1,0,1
-40,-35,-5,0,1,1
-43,-28,-15,0,1,1
4,-10,14,1,1,0
7,27,-20,0,1,1
22,30,-8,0,1,1
0,-3,3,1,1,0
18,25,-7,0,1,1
-21,-30,9,1,1,0
-8,-20,12,1,1,0
-16,3,-19,0,0,0
7,14,-7,0,0,0
7,14,-7,0,0,0
-34,-25,-9,0,0,0
-1,17,-18,0,0,0
11,11,0,0,0,0
-14,-25,11,1,0,1
34,28,6,1,0,1
-31,-32,1,1,0,1
-7,-21,14,1,0,1
-9,-14,5,1,0,1
-35,-15,-20,0,0,0
29,44,-15,0,0,0
-29,-36,7,1,0,1
59,40,19,1,0,1
-44,-38,-6,0,0,0
-13,2,-15,0,0,0
24,9,15,1,0,1
-35,-24,-11,0,0,0
-26,-31,5,1,0,1
13,4,9,1,0,1
-31,-29,-2,0,1,1
27,40,-13,0,1,1
5,3,2,1,1,0
5,25,-20,0,1,1
-48,-44,-4,0,1,1
-20,-19,-1,0,1,1
7,-12,19,1,1,0
-22,-2,-20,0,1,1
15,28,-13,0,0,0
-19,-38,19,1,0,1
5,25,-20,0,0,0
4,-1,5,1,0,1
-46,-32,-14,0,0,0
-22,-14,-8,0,0,0
1,-1,2,1,0,1
21,38,-17,0,0,0
17,34,-17,0,0,0
1,19,-18,0,0,0
-60,-41,-19,0,0,0
12,-1,13,1,0,1
28,15,13,1,1,0
2,1,1,1,1,0
12,11,1,1,1,0
-26,-13,-13,0,1,1
-19,1,-20,0,1,1
46,28,18,1,1,0
-6,14,-20,0,1,1
47,40,7,1,1,0
-45,-42,-3,0,1,1
6,15,-9,0,1,1
11,4,7,1,1,0
44,30,14,1,1,0
18,22,-4,0,1,1
-13,-4,-9,0,1,1
-13,-24,11,1,1,0
-28,-9,-19,0,0,0
21,33,-12,0,0,0
-19,-23,4,1,0,1
-11,-18,7,1,0,1
33,34,-1,0,0,0
-36,-22,-14,0,0,0
-27,-22,-5,0,0,0
-6,14,-20,0,0,0
-8,-18,10,1,0,1
-13,-14,1,1,0,1
-32,-36,4,1,0,1
-24,-8,-16,0,0,0
-45,-41,-4,0,0,0
27,19,8,1,0,1
45,35,10,1,1,0
28,39,-11,0,1,1
2,-16,18,1,1,0
53,33,20,1,1,0
23,11,12,1,1,0
3,-17,20,1,1,0
8,21,-13,0,1,1
35,39,-4,0,1,1
51,38,13,1,1,0
-62,-42,-20,0,1,1
21,10,11,1,1,0
4,6,-2,0,1,1
-38,-44,6,1,1,0
16,4,12,1,1,0
-41,-25,-16,0,1,1
27,22,5,1,1,0
-19,1,-20,0,1,1
48,41,7,1,1,0
-18,-24,6,1,1,0
-24,-7,-17,0,0,0
22,23,-1,0,0,0
25,21,4,1,0,1
26,26,0,0,0,0
-49,-31,-18,0,0,0
-43,-37,-6,0,0,0
-43,-34,-9,0,0,0
30,41,-11,0,0,0
18,23,-5,0,0,0
50,38,12,1,0,1
24,20,4,1,0,1
19,38,-19,0,0,0
-17,-36,19,1,0,1
18,14,4,1,0,1
34,22,12,1,0,1
0,11,-11,0,0,0
-55,-45,-10,0,0,0
-26,-9,-17,0,0,0
22,27,-5,0,0,0
-25,-13,-12,0,1,1
-29,-32,3,1,1,0
23,18,5,1,1,0
21,24,-3,0,1,1
-26,-38,12,1,1,0
-29,-36,7,1,1,0
37,36,1,1,1,0
-17,2,-19,0,1,1
-63,-45,-18,0,1,1
45,25,20,1,1,0
30,32,-2,0,1,1
-39,-24,-15,0,1,1
-15,0,-15,0,1,1
-36,-18,-18,0,1,1
28,38,-10,0,1,1
14,34,-20,0,1,1
-43,-43,0,0,1,1
-1,-19,18,1,1,0
-10,-16,6,1,1,0
20,38,-18,0,1,1
22,39,-17,0,1,1
6,-5,11,1,0,1
-28,-37,9,1,0,1
44,28,16,1,0,1
52,33,19,1,0,1
13,-5,18,1,0,1
-28,-23,-5,0,0,0
37,35,2,1,0,1
-22,-29,7,1,0,1
-33,-42,9,1,0,1
33,13,20,1,1,0
-29,-22,-7,0,1,1
10,25,-15,0,1,1
-25,-31,6,1,1,0
27,21,6,1,1,0
-6,-1,-5,0,1,1
18,34,-16,0,1,1
-26,-12,-14,0,1,1
-27,-41,14,1,1,0
-7,2,-9,0,1,1
-3,-18,15,1,0,1
-5,5,-10,0,0,0
5,-8,13,1,0,1
15,3,12,1,0,1
13,0,13,1,0,1
-36,-20,-16,0,0,0
-41,-25,-16,0,0,0
27,22,5,1,0,1
38,37,1,1,1,0
8,18,-10,0,1,1
-48,-34,-14,0,1,1
-13,-25,12,1,1,0
14,15,-1,0,1,1
20,24,-4,0,1,1
-6,-13,7,1,1,0
-46,-36,-10,0,1,1
55,41,14,1,1,0
-38,-25,-13,0,1,1
-5,0,-5,0,1,1
23,36,-13,0,1,1
-21,-11,-10,0,0,0
-1,11,-12,0,0,0
34,27,7,1,0,1
7,3,4,1,0,1
23,11,12,1,0,1
0,-8,8,1,0,1
-19,-35,16,1,0,1
-44,-28,-16,0,0,0
-5,-5,0,0,0,0
-29,-41,12,1,0,1
13,9,4,1,0,1
21,31,-10,0,0,0
64,44,20,1,0,1
-19,-38,19,1,0,1
-3,15,-18,0,0,0
-23,-29,6,1,0,1
29,38,-9,0,0,0
-7,8,-15,0,0,0
-37,-18,-19,0,0,0
18,3,15,1,0,1
34,21,13,1,0,1
38,29,9,1,1,0
-18,-31,13,1,1,0
41,34,7,1,1,0
-28,-43,15,1,1,0
-15,-30,15,1,1,0
-12,0,-12,0,1,1
-2,-12,10,1,1,0
-27,-29,2,1,1,0
-7,-12,5,1,1,0
29,33,-4,0,1,1
-47,-29,-18,0,1,1
-23,-43,20,1,1,0
13,26,-13,0,1,1
-3,-16,13,1,1,0
-34,-24,-10,0,1,1
-31,-17,-14,0,1,1
39,43,-4,0,1,1
3,22,-19,0,1,1
18,13,5,1,1,0
17,3,14,1,1,0
0,-2,2,1,1,0
-5,-25,20,1,0,1
5,1,4,1,0,1
14,30,-16,0,0,0
44,42,2,1,0,1
2,7,-5,0,0,0
28,28,0,0,0,0
24,9,15,1,0,1
-44,-38,-6,0,0,0
-3,9,-12,0,1,1
55,42,13,1,1,0
-63,-44,-19,0,1,1
-63,-45,-18,0,1,1
-33,-22,-11,0,1,1
12,18,-6,0,1,1
23,33,-10,0,1,1
40,26,14,1,1,0
43,33,10,1,1,0
-57,-45,-12,0,1,1
48,33,15,1,1,0
34,42,-8,0,1,1
15,0,15,1,1,0
36,16,20,1,1,0
32,36,-4,0,1,1
-13,-25,12,1,1,0
-7,10,-17,0,1,1
1,-5,6,1,1,0
-41,-40,-1,0,1,1
-11,-1,-10,0,1,1
-18,-6,-12,0,1,1
-1,-10,9,1,0,1
-7,-5,-2,0,0,0
-1,-17,16,1,0,1
-18,-1,-17,0,0,0
-16,-32,16,1,0,1
56,44,12,1,0,1
13,-4,17,1,0,1
8,-9,17,1,0,1
22,26,-4,0,0,0
33,41,-8,0,0,0
58,39,19,1,0,1
28,33,-5,0,0,0
-8,-2,-6,0,0,0
4,10,-6,0,0,0
-3,1,-4,0,0,0
5,-8,13,1,0,1
-51,-41,-10,0,0,0
-2,3,-5,0,1,1
57,40,17,1,1,0
47,38,9,1,1,0
-29,-26,-3,0,1,1
-46,-31,-15,0,1,1
51,33,18,1,1,0
28,14,14,1,1,0
-33,-34,1,1,1,0
26,13,13,1,1,0
-52,-35,-17,0,1,1
-26,-7,-19,0,1,1
-25,-23,-2,0,1,1
9,23,-14,0,1,1
-37,-29,-8,0,1,1
-46,-32,-14,0,1,1
35,38,-3,0,0,0
-38,-40,2,1,0,1
25,26,-1,0,0,0
-39,-21,-18,0,0,0
-43,-35,-8,0,0,0
-32,-31,-1,0,0,0
-30,-45,15,1,0,1
-60,-42,-18,0,0,0
-11,-14,3,1,1,0
-9,-22,13,1,1,0
-28,-31,3,1,1,0
-2,-7,5,1,1,0
-22,-33,11,1,1,0
-20,-36,16,1,1,0
-62,-45,-17,0,1,1
17,7,10,1,1,0
-39,-22,-17,0,1,1
10,-6,16,1,1,0
-29,-22,-7,0,1,1
-20,-17,-3,0,0,0
10,27,-17,0,0,0
-33,-21,-12,0,0,0
-18,-12,-6,0,0,0
20,16,4,1,0,1
-21,-6,-15,0,0,0
37,20,17,1,0,1
20,27,-7,0,0,0
32,28,4,1,1,0
-1,10,-11,0,1,1
-35,-35,0,0,1,1
33,40,-7,0,1,1
12,-8,20,1,1,0
16,28,-12,0,1,1
-4,5,-9,0,1,1
0,-11,11,1,1,0
57,44,13,1,1,0
-8,3,-11,0,1,1
-28,-42,14,1,1,0
-31,-27,-4,0,1,1
-34,-19,-15,0,1,1
19,26,-7,0,1,1
-10,-29,19,1,1,0
16,18,-2,0,1,1
41,38,3,1,1,0
37,20,17,1,1,0
-3,0,-3,0,1,1
0,20,-20,0,1,1
-6,12,-18,0,0,0
18,22,-4,0,0,0
24,13,11,1,0,1
41,36,5,1,0,1
-18,-6,-12,0,0,0
-5,-20,15,1,0,1
-24,-16,-8,0,0,0
20,3,17,1,0,1
25,13,12,1,0,1
-10,2,-12,0,0,0
-32,-44,12,1,0,1
-9,-2,-7,0,0,0
7,0,7,1,0,1
35,24,11,1,1,0
20,21,-1,0,1,1
-5,-11,6,1,1,0
5,23,-18,0,1,1
54,38,16,1,1,0
27,11,16,1,1,0
-38,-30,-8,0,1,1
-38,-19,-19,0,1,1
-8,11,-19,0,1,1
-40,-41,1,1,0,1
-33,-29,-4,0,0,0
-2,-1,-1,0,0,0
2,5,-3,0,0,0
12,1,11,1,0,1
10,21,-11,0,0,0
-23,-10,-13,0,0,0
3,-17,20,1,0,1
16,25,-9,0,0,0
49,37,12,1,0,1
-38,-21,-17,0,0,0
22,19,3,1,0,1
9,10,-1,0,0,0
5,12,-7,0,0,0
3,-5,8,1,0,1
-23,-17,-6,0,0,0
24,31,-7,0,0,0
13,1,12,1,0,1
36,20,16,1,0,1
1,18,-17,0,0,0
-24,-20,-4,0,0,0
-20,-17,-3,0,1,1
-4,-16,12,1,1,0
-46,-38,-8,0,1,1
15,29,-14,0,1,1
-35,-27,-8,0,1,1
-36,-32,-4,0,1,1
4,15,-11,0,1,1
34,30,4,1,1,0
-2,-6,4,1,1,0
37,35,2,1,1,0
-16,-17,1,1,1,0
11,26,-15,0,1,1
11,20,-9,0,1,1
15,24,-9,0,1,1
63,43,20,1,1,0
17,34,-17,0,1,1
9,22,-13,0,0,0
-17,-29,12,1,0,1
9,29,-20,0,0,0
1,-10,11,1,0,1
17,34,-17,0,0,0
-16,-11,-5,0,0,0
-48,-43,-5,0,0,0
-41,-21,-20,0,0,0
-44,-31,-13,0,0,0
42,42,0,0,0,0
-12,-11,-1,0,0,0
-33,-13,-20,0,0,0
-6,5,-11,0,0,0
6,6,0,0,1,1
50,31,19,1,1,0
-47,-30,-17,0,1,1
-25,-21,-4,0,1,1
-2,-13,11,1,1,0
40,37,3,1,1,0
5,-12,17,1,1,0
29,10,19,1,1,0
31,32,-1,0,1,1
27,28,-1,0,1,1
2,18,-16,0,1,1
15,1,14,1,1,0
-6,-13,7,1,0,1
32,19,13,1,0,1
17,1,16,1,0,1
38,41,-3,0,0,0
31,29,2,1,0,1
-1,2,-3,0,0,0
1,-19,20,1,0,1
31,41,-10,0,0,0
24,38,-14,0,0,0
25,16,9,1,0,1
8,23,-15,0,0,0
-13,-24,11,1,0,1
-57,-39,-18,0,0,0
40,33,7,1,1,0
25,32,-7,0,1,1
19,32,-13,0,1,1
2,-6,8,1,1,0
-17,-4,-13,0,1,1
22,33,-11,0,1,1
6,-7,13,1,1,0
-14,-19,5,1,1,0
-14,-15,1,1,1,0
8,1,7,1,1,0
-12,-1,-11,0,1,1
-35,-26,-9,0,1,1
-4,-17,13,1,1,0
12,16,-4,0,1,1
-20,-2,-18,0,0,0
-42,-42,0,0,0,0
-14,-30,16,1,0,1
-18,0,-18,0,0,0
15,-5,20,1,0,1
-15,-29,14,1,0,1
-30,-29,-1,0,0,0
-9,-18,9,1,0,1
-1,15,-16,0,0,0
14,1,13,1,0,1
-22,-30,8,1,0,1
-9,-19,10,1,0,1
-8,-1,-7,0,0,0
-14,-29,15,1,1,0
10,0,10,1,1,0
11,1,10,1,1,0
-7,-26,19,1,1,0
-30,-18,-12,0,1,1
39,43,-4,0,1,1
-17,-12,-5,0,1,1
-32,-29,-3,0,1,1
5,5,0,0,1,1
11,9,2,1,1,0
36,30,6,1,1,0
36,25,11,1,1,0
-55,-44,-11,0,1,1
-13,-27,14,1,1,0
-37,-45,8,1,1,0
-7,7,-14,0,1,1
-18,-30,12,1,0,1
5,4,1,1,0,1
4,22,-18,0,0,0
-57,-39,-18,0,0,0
10,0,10,1,0,1
-24,-24,0,0,0,0
-16,-25,9,1,0,1
-13,-23,10,1,0,1
-24,-6,-18,0,0,0
7,16,-9,0,0,0
-14,-10,-4,0,0,0
-31,-16,-15,0,0,0
-46,-44,-2,0,0,0
-43,-23,-20,0,0,0
-41,-40,-1,0,0,0
17,3,14,1,1,0
0,20,-20,0,1,1
21,32,-11,0,1,1
0,2,-2,0,1,1
-33,-44,11,1,1,0
19,13,6,1,1,0
22,33,-11,0,1,1
-20,-28,8,1,1,0
-4,11,-15,0,1,1
20,32,-12,0,1,1
32,14,18,1,1,0
-16,-2,-14,0,0,0
5,-14,19,1,0,1
-48,-44,-4,0,0,0
32,16,16,1,0,1
-47,-30,-17,0,0,0
12,-2,14,1,0,1
-32,-27,-5,0,0,0
16,21,-5,0,0,0
39,33,6,1,0,1
16,1,15,1,0,1
-1,-6,5,1,0,1
-20,-40,20,1,0,1
-42,-29,-13,0,0,0
-39,-34,-5,0,1,1
19,37,-18,0,1,1
-25,-6,-19,0,1,1
-40,-37,-3,0,1,1
-31,-25,-6,0,1,1
0,-11,11,1,1,0
5,19,-14,0,1,1
1,18,-17,0,1,1
7,-9,16,1,1,0
34,42,-8,0,1,1
-5,-16,11,1,1,0
-23,-5,-18,0,1,1
11,13,-2,0,1,1
21,11,10,1,1,0
7,17,-10,0,1,1
-29,-42,13,1,1,0
-14,-9,-5,0,1,1
24,43,-19,0,1,1
-6,0,-6,0,1,1
-28,-42,14,1,1,0
-4,-14,10,1,1,0
-61,-43,-18,0,0,0
-36,-30,-6,0,0,0
-50,-34,-16,0,0,0
43,37,6,1,0,1
31,24,7,1,0,1
26,32,-6,0,0,0
14,32,-18,0,0,0
-20,-14,-6,0,0,0
-4,-11,7,1,0,1
-11,-19,8,1,0,1
-15,-28,13,1,0,1
-20,-4,-16,0,0,0
-56,-44,-12,0,0,0
-6,-15,9,1,1,0
42,31,11,1,1,0
-28,-15,-13,0,1,1
48,35,13,1,1,0
-15,-16,1,1,1,0
12,29,-17,0,1,1
-41,-30,-11,0,1,1
-29,-9,-20,0,1,1
-54,-34,-20,0,1,1
15,9,6,1,1,0
62,44,18,1,1,0
3,-9,12,1,1,0
-31,-31,0,0,1,1
-33,-32,-1,0,1,1
51,41,10,1,1,0
47,29,18,1,1,0
-33,-40,7,1,1,0
34,33,1,1,1,0
-22,-12,-10,0,1,1
26,31,-5,0,1,1
-30,-16,-14,0,1,1
48,41,7,1,0,1
15,8,7,1,0,1
41,32,9,1,0,1
22,37,-15,0,0,0
-47,-31,-16,0,0,0
26,25,1,1,0,1
-19,-34,15,1,0,1
40,34,6,1,0,1
20,28,-8,0,0,0
34,23,11,1,0,1
46,33,13,1,0,1
4,8,-4,0,0,0
-35,-26,-9,0,1,1
-47,-36,-11,0,1,1
6,-11,17,1,1,0
9,16,-7,0,1,1
42,37,5,1,1,0
23,40,-17,0,1,1
-4,-2,-2,0,1,1
-11,-24,13,1,1,0
-21,-22,1,1,1,0
2,7,-5,0,1,1
-40,-30,-10,0,1,1
-6,-26,20,1,1,0
32,13,19,1,1,0
14,34,-20,0,1,1
6,11,-5,0,1,1
50,44,6,1,1,0
47,40,7,1,1,0
26,40,-14,0,1,1
-32,-30,-2,0,1,1
-43,-23,-20,0,1,1
19,16,3,1,1,0
-20,-18,-2,0,0,0
44,33,11,1,0,1
-7,-3,-4,0,0,0
28,12,16,1,0,1
1,-7,8,1,0,1
9,20,-11,0,0,0
12,19,-7,0,0,0
-30,-33,3,1,0,1
-9,5,-14,0,0,0
-33,-19,-14,0,0,0
-51,-38,-13,0,0,0
17,12,5,1,0,1
-15,-28,13,1,0,1
-20,-31,11,1,0,1
-18,-5,-13,0,0,0
20,5,15,1,0,1
-7,-12,5,1,1,0
-23,-38,15,1,1,0
26,36,-10,0,1,1
45,38,7,1,1,0
-6,-19,13,1,1,0
-23,-17,-6,0,1,1
24,42,-18,0,1,1
-20,-40,20,1,1,0
31,43,-12,0,1,1
-13,-7,-6,0,1,1
9,-2,11,1,1,0
-15,-31,16,1,1,0
-45,-31,-14,0,1,1
-4,2,-6,0,0,0
-55,-41,-14,0,0,0
52,38,14,1,0,1
52,39,13,1,0,1
33,20,13,1,0,1
38,26,12,1,0,1
4,17,-13,0,0,0
23,26,-3,0,0,0
-15,-4,-11,0,0,0
5,7,-2,0,1,1
3,-11,14,1,1,0
37,37,0,0,1,1
-18,-15,-3,0,1,1
3,13,-10,0,1,1
-17,-8,-9,0,1,1
15,2,13,1,1,0
-41,-26,-15,0,1,1
-21,-28,7,1,1,0
-40,-21,-19,0,1,1
53,33,20,1,1,0
-23,-21,-2,0,1,1
-29,-36,7,1,1,0
26,35,-9,0,1,1
18,36,-18,0,1,1
37,32,5,1,1,0
18,3,15,1,0,1
-3,-15,12,1,0,1
45,38,7,1,0,1
-2,11,-13,0,0,0
35,26,9,1,0,1
-9,1,-10,0,0,0
34,39,-5,0,0,0
20,36,-16,0,0,0
56,38,18,1,0,1
-23,-12,-11,0,0,0
-61,-41,-20,0,0,0
-12,-4,-8,0,0,0
-11,8,-19,0,0,0
-31,-36,5,1,0,1
15,27,-12,0,0,0
33,28,5,1,0,1
22,30,-8,0,0,0
-46,-44,-2,0,0,0
-32,-37,5,1,0,1
59,39,20,1,0,1
20,22,-2,0,0,0
39,39,0,0,1,1
-15,-1,-14,0,1,1
18,16,2,1,1,0
-31,-35,4,1,1,0
6,14,-8,0,1,1
-44,-34,-10,0,1,1
-7,-11,4,1,1,0
13,21,-8,0,1,1
-6,11,-17,0,1,1
-28,-30,2,1,1,0
9,-4,13,1,1,0
-9,10,-19,0,1,1
7,11,-4,0,1,1
2,18,-16,0,1,1
20,10,10,1,1,0
-2,1,-3,0,1,1
-1,13,-14,0,1,1
1,8,-7,0,1,1
3,10,-7,0,1,1
-18,-32,14,1,1,0
-14,-15,1,1,1,0
23,24,-1,0,0,0
2,5,-3,0,0,0
-32,-33,1,1,0,1
-13,-23,10,1,0,1
-59,-44,-15,0,0,0
-59,-45,-14,0,0,0
-28,-10,-18,0,0,0
8,3,5,1,0,1
-46,-35,-11,0,0,0
28,38,-10,0,1,1
-32,-29,-3,0,1,1
38,26,12,1,1,0
-24,-14,-10,0,1,1
-16,-12,-4,0,1,1
-4,-12,8,1,1,0
7,4,3,1,1,0
23,33,-10,0,1,1
-56,-44,-12,0,1,1
-2,5,-7,0,1,1
8,27,-19,0,1,1
12,-8,20,1,1,0
-3,15,-18,0,1,1
28,31,-3,0,1,1
38,39,-1,0,1,1
0,9,-9,0,1,1
1,16,-15,0,1,1
44,31,13,1,1,0
-53,-38,-15,0,1,1
6,8,-2,0,1,1
6,20,-14,0,1,1
1,-3,4,1,0,1
-9,-1,-8,0,0,0
-44,-44,0,0,0,0
-53,-41,-12,0,0,0
34,18,16,1,0,1
14,-3,17,1,0,1
-47,-43,-4,0,0,0
-36,-26,-10,0,0,0
-45,-34,-11,0,0,0
-24,-25,1,1,0,1
-26,-17,-9,0,1,1
26,18,8,1,1,0
53,43,10,1,1,0
-14,4,-18,0,1,1
19,33,-14,0,1,1
2,7,-5,0,1,1
44,38,6,1,1,0
33,38,-5,0,1,1
-27,-38,11,1,1,0
32,40,-8,0,0,0
15,26,-11,0,0,0
-32,-44,12,1,0,1
10,19,-9,0,0,0
-24,-35,11,1,0,1
18,24,-6,0,0,0
-21,-27,6,1,0,1
14,7,7,1,0,1
37,35,2,1,0,1
-27,-34,7,1,0,1
-12,-28,16,1,0,1
31,14,17,1,0,1
-48,-32,-16,0,0,0
-11,-10,-1,0,0,0
-12,-10,-2,0,0,0
20,19,1,1,0,1
-12,-10,-2,0,0,0
-4,2,-6,0,0,0
16,24,-8,0,0,0
-17,-9,-8,0,0,0
16,36,-20,0,1,1
40,33,7,1,1,0
-25,-34,9,1,1,0
-15,-13,-2,0,1,1
6,13,-7,0,1,1
35,35,0,0,1,1
-33,-33,0,0,1,1
-22,-23,1,1,1,0
-46,-32,-14,0,1,1
-30,-33,3,1,1,0
19,20,-1,0,1,1
-45,-40,-5,0,1,1
20,28,-8,0,0,0
-21,-28,7,1,0,1
-10,-25,15,1,0,1
35,17,18,1,0,1
18,27,-9,0,0,0
18,36,-18,0,0,0
-15,-35,20,1,0,1
13,7,6,1,0,1
10,6,4,1,0,1
-7,-26,19,1,0,1
-6,5,-11,0,1,1
-55,-39,-16,0,1,1
35,38,-3,0,1,1
-47,-31,-16,0,1,1
8,10,-2,0,1,1
-6,13,-19,0,1,1
25,6,19,1,1,0
26,23,3,1,1,0
41,29,12,1,1,0
-14,-8,-6,0,1,1
6,-7,13,1,1,0
-18,-1,-17,0,1,1
-55,-41,-14,0,1,1
35,40,-5,0,1,1
-17,-1,-16,0,1,1
13,19,-6,0,1,1
51,36,15,1,1,0
-35,-39,4,1,1,0
-17,-6,-11,0,1,1
-6,-26,20,1,1,0
10,-2,12,1,1,0
-25,-6,-19,0,0,0
-34,-14,-20,0,0,0
-19,-13,-6,0,0,0
24,15,9,1,0,1
1,14,-13,0,0,0
3,-14,17,1,0,1
12,7,5,1,0,1
-25,-35,10,1,0,1
10,6,4,1,0,1
40,30,10,1,0,1
-9,0,-9,0,0,0
7,4,3,1,0,1
-25,-9,-16,0,0,0
6,-8,14,1,0,1
31,23,8,1,0,1
-13,-28,15,1,0,1
-21,-5,-16,0,0,0
-32,-36,4,1,0,1
14,27,-13,0,0,0
5,9,-4,0,1,1
40,42,-2,0,1,1
6,3,3,1,1,0
33,42,-9,0,1,1
15,-1,16,1,1,0
-49,-44,-5,0,1,1
-44,-38,-6,0,1,1
23,36,-13,0,1,1
-35,-34,-1,0,0,0
36,43,-7,0,0,0
-43,-32,-11,0,0,0
26,8,18,1,0,1
31,39,-8,0,0,0
0,-17,17,1,0,1
-17,-32,15,1,0,1
16,9,7,1,0,1
47,28,19,1,0,1
-22,-30,8,1,0,1
-8,-28,20,1,0,1
52,36,16,1,1,0
8,4,4,1,1,0
13,9,4,1,1,0
-16,4,-20,0,1,1
-29,-17,-12,0,1,1
-23,-16,-7,0,1,1
-1,-7,6,1,1,0
-21,-21,0,0,1,1
21,26,-5,0,1,1
-2,13,-15,0,1,1
-18,-21,3,1,1,0
-12,1,-13,0,1,1
-8,-1,-7,0,1,1
-37,-39,2,1,1,0
-17,-30,13,1,0,1
-21,-36,15,1,0,1
55,43,12,1,0,1
25,13,12,1,0,1
-33,-19,-14,0,0,0
-32,-21,-11,0,0,0
27,15,12,1,0,1
-8,-27,19,1,0,1
13,29,-16,0,1,1
10,25,-15,0,1,1
-34,-41,7,1,1,0
17,22,-5,0,1,1
2,2,0,0,1,1
8,10,-2,0,1,1
46,36,10,1,1,0
-14,-4,-10,0,1,1
57,40,17,1,1,0
32,34,-2,0,1,1
27,28,-1,0,1,1
-1,-21,20,1,1,0
-50,-32,-18,0,1,1
-28,-32,4,1,1,0
50,39,11,1,1,0
-33,-34,1,1,1,0
14,23,-9,0,1,1
29,10,19,1,1,0
16,20,-4,0,1,1
3,-13,16,1,1,0
26,9,17,1,0,1
54,36,18,1,0,1
59,42,17,1,0,1
-8,-27,19,1,0,1
-26,-22,-4,0,0,0
13,14,-1,0,0,0
-5,2,-7,0,0,0
30,25,5,1,0,1
-37,-35,-2,0,0,0
-27,-23,-4,0,0,0
-35,-25,-10,0,0,0
40,36,4,1,0,1
-19,-10,-9,0,0,0
34,38,-4,0,0,0
6,-10,16,1,0,1
1,-2,3,1,0,1
31,21,10,1,0,1
-1,3,-4,0,0,0
-19,-35,16,1,0,1
-41,-43,2,1,1,0
-18,-2,-16,0,1,1
-42,-34,-8,0,1,1
-9,7,-16,0,1,1
-12,-22,10,1,1,0
-10,-8,-2,0,1,1
3,6,-3,0,1,1
8,11,-3,0,1,1
-3,4,-7,0,1,1
44,40,4,1,1,0
2,-11,13,1,1,0
-6,14,-20,0,1,1
-38,-44,6,1,1,0
-48,-29,-19,0,1,1
-44,-26,-18,0,1,1
-30,-33,3,1,1,0
-10,-27,17,1,1,0
10,29,-19,0,1,1
-21,-34,13,1,1,0
-43,-37,-6,0,1,1
17,37,-20,0,1,1
37,30,7,1,0,1
31,23,8,1,0,1
-16,-25,9,1,0,1
5,20,-15,0,0,0
44,37,7,1,0,1
-32,-34,2,1,0,1
25,43,-18,0,0,0
18,16,2,1,0,1
22,36,-14,0,0,0
-40,-42,2,1,0,1
-35,-42,7,1,0,1
1,-11,12,1,0,1
-52,-42,-10,0,0,0
-26,-9,-17,0,0,0
4,18,-14,0,0,0
51,40,11,1,0,1
-36,-34,-2,0,0,0
-21,-14,-7,0,0,0
-36,-38,2,1,0,1
-43,-43,0,0,0,0
3,5,-2,0,0,0
-14,-28,14,1,1,0
-32,-17,-15,0,1,1
-27,-35,8,1,1,0
-7,-23,16,1,1,0
19,25,-6,0,1,1
20,35,-15,0,1,1
56,38,18,1,1,0
4,2,2,1,1,0
-49,-42,-7,0,0,0
2,-5,7,1,0,1
10,27,-17,0,0,0
33,19,14,1,0,1
-26,-42,16,1,0,1
11,-5,16,1,0,1
-43,-45,2,1,0,1
15,-1,16,1,0,1
-27,-28,1,1,0,1
-8,2,-10,0,0,0
-2,6,-8,0,0,0
-24,-31,7,1,1,0
3,-7,10,1,1,0
-1,18,-19,0,1,1
31,42,-11,0,1,1
30,24,6,1,1,0
3,3,0,0,1,1
26,36,-10,0,1,1
-46,-34,-12,0,1,1
-4,-24,20,1,1,0
-25,-19,-6,0,1,1
-1,13,-14,0,1,1
17,26,-9,0,1,1
-4,-17,13,1,1,0
-43,-37,-6,0,1,1
-43,-42,-1,0,1,1
59,39,20,1,1,0
-10,2,-12,0,1,1
32,43,-11,0,0,0
37,27,10,1,0,1
-20,-28,8,1,0,1
-2,-1,-1,0,0,0
2,-10,12,1,0,1
-54,-38,-16,0,0,0
-47,-43,-4,0,0,0
23,40,-17,0,0,0
-40,-21,-19,0,0,0
34,16,18,1,0,1
26,32,-6,0,0,0
35,19,16,1,0,1
46,31,15,1,0,1
-31,-40,9,1,0,1
26,30,-4,0,0,0
-34,-42,8,1,0,1
30,36,-6,0,0,0
54,44,10,1,0,1
-18,-32,14,1,0,1
-49,-41,-8,0,0,0
45,25,20,1,0,1
11,-6,17,1,1,0
-21,-40,19,1,1,0
60,44,16,1,1,0
-61,-44,-17,0,1,1
32,37,-5,0,1,1
-28,-21,-7,0,1,1
-15,-25,10,1,1,0
36,24,12,1,1,0
50,35,15,1,1,0
-5,-7,2,1,1,0
-19,-20,1,1,1,0
9,22,-13,0,1,1
8,-8,16,1,1,0
-3,-20,17,1,0,1
-35,-21,-14,0,0,0
-14,-5,-9,0,0,0
35,34,1,1,0,1
1,-3,4,1,0,1
-46,-42,-4,0,0,0
-11,-16,5,1,0,1
49,32,17,1,0,1
-12,-31,19,1,0,1
1,-10,11,1,0,1
-48,-29,-19,0,0,0
-5,0,-5,0,0,0
-30,-13,-17,0,0,0
-28,-45,17,1,0,1
-9,-27,18,1,0,1
-30,-40,10,1,1,0
41,34,7,1,1,0
-26,-22,-4,0,1,1
-9,-20,11,1,1,0
-20,-2,-18,0,1,1
42,41,1,1,1,0
28,38,-10,0,1,1
-4,-19,15,1,1,0
10,-10,20,1,1,0
-39,-33,-6,0,1,1
-36,-27,-9,0,1,1
20,25,-5,0,1,1
10,-7,17,1,1,0
-44,-26,-18,0,1,1
30,26,4,1,1,0
-6,-11,5,1,1,0
-36,-33,-3,0,1,1
-34,-37,3,1,1,0
19,16,3,1,1,0
-46,-38,-8,0,1,1
7,14,-7,0,1,1
-41,-21,-20,0,0,0
-10,-26,16,1,0,1
-14,-19,5,1,0,1
24,22,2,1,0,1
16,34,-18,0,0,0
16,27,-11,0,0,0
-23,-13,-10,0,0,0
16,33,-17,0,0,0
-18,-17,-1,0,0,0
5,0,5,1,0,1
32,19,13,1,0,1
-36,-45,9,1,1,0
13,26,-13,0,1,1
-9,-7,-2,0,1,1
-17,-34,17,1,1,0
29,12,17,1,1,0
30,32,-2,0,1,1
-37,-41,4,1,1,0
33,39,-6,0,1,1
4,21,-17,0,1,1
-32,-25,-7,0,1,1
13,19,-6,0,1,1
-45,-36,-9,0,1,1
8,23,-15,0,0,0
3,-8,11,1,0,1
31,28,3,1,0,1
-11,-31,20,1,0,1
-20,-3,-17,0,0,0
-20,-14,-6,0,0,0
0,10,-10,0,0,0
59,40,19,1,0,1
-1,15,-16,0,0,0
0,12,-12,0,0,0
-15,-30,15,1,0,1
31,39,-8,0,0,0
18,22,-4,0,0,0
14,-4,18,1,0,1
15,26,-11,0,1,1
4,-14,18,1,1,0
-9,-10,1,1,1,0
-3,16,-19,0,1,1
-17,-20,3,1,1,0
-56,-39,-17,0,1,1
47,44,3,1,1,0
43,41,2,1,1,0
-21,-6,-15,0,1,1
17,6,11,1,1,0
7,22,-15,0,1,1
30,37,-7,0,1,1
13,-5,18,1,1,0
30,44,-14,0,1,1
8,20,-12,0,1,1
4,-7,11,1,1,0
-42,-25,-17,0,1,1
25,27,-2,0,1,1
41,21,20,1,0,1
21,3,18,1,0,1
50,40,10,1,0,1
33,25,8,1,0,1
-29,-32,3,1,0,1
7,22,-15,0,0,0
10,-4,14,1,0,1
13,26,-13,0,0,0
-11,-25,14,1,0,1
-21,-2,-19,0,0,0
16,6,10,1,0,1
-31,-44,13,1,0,1
12,31,-19,0,0,0
32,42,-10,0,0,0
19,27,-8,0,0,0
0,0,0,0,0,0
-30,-11,-19,0,0,0
25,6,19,1,0,1
16,24,-8,0,0,0
15,-5,20,1,0,1
26,31,-5,0,0,0
43,34,9,1,1,0
-2,-10,8,1,1,0
20,32,-12,0,1,1
60,43,17,1,1,0
-40,-26,-14,0,1,1
45,37,8,1,1,0
43,43,0,0,1,1
6,-10,16,1,1,0
0,13,-13,0,1,1
-8,-15,7,1,1,0
21,32,-11,0,1,1
16,23,-7,0,1,1
20,33,-13,0,1,1
-46,-35,-11,0,0,0
3,22,-19,0,0,0
-12,-23,11,1,0,1
-20,-39,19,1,0,1
-27,-38,11,1,0,1
-23,-4,-19,0,0,0
26,7,19,1,0,1
50,33,17,1,0,1
-27,-27,0,0,0,0
-28,-34,6,1,0,1
15,29,-14,0,1,1
42,31,11,1,1,0
23,12,11,1,1,0
-19,-8,-11,0,1,1
-31,-15,-16,0,1,1
-6,-15,9,1,1,0
-56,-45,-11,0,1,1
-18,-5,-13,0,1,1
-43,-45,2,1,1,0
45,32,13,1,1,0
22,12,10,1,1,0
-30,-35,5,1,1,0
21,40,-19,0,1,1
-31,-11,-20,0,1,1
23,18,5,1,1,0
54,42,12,1,1,0
-24,-39,15,1,1,0
19,1,18,1,1,0
-38,-31,-7,0,1,1
15,23,-8,0,1,1
27,22,5,1,1,0
4,8,-4,0,0,0
21,29,-8,0,0,0
27,13,14,1,0,1
42,32,10,1,0,1
-5,-11,6,1,0,1
-21,-4,-17,0,0,0
-6,-2,-4,0,0,0
-37,-34,-3,0,0,0
-26,-17,-9,0,0,0
32,43,-11,0,0,0
32,22,10,1,0,1
-36,-19,-17,0,0,0
-14,-21,7,1,0,1
21,37,-16,0,0,0
50,44,6,1,0,1
-39,-24,-15,0,0,0
43,31,12,1,0,1
3,-6,9,1,0,1
31,39,-8,0,0,0
41,25,16,1,1,0
-54,-44,-10,0,1,1
-19,-12,-7,0,1,1
30,43,-13,0,1,1
-23,-33,10,1,1,0
17,14,3,1,1,0
-7,6,-13,0,1,1
-2,12,-14,0,1,1
-59,-45,-14,0,1,1
2,-1,3,1,1,0
-48,-45,-3,0,1,1
-27,-8,-19,0,1,1
-28,-30,2,1,1,0
-29,-28,-1,0,1,1
-23,-38,15,1,1,0
-29,-26,-3,0,1,1
-11,-31,20,1,1,0
35,35,0,0,1,1
-45,-41,-4,0,1,1
33,29,4,1,1,0
-12,-18,6,1,1,0
-15,-20,5,1,0,1
-16,-28,12,1,0,1
-10,3,-13,0,0,0
13,-4,17,1,0,1
-19,-13,-6,0,0,0
-35,-25,-10,0,0,0
-58,-45,-13,0,0,0
18,-1,19,1,0,1
19,30,-11,0,0,0
44,39,5,1,0,1
-32,-41,9,1,0,1
3,8,-5,0,0,0
-35,-32,-3,0,0,0
43,39,4,1,0,1
-16,-10,-6,0,0,0
40,20,20,1,0,1
2,-16,18,1,0,1
22,20,2,1,0,1
24,37,-13,0,0,0
-41,-29,-12,0,0,0
22,25,-3,0,0,0
-43,-35,-8,0,1,1
-23,-12,-11,0,1,1
41,27,14,1,1,0
-35,-20,-15,0,1,1
4,7,-3,0,1,1
-34,-20,-14,0,1,1
-5,0,-5,0,1,1
-18,1,-19,0,1,1
-38,-33,-5,0,1,1
-16,4,-20,0,1,1
15,22,-7,0,1,1
-9,-1,-8,0,0,0
31,41,-10,0,0,0
2,22,-20,0,0,0
26,12,14,1,0,1
49,29,20,1,0,1
-26,-30,4,1,0,1
34,20,14,1,0,1
-51,-38,-13,0,0,0
-14,-27,13,1,0,1
-39,-23,-16,0,0,0
-43,-38,-5,0,0,0
22,41,-19,0,0,0
-10,-3,-7,0,0,0
-9,-26,17,1,0,1
-39,-24,-15,0,0,0
9,24,-15,0,0,0
-26,-17,-9,0,0,0
-26,-30,4,1,0,1
-27,-10,-17,0,0,0
-52,-41,-11,0,0,0
-20,0,-20,0,0,0
-17,-4,-13,0,1,1
-16,-19,3,1,1,0
24,28,-4,0,1,1
35,25,10,1,1,0
-37,-25,-12,0,1,1
28,16,12,1,1,0
22,22,0,0,1,1
-10,-6,-4,0,1,1
-5,-10,5,1,1,0
54,44,10,1,1,0
-38,-39,1,1,1,0
51,43,8,1,1,0
-48,-40,-8,0,1,1
-2,-1,-1,0,1,1
14,9,5,1,1,0
52,33,19,1,0,1
39,27,12,1,0,1
48,29,19,1,0,1
10,8,2,1,0,1
-7,-15,8,1,0,1
-4,-14,10,1,0,1
6,-13,19,1,0,1
19,7,12,1,0,1
-2,12,-14,0,0,0
6,3,3,1,0,1
-24,-25,1,1,0,1
-24,-28,4,1,0,1
12,-2,14,1,0,1
-61,-45,-16,0,0,0
-33,-30,-3,0,0,0
-16,-16,0,0,0,0
-49,-42,-7,0,0,0
37,32,5,1,0,1
-17,3,-20,0,0,0
-6,-20,14,1,0,1
-46,-45,-1,0,0,0
35,31,4,1,1,0
-7,2,-9,0,1,1
-4,-19,15,1,1,0
17,25,-8,0,1,1
-45,-30,-15,0,1,1
-18,-29,11,1,1,0
2,16,-14,0,1,1
-23,-4,-19,0,1,1
-53,-38,-15,0,1,1
28,42,-14,0,1,1
-15,-22,7,1,0,1
-34,-14,-20,0,0,0
-5,-2,-3,0,0,0
-56,-37,-19,0,0,0
8,19,-11,0,0,0
24,34,-10,0,0,0
-13,-20,7,1,0,1
-11,-27,16,1,0,1
10,30,-20,0,0,0
48,33,15,1,0,1
42,28,14,1,1,0
-28,-26,-2,0,1,1
-41,-22,-19,0,1,1
-14,-5,-9,0,1,1
50,40,10,1,1,0
-9,-27,18,1,1,0
6,10,-4,0,1,1
18,13,5,1,1,0
32,14,18,1,1,0
-28,-20,-8,0,1,1
4,-14,18,1,1,0
-17,-23,6,1,1,0
-22,-13,-9,0,1,1
25,34,-9,0,1,1
-43,-39,-4,0,1,1
24,12,12,1,0,1
34,44,-10,0,0,0
36,23,13,1,0,1
22,20,2,1,0,1
1,-7,8,1,0,1
5,-14,19,1,0,1
-61,-45,-16,0,0,0
18,18,0,0,0,0
17,31,-14,0,0,0
-39,-31,-8,0,0,0
17,21,-4,0,0,0
-52,-38,-14,0,0,0
1,11,-10,0,0,0
59,42,17,1,1,0
25,9,16,1,1,0
-45,-39,-6,0,1,1
-1,6,-7,0,1,1
30,19,11,1,1,0
-1,19,-20,0,1,1
-25,-45,20,1,1,0
43,42,1,1,1,0
-15,-5,-10,0,1,1
23,11,12,1,1,0
11,7,4,1,1,0
13,21,-8,0,1,1
26,17,9,1,1,0
5,2,3,1,0,1
11,12,-1,0,0,0
23,24,-1,0,0,0
26,6,20,1,0,1
-23,-24,1,1,0,1
-12,-2,-10,0,0,0
24,18,6,1,0,1
-11,-26,15,1,0,1
23,37,-14,0,0,0
-56,-45,-11,0,1,1
-39,-32,-7,0,1,1
48,36,12,1,1,0
22,3,19,1,1,0
-18,-37,19,1,1,0
-4,-5,1,1,1,0
34,25,9,1,1,0
-1,-3,2,1,1,0
-24,-23,-1,0,0,0
39,27,12,1,0,1
16,24,-8,0,0,0
35,24,11,1,0,1
12,29,-17,0,0,0
-19,-29,10,1,0,1
45,33,12,1,0,1
11,28,-17,0,0,0
28,10,18,1,0,1
17,7,10,1,0,1
53,34,19,1,0,1
24,40,-16,0,1,1
-29,-19,-10,0,1,1
-43,-42,-1,0,1,1
4,24,-20,0,1,1
-47,-39,-8,0,1,1
42,42,0,0,1,1
-21,-14,-7,0,1,1
-34,-38,4,1,1,0
-16,-27,11,1,1,0
16,21,-5,0,1,1
36,42,-6,0,1,1
62,44,18,1,1,0
-9,-18,9,1,1,0
44,43,1,1,1,0
16,31,-15,0,1,1
-41,-39,-2,0,1,1
17,9,8,1,1,0
-4,-13,9,1,1,0
30,12,18,1,0,1
-61,-42,-19,0,0,0
35,33,2,1,0,1
39,24,15,1,0,1
29,32,-3,0,0,0
40,22,18,1,0,1
-31,-41,10,1,0,1
-11,2,-13,0,0,0
28,21,7,1,0,1
-15,-29,14,1,0,1
27,27,0,0,0,0
31,15,16,1,1,0
0,-14,14,1,1,0
22,19,3,1,1,0
-12,2,-14,0,1,1
2,1,1,1,1,0
54,37,17,1,1,0
20,30,-10,0,1,1
18,38,-20,0,1,1
42,27,15,1,1,0
2,-1,3,1,1,0
9,1,8,1,0,1
41,29,12,1,0,1
-11,5,-16,0,0,0
-49,-39,-10,0,0,0
35,39,-4,0,0,0
24,21,3,1,0,1
4,22,-18,0,0,0
9,16,-7,0,0,0
-6,11,-17,0,0,0
16,34,-18,0,0,0
32,22,10,1,0,1
-30,-34,4,1,0,1
-20,-40,20,1,0,1
-18,-1,-17,0,0,0
-48,-31,-17,0,1,1
-47,-34,-13,0,1,1
-62,-45,-17,0,1,1
32,28,4,1,1,0
-32,-42,10,1,1,0
26,12,14,1,1,0
25,34,-9,0,1,1
-26,-15,-11,0,1,1
8,16,-8,0,1,1
42,34,8,1,1,0
0,10,-10,0,1,1
-40,-32,-8,0,1,1
28,35,-7,0,0,0
49,30,19,1,0,1
-13,-10,-3,0,0,0
-38,-25,-13,0,0,0
13,13,0,0,0,0
26,37,-11,0,0,0
27,9,18,1,0,1
-27,-15,-12,0,0,0
38,34,4,1,0,1
26,7,19,1,0,1
-4,-20,16,1,0,1
-15,-9,-6,0,0,0
19,25,-6,0,0,0
-50,-36,-14,0,0,0
-22,-12,-10,0,0,0
-32,-45,13,1,0,1
53,33,20,1,0,1
-40,-45,5,1,0,1
-19,-6,-13,0,0,0
-39,-22,-17,0,1,1
49,35,14,1,1,0
27,32,-5,0,1,1
30,18,12,1,1,0
35,19,16,1,1,0
11,16,-5,0,1,1
-18,-15,-3,0,1,1
-21,-2,-19,0,1,1
34,18,16,1,1,0
-11,2,-13,0,1,1
-25,-8,-17,0,1,1
-17,-6,-11,0,1,1
18,12,6,1,0,1
-30,-36,6,1,0,1
-21,-11,-10,0,0,0
47,39,8,1,0,1
-15,-22,7,1,0,1
-15,-3,-12,0,0,0
-9,-21,12,1,0,1
26,28,-2,0,0,0
-12,2,-14,0,0,0
59,43,16,1,0,1
28,15,13,1,0,1
22,10,12,1,0,1
-20,-34,14,1,0,1
22,5,17,1,0,1
-45,-27,-18,0,0,0
-21,-18,-3,0,0,0
-20,0,-20,0,0,0
24,25,-1,0,0,0
38,39,-1,0,1,1
12,17,-5,0,1,1
-31,-21,-10,0,1,1
6,22,-16,0,1,1
7,22,-15,0,1,1
-6,-13,7,1,1,0
20,10,10,1,1,0
32,42,-10,0,1,1
-33,-29,-4,0,1,1
1,1,0,0,1,1
43,41,2,1,1,0
-34,-33,-1,0,1,1
39,35,4,1,1,0
9,-2,11,1,0,1
-45,-35,-10,0,0,0
-18,-32,14,1,0,1
44,39,5,1,0,1
-36,-25,-11,0,0,0
18,28,-10,0,0,0
32,15,17,1,0,1
31,11,20,1,0,1
-48,-44,-4,0,0,0
37,36,1,1,0,1
18,23,-5,0,0,0
35,17,18,1,0,1
-7,-17,10,1,0,1
-23,-26,3,1,0,1
29,22,7,1,0,1
-7,-17,10,1,0,1
-18,-6,-12,0,0,0
-16,-29,13,1,0,1
18,8,10,1,1,0
58,40,18,1,1,0
53,36,17,1,1,0
-23,-19,-4,0,1,1
-19,-37,18,1,1,0
-23,-31,8,1,1,0
17,36,-19,0,1,1
15,15,0,0,1,1
-20,-39,19,1,1,0
34,37,-3,0,1,1
-14,-26,12,1,1,0
-3,2,-5,0,1,1
-7,9,-16,0,1,1
26,30,-4,0,1,1
-13,-30,17,1,1,0
-33,-14,-19,0,1,1
-18,2,-20,0,1,1
46,32,14,1,1,0
21,7,14,1,0,1
22,10,12,1,0,1
34,15,19,1,0,1
-37,-19,-18,0,0,0
-4,1,-5,0,0,0
20,26,-6,0,0,0
2,5,-3,0,0,0
43,23,20,1,0,1
-52,-38,-14,0,0,0
59,42,17,1,0,1
23,18,5,1,0,1
-20,-39,19,1,0,1
-53,-45,-8,0,0,0
-16,0,-16,0,0,0
2,-18,20,1,0,1
18,-1,19,1,0,1
-26,-12,-14,0,0,0
-18,-14,-4,0,0,0
9,9,0,0,0,0
-19,-2,-17,0,0,0
11,-2,13,1,1,0
32,27,5,1,1,0
-6,-26,20,1,1,0
15,28,-13,0,1,1
-54,-38,-16,0,1,1
19,6,13,1,1,0
14,1,13,1,1,0
25,7,18,1,1,0
-35,-44,9,1,1,0
6,21,-15,0,0,0
36,24,12,1,0,1
24,32,-8,0,0,0
24,17,7,1,0,1
-9,5,-14,0,0,0
15,33,-18,0,0,0
-12,1,-13,0,0,0
30,22,8,1,0,1
14,33,-19,0,0,0
-25,-45,20,1,0,1
-15,-25,10,1,0,1
42,25,17,1,0,1
-22,-21,-1,0,0,0
1,-8,9,1,0,1
29,13,16,1,0,1
-37,-40,3,1,0,1
-45,-35,-10,0,0,0
-50,-39,-11,0,0,0
27,37,-10,0,0,0
-20,-37,17,1,0,1
-54,-43,-11,0,0,0
-20,-23,3,1,1,0
8,22,-14,0,1,1
7,7,0,0,1,1
37,34,3,1,1,0
45,43,2,1,1,0
45,32,13,1,1,0
-1,-8,7,1,1,0
-34,-23,-11,0,1,1
-56,-44,-12,0,1,1
6,-10,16,1,1,0
-40,-30,-10,0,1,1
14,32,-18,0,1,1
15,26,-11,0,1,1
-28,-40,12,1,1,0
-41,-36,-5,0,1,1
-2,-2,0,0,1,1
-29,-37,8,1,1,0
7,6,1,1,1,0
-14,-15,1,1,1,0
22,31,-9,0,0,0
-7,-7,0,0,0,0
-34,-41,7,1,0,1
48,44,4,1,0,1
-14,-8,-6,0,0,0
-61,-45,-16,0,0,0
-22,-38,16,1,0,1
-32,-27,-5,0,0,0
9,15,-6,0,0,0
-20,-28,8,1,0,1
21,32,-11,0,1,1
-11,-4,-7,0,1,1
-18,-20,2,1,1,0
21,3,18,1,1,0
18,32,-14,0,1,1
-38,-41,3,1,1,0
27,40,-13,0,1,1
59,39,20,1,1,0
-21,-17,-4,0,1,1
-59,-45,-14,0,0,0
-24,-29,5,1,0,1
-31,-39,8,1,0,1
3,8,-5,0,0,0
6,-3,9,1,0,1
-17,-20,3,1,0,1
9,25,-16,0,0,0
13,-6,19,1,0,1
-6,-3,-3,0,0,0
9,-8,17,1,0,1
-27,-35,8,1,0,1
-4,6,-10,0,0,0
14,17,-3,0,1,1
6,21,-15,0,1,1
-23,-4,-19,0,1,1
17,-2,19,1,1,0
-28,-18,-10,0,1,1
24,8,16,1,1,0
46,43,3,1,1,0
-35,-15,-20,0,1,1
29,9,20,1,1,0
18,1,17,1,1,0
27,40,-13,0,1,1
42,24,18,1,1,0
-5,-4,-1,0,0,0
11,28,-17,0,0,0
26,31,-5,0,0,0
31,24,7,1,0,1
5,7,-2,0,0,0
-1,-5,4,1,0,1
3,-13,16,1,0,1
27,41,-14,0,0,0
61,41,20,1,0,1
26,6,20,1,0,1
-13,-13,0,0,0,0
-25,-13,-12,0,0,0
-23,-36,13,1,1,0
9,25,-16,0,1,1
25,19,6,1,1,0
-5,-1,-4,0,1,1
-33,-43,10,1,1,0
-10,-29,19,1,1,0
-53,-42,-11,0,1,1
-11,-24,13,1,1,0
-2,14,-16,0,0,0
-23,-39,16,1,0,1
-33,-14,-19,0,0,0
-7,-8,1,1,0,1
13,18,-5,0,0,0
9,25,-16,0,0,0
42,33,9,1,0,1
-41,-25,-16,0,0,0
-44,-43,-1,0,0,0
-41,-45,4,1,0,1
38,27,11,1,0,1
12,25,-13,0,0,0
17,13,4,1,0,1
27,34,-7,0,0,0
-29,-25,-4,0,0,0
-15,-14,-1,0,0,0
-42,-33,-9,0,0,0
-13,-8,-5,0,0,0
-10,-2,-8,0,0,0
-24,-18,-6,0,0,0
-47,-27,-20,0,1,1
30,40,-10,0,1,1
19,28,-9,0,1,1
48,32,16,1,1,0
-44,-31,-13,0,1,1
14,10,4,1,1,0
-37,-36,-1,0,1,1
-42,-25,-17,0,1,1
18,9,9,1,0,1
56,36,20,1,0,1
-7,-15,8,1,0,1
8,27,-19,0,0,0
-20,-12,-8,0,0,0
41,26,15,1,0,1
50,41,9,1,0,1
-20,-39,19,1,0,1
9,19,-10,0,0,0
-3,-8,5,1,0,1
43,35,8,1,1,0
63,43,20,1,1,0
35,24,11,1,1,0
-42,-25,-17,0,1,1
16,9,7,1,1,0
-37,-42,5,1,1,0
18,29,-11,0,1,1
-51,-33,-18,0,1,1
15,6,9,1,1,0
9,3,6,1,1,0
-8,-2,-6,0,1,1
-31,-38,7,1,0,1
39,35,4,1,0,1
1,19,-18,0,0,0
28,13,15,1,0,1
-13,-20,7,1,0,1
54,42,12,1,0,1
-16,1,-17,0,0,0
-15,-15,0,0,0,0
-23,-22,-1,0,1,1
-25,-32,7,1,1,0
-51,-34,-17,0,1,1
-4,-17,13,1,1,0
18,12,6,1,1,0
-18,-9,-9,0,1,1
-11,6,-17,0,1,1
-10,-17,7,1,1,0
-1,13,-14,0,1,1
10,12,-2,0,1,1
16,9,7,1,1,0
47,34,13,1,1,0
15,19,-4,0,1,1
42,34,8,1,1,0
-28,-43,15,1,1,0
41,41,0,0,1,1
1,14,-13,0,1,1
48,33,15,1,1,0
34,27,7,1,1,0
16,10,6,1,1,0
5,4,1,1,1,0
1,17,-16,0,0,0
-9,11,-20,0,0,0
-22,-11,-11,0,0,0
41,38,3,1,0,1
12,18,-6,0,0,0
36,41,-5,0,0,0
22,20,2,1,0,1
0,1,-1,0,0,0
-28,-10,-18,0,0,0
-25,-38,13,1,0,1
57,44,13,1,0,1
47,43,4,1,1,0
-6,-12,6,1,1,0
-53,-39,-14,0,1,1
27,34,-7,0,1,1
-25,-14,-11,0,1,1
-13,-16,3,1,1,0
30,21,9,1,1,0
-18,-31,13,1,1,0
-37,-22,-15,0,1,1
35,44,-9,0,0,0
-14,-32,18,1,0,1
0,2,-2,0,0,0
18,27,-9,0,0,0
44,27,17,1,0,1
14,3,11,1,0,1
-15,-27,12,1,0,1
-17,-3,-14,0,0,0
38,21,17,1,0,1
-44,-25,-19,0,0,0
-5,-6,1,1,0,1
-9,-25,16,1,0,1
-19,-25,6,1,0,1
6,3,3,1,0,1
25,28,-3,0,1,1
7,26,-19,0,1,1
-21,-11,-10,0,1,1
-20,-26,6,1,1,0
41,27,14,1,1,0
-19,-10,-9,0,1,1
-50,-31,-19,0,1,1
32,17,15,1,1,0
56,36,20,1,1,0
25,32,-7,0,0,0
-20,-19,-1,0,0,0
46,35,11,1,0,1
9,15,-6,0,0,0
28,25,3,1,0,1
-26,-36,10,1,0,1
18,19,-1,0,0,0
11,-5,16,1,0,1
23,10,13,1,0,1
-13,0,-13,0,0,0
-20,-26,6,1,0,1
-26,-45,19,1,0,1
23,32,-9,0,0,0
-5,7,-12,0,0,0
19,4,15,1,1,0
-4,-6,2,1,1,0
-36,-45,9,1,1,0
55,41,14,1,1,0
-22,-12,-10,0,1,1
-10,-23,13,1,1,0
48,31,17,1,1,0
11,12,-1,0,1,1
43,32,11,1,1,0
40,38,2,1,1,0
-5,-23,18,1,1,0
19,4,15,1,0,1
-22,-3,-19,0,0,0
33,22,11,1,0,1
-23,-20,-3,0,0,0
13,17,-4,0,0,0
10,13,-3,0,0,0
60,40,20,1,0,1
16,0,16,1,0,1
-20,-6,-14,0,0,0
20,21,-1,0,0,0
-7,2,-9,0,0,0
51,32,19,1,0,1
-39,-42,3,1,0,1
58,38,20,1,0,1
56,43,13,1,0,1
7,15,-8,0,0,0
-13,-28,15,1,0,1
29,9,20,1,0,1
49,36,13,1,0,1
-11,9,-20,0,1,1
5,-2,7,1,1,0
41,30,11,1,1,0
34,31,3,1,1,0
-15,1,-16,0,1,1
7,3,4,1,1,0
-39,-35,-4,0,1,1
-60,-40,-20,0,1,1
5,-9,14,1,1,0
18,11,7,1,1,0
-10,-13,3,1,1,0
-6,-10,4,1,1,0
-17,-1,-16,0,1,1
-50,-32,-18,0,1,1
-8,-6,-2,0,0,0
37,39,-2,0,0,0
-25,-5,-20,0,0,0
-52,-44,-8,0,0,0
15,11,4,1,0,1
2,6,-4,0,0,0
-47,-30,-17,0,0,0
27,43,-16,0,0,0
14,11,3,1,0,1
-44,-39,-5,0,0,0
50,43,7,1,0,1
54,40,14,1,0,1
40,44,-4,0,0,0
-3,-17,14,1,0,1
-27,-13,-14,0,0,0
-28,-11,-17,0,0,0
16,21,-5,0,1,1
-5,-11,6,1,1,0
-49,-44,-5,0,1,1
16,8,8,1,1,0
-11,9,-20,0,1,1
12,16,-4,0,1,1
-1,-9,8,1,1,0
-25,-5,-20,0,1,1
-29,-38,9,1,1,0
6,7,-1,0,1,1
-22,-9,-13,0,1,1
6,-9,15,1,0,1
11,26,-15,0,0,0
-26,-45,19,1,0,1
4,18,-14,0,0,0
53,41,12,1,0,1
-6,-11,5,1,0,1
40,40,0,0,0,0
-61,-44,-17,0,0,0
-10,6,-16,0,0,0
19,34,-15,0,0,0
12,1,11,1,0,1
7,23,-16,0,0,0
-52,-40,-12,0,0,0
8,8,0,0,1,1
-9,-6,-3,0,1,1
28,37,-9,0,1,1
-4,0,-4,0,1,1
-51,-41,-10,0,1,1
20,5,15,1,1,0
14,25,-11,0,1,1
-32,-40,8,1,1,0
-26,-15,-11,0,1,1
-60,-44,-16,0,1,1
23,29,-6,0,1,1
-34,-31,-3,0,1,1
-32,-12,-20,0,1,1
-7,-11,4,1,1,0
41,41,0,0,1,1
-8,-16,8,1,1,0
30,24,6,1,1,0
23,19,4,1,0,1
-19,-34,15,1,0,1
-27,-17,-10,0,0,0
-57,-42,-15,0,0,0
-13,-4,-9,0,0,0
-38,-22,-16,0,0,0
2,-13,15,1,0,1
-27,-17,-10,0,0,0
21,15,6,1,0,1
-48,-39,-9,0,0,0
-31,-27,-4,0,1,1
35,20,15,1,1,0
-31,-35,4,1,1,0
9,23,-14,0,1,1
36,35,1,1,1,0
21,28,-7,0,1,1
-44,-33,-11,0,1,1
-13,-33,20,1,1,0
22,30,-8,0,1,1
-18,1,-19,0,1,1
-35,-37,2,1,1,0
16,36,-20,0,1,1
-17,-14,-3,0,1,1
-34,-21,-13,0,1,1
20,15,5,1,1,0
-5,-6,1,1,1,0
-54,-36,-18,0,1,1
-18,-20,2,1,1,0
36,39,-3,0,1,1
26,12,14,1,1,0
-45,-41,-4,0,1,1
-9,0,-9,0,0,0
6,23,-17,0,0,0
13,7,6,1,0,1
5,-13,18,1,0,1
-46,-44,-2,0,0,0
62,43,19,1,0,1
-8,-10,2,1,0,1
23,33,-10,0,0,0
22,39,-17,0,0,0
-27,-25,-2,0,0,0
-5,7,-12,0,0,0
-42,-24,-18,0,0,0
-1,2,-3,0,0,0
-14,-10,-4,0,0,0
10,11,-1,0,0,0
0,16,-16,0,0,0
-6,-26,20,1,0,1
-27,-24,-3,0,0,0
-44,-28,-16,0,0,0
-40,-28,-12,0,0,0
-2,-9,7,1,0,1
-31,-12,-19,0,1,1
43,29,14,1,1,0
-6,2,-8,0,1,1
41,26,15,1,1,0
51,38,13,1,1,0
-39,-31,-8,0,1,1
22,42,-20,0,1,1
51,36,15,1,1,0
14,22,-8,0,1,1
49,38,11,1,1,0
8,14,-6,0,1,1
40,21,19,1,1,0
-7,0,-7,0,1,1
-16,-14,-2,0,0,0
-18,-4,-14,0,0,0
17,32,-15,0,0,0
46,33,13,1,0,1
38,20,18,1,0,1
-36,-30,-6,0,0,0
7,-6,13,1,0,1
-6,-26,20,1,0,1
-14,-32,18,1,0,1
43,34,9,1,0,1
-9,-12,3,1,0,1
-10,3,-13,0,0,0
-28,-14,-14,0,0,0
-61,-44,-17,0,0,0
-41,-42,1,1,0,1
55,35,20,1,0,1
28,34,-6,0,0,0
-33,-26,-7,0,0,0
-39,-38,-1,0,0,0
26,35,-9,0,0,0
-41,-21,-20,0,0,0
6,10,-4,0,1,1
-18,-17,-1,0,1,1
5,17,-12,0,1,1
21,8,13,1,1,0
-16,-14,-2,0,1,1
28,25,3,1,1,0
-14,1,-15,0,1,1
-1,-10,9,1,1,0
54,38,16,1,1,0
13,32,-19,0,1,1
-47,-37,-10,0,1,1
14,2,12,1,1,0
-21,-2,-19,0,0,0
20,11,9,1,0,1
-53,-36,-17,0,0,0
-10,-27,17,1,0,1
-36,-38,2,1,0,1
20,16,4,1,0,1
-37,-34,-3,0,0,0
-35,-40,5,1,0,1
-4,-20,16,1,0,1
10,6,4,1,0,1
-26,-16,-10,0,0,0
7,10,-3,0,0,0
-27,-22,-5,0,0,0
-14,-32,18,1,0,1
-1,-15,14,1,0,1
-49,-39,-10,0,0,0
12,-2,14,1,0,1
7,-11,18,1,1,0
9,1,8,1,1,0
19,10,9,1,1,0
-39,-24,-15,0,1,1
25,44,-19,0,1,1
-31,-28,-3,0,1,1
10,6,4,1,1,0
-33,-22,-11,0,1,1
53,38,15,1,1,0
3,-10,13,1,1,0
-45,-43,-2,0,1,1
-4,5,-9,0,1,1
43,34,9,1,1,0
-16,-5,-11,0,1,1
-21,-20,-1,0,1,1
34,28,6,1,1,0
23,17,6,1,1,0
-11,-4,-7,0,1,1
-27,-32,5,1,1,0
-5,4,-9,0,1,1
-17,-11,-6,0,1,1
4,-6,10,1,0,1
-31,-42,11,1,0,1
-13,-21,8,1,0,1
11,9,2,1,0,1
-26,-29,3,1,0,1
-9,-25,16,1,0,1
17,35,-18,0,0,0
23,39,-16,0,0,0
24,35,-11,0,0,0
-13,-5,-8,0,1,1
9,-11,20,1,1,0
14,2,12,1,1,0
18,30,-12,0,1,1
-42,-42,0,0,1,1
35,27,8,1,1,0
-15,-27,12,1,1,0
-26,-24,-2,0,1,1
41,41,0,0,1,1
-21,-2,-19,0,1,1
-12,-20,8,1,1,0
-2,-10,8,1,1,0
16,9,7,1,1,0
-14,5,-19,0,1,1
13,4,9,1,1,0
6,24,-18,0,1,1
1,6,-5,0,1,1
38,36,2,1,1,0
10,14,-4,0,1,1
10,29,-19,0,1,1
13,17,-4,0,1,1
17,26,-9,0,0,0
-23,-3,-20,0,0,0
20,23,-3,0,0,0
33,22,11,1,0,1
5,6,-1,0,0,0
-8,-6,-2,0,0,0
-17,-1,-16,0,0,0
-30,-32,2,1,0,1
38,40,-2,0,0,0
16,35,-19,0,0,0
-2,8,-10,0,0,0
-56,-39,-17,0,0,0
20,18,2,1,0,1
-55,-39,-16,0,0,0
21,29,-8,0,0,0
-39,-32,-7,0,0,0
42,35,7,1,1,0
15,14,1,1,1,0
33,27,6,1,1,0
24,20,4,1,1,0
-59,-44,-15,0,1,1
47,40,7,1,1,0
5,23,-18,0,1,1
22,12,10,1,1,0
-6,-12,6,1,1,0
36,36,0,0,1,1
-20,-8,-12,0,1,1
-25,-7,-18,0,1,1
58,41,17,1,1,0
-29,-9,-20,0,1,1
-6,14,-20,0,1,1
43,35,8,1,1,0
53,34,19,1,1,0
-10,-24,14,1,1,0
-31,-36,5,1,1,0
18,26,-8,0,1,1
-38,-34,-4,0,1,1
6,19,-13,0,0,0
22,30,-8,0,0,0
-30,-30,0,0,0,0
44,37,7,1,0,1
32,44,-12,0,0,0
29,26,3,1,0,1
15,-3,18,1,0,1
43,27,16,1,0,1
1,-18,19,1,0,1
58,41,17,1,0,1
4,-15,19,1,0,1
51,41,10,1,0,1
-10,-9,-1,0,0,0
-56,-36,-20,0,0,0
-2,-5,3,1,0,1
-30,-21,-9,0,0,0
-30,-13,-17,0,0,0
-8,-18,10,1,0,1
16,36,-20,0,0,0
-23,-25,2,1,0,1
23,28,-5,0,0,0
26,9,17,1,1,0
28,14,14,1,1,0
14,-1,15,1,1,0
35,37,-2,0,1,1
26,27,-1,0,1,1
25,14,11,1,1,0
-24,-7,-17,0,1,1
13,1,12,1,1,0
15,11,4,1,1,0
25,11,14,1,1,0
-20,-23,3,1,1,0
5,3,2,1,1,0
-1,15,-16,0,0,0
55,38,17,1,0,1
-37,-24,-13,0,0,0
50,34,16,1,0,1
-10,5,-15,0,0,0
19,23,-4,0,0,0
38,22,16,1,0,1
11,30,-19,0,0,0
-38,-44,6,1,0,1
-24,-42,18,1,0,1
47,37,10,1,0,1
3,11,-8,0,0,0
-2,4,-6,0,0,0
-59,-42,-17,0,0,0
42,30,12,1,0,1
36,21,15,1,0,1
1,-17,18,1,0,1
-31,-16,-15,0,0,0
-36,-35,-1,0,0,0
-15,-13,-2,0,0,0
21,24,-3,0,0,0
44,27,17,1,1,0
-49,-34,-15,0,1,1
-11,-24,13,1,1,0
-8,-19,11,1,1,0
-45,-43,-2,0,1,1
23,27,-4,0,1,1
49,32,17,1,1,0
32,29,3,1,1,0
27,12,15,1,1,0
-33,-18,-15,0,1,1
40,27,13,1,1,0
10,0,10,1,1,0
-11,-1,-10,0,0,0
50,37,13,1,0,1
-23,-35,12,1,0,1
1,16,-15,0,0,0
-10,-17,7,1,0,1
11,-8,19,1,0,1
-53,-44,-9,0,0,0
42,24,18,1,0,1
-12,0,-12,0,0,0
17,3,14,1,0,1
-24,-17,-7,0,0,0
-63,-44,-19,0,0,0
-36,-16,-20,0,0,0
17,1,16,1,0,1
-38,-32,-6,0,0,0
-47,-41,-6,0,0,0
11,0,11,1,0,1
24,4,20,1,0,1
3,-13,16,1,0,1
48,43,5,1,0,1
-9,5,-14,0,0,0
-37,-38,1,1,1,0
-42,-28,-14,0,1,1
9,-3,12,1,1,0
29,16,13,1,1,0
-20,0,-20,0,1,1
-8,-26,18,1,1,0
-44,-30,-14,0,1,1
36,19,17,1,1,0
-23,-36,13,1,0,1
-32,-31,-1,0,0,0
1,-17,18,1,0,1
-15,-23,8,1,0,1
32,30,2,1,0,1
-59,-43,-16,0,0,0
-61,-42,-19,0,0,0
-43,-41,-2,0,0,0
-40,-44,4,1,0,1
-51,-44,-7,0,0,0
-35,-19,-16,0,0,0
-34,-39,5,1,0,1
-4,-6,2,1,1,0
-32,-43,11,1,1,0
-17,-12,-5,0,1,1
-23,-13,-10,0,1,1
11,15,-4,0,1,1
-17,-16,-1,0,1,1
-22,-21,-1,0,1,1
10,29,-19,0,1,1
3,-15,18,1,1,0
43,27,16,1,1,0
-59,-39,-20,0,1,1
-2,0,-2,0,1,1
3,17,-14,0,1,1
46,34,12,1,1,0
32,32,0,0,0,0
50,34,16,1,0,1
36,27,9,1,0,1
-35,-22,-13,0,0,0
9,12,-3,0,0,0
32,21,11,1,0,1
8,-11,19,1,0,1
-15,-30,15,1,0,1
26,32,-6,0,0,0
-11,-14,3,1,0,1
-8,9,-17,0,0,0
-41,-43,2,1,0,1
-12,-11,-1,0,0,0
-51,-34,-17,0,1,1
1,-17,18,1,1,0
-8,-8,0,0,1,1
51,31,20,1,1,0
0,14,-14,0,1,1
-54,-41,-13,0,1,1
-47,-45,-2,0,1,1
-10,-5,-5,0,1,1
38,33,5,1,1,0
-15,-18,3,1,0,1
46,27,19,1,0,1
7,9,-2,0,0,0
-32,-21,-11,0,0,0
-48,-32,-16,0,0,0
-25,-26,1,1,0,1
36,31,5,1,0,1
24,10,14,1,0,1
-6,-10,4,1,0,1
-19,-25,6,1,0,1
-10,-15,5,1,0,1
-31,-33,2,1,0,1
-39,-20,-19,0,0,0
39,26,13,1,1,0
-5,-9,4,1,1,0
-17,0,-17,0,1,1
-31,-19,-12,0,1,1
29,38,-9,0,1,1
13,20,-7,0,1,1
15,28,-13,0,1,1
-54,-38,-16,0,1,1
0,6,-6,0,1,1
47,32,15,1,1,0
-51,-37,-14,0,1,1
3,15,-12,0,1,1
21,4,17,1,0,1
2,18,-16,0,0,0
42,32,10,1,0,1
-41,-32,-9,0,0,0
9,27,-18,0,0,0
-37,-33,-4,0,0,0
-60,-45,-15,0,0,0
55,40,15,1,0,1
27,40,-13,0,0,0
39,22,17,1,0,1
-15,-18,3,1,0,1
25,43,-18,0,0,0
17,-2,19,1,0,1
-34,-26,-8,0,0,0
30,16,14,1,0,1
43,26,17,1,0,1
13,26,-13,0,0,0
-57,-38,-19,0,0,0
16,8,8,1,0,1
14,24,-10,0,0,0
-10,-28,18,1,0,1
-52,-36,-16,0,1,1
16,7,9,1,1,0
4,-5,9,1,1,0
-22,-16,-6,0,1,1
-4,-24,20,1,1,0
-12,8,-20,0,1,1
-9,1,-10,0,1,1
-12,-30,18,1,1,0
-7,-25,18,1,1,0
-27,-7,-20,0,1,1
-30,-17,-13,0,1,1
-22,-27,5,1,1,0
-2,-13,11,1,1,0
-38,-20,-18,0,1,1
27,31,-4,0,0,0
11,17,-6,0,0,0
-23,-36,13,1,0,1
4,13,-9,0,0,0
17,6,11,1,0,1
-33,-24,-9,0,0,0
20,40,-20,0,0,0
-22,-19,-3,0,0,0
-10,0,-10,0,0,0
33,28,5,1,1,0
-29,-12,-17,0,1,1
-11,-9,-2,0,1,1
-8,8,-16,0,1,1
20,5,15,1,1,0
19,12,7,1,1,0
-47,-28,-19,0,1,1
-7,2,-9,0,1,1
-27,-30,3,1,0,1
-19,-39,20,1,0,1
-17,-36,19,1,0,1
35,22,13,1,0,1
5,15,-10,0,0,0
7,0,7,1,0,1
-45,-33,-12,0,0,0
-4,-3,-1,0,0,0
17,21,-4,0,0,0
1,15,-14,0,0,0
-14,-8,-6,0,0,0
32,24,8,1,0,1
9,13,-4,0,0,0
0,-16,16,1,0,1
-18,-9,-9,0,0,0
35,32,3,1,0,1
17,5,12,1,0,1
8,8,0,0,0,0
-24,-41,17,1,0,1
23,27,-4,0,0,0
-1,-15,14,1,0,1
42,23,19,1,1,0
26,26,0,0,1,1
39,24,15,1,1,0
8,21,-13,0,1,1
32,20,12,1,1,0
21,25,-4,0,1,1
-17,-24,7,1,1,0
23,31,-8,0,1,1
-25,-23,-2,0,1,1
12,32,-20,0,1,1
5,16,-11,0,1,1
-24,-16,-8,0,1,1
16,22,-6,0,0,0
-48,-32,-16,0,0,0
-15,-8,-7,0,0,0
-26,-23,-3,0,0,0
45,33,12,1,0,1
16,15,1,1,0,1
15,20,-5,0,0,0
-12,3,-15,0,0,0
-15,-8,-7,0,1,1
-15,-33,18,1,1,0
9,0,9,1,1,0
-19,-19,0,0,1,1
12,2,10,1,1,0
-19,-22,3,1,1,0
-45,-28,-17,0,1,1
31,12,19,1,1,0
-36,-23,-13,0,1,1
8,0,8,1,1,0
18,26,-8,0,1,1
-15,2,-17,0,1,1
49,29,20,1,1,0
-26,-41,15,1,1,0
25,28,-3,0,1,1
26,31,-5,0,1,1
17,13,4,1,1,0
19,3,16,1,1,0
-53,-36,-17,0,1,1
53,43,10,1,1,0
1,6,-5,0,1,1
-1,19,-20,0,0,0
-15,-28,13,1,0,1
-13,-5,-8,0,0,0
-5,9,-14,0,0,0
-48,-45,-3,0,0,0
-18,-34,16,1,0,1
3,19,-16,0,0,0
-17,1,-18,0,0,0
-9,-3,-6,0,0,0
-21,-17,-4,0,0,0
-29,-41,12,1,1,0
-24,-26,2,1,1,0
30,43,-13,0,1,1
18,22,-4,0,1,1
-36,-24,-12,0,1,1
-23,-37,14,1,1,0
41,39,2,1,1,0
-25,-27,2,1,1,0
-11,-26,15,1,1,0
-8,10,-18,0,1,1
1,12,-11,0,1,1
34,34,0,0,1,1
-5,15,-20,0,1,1
20,0,20,1,1,0
30,21,9,1,1,0
-24,-19,-5,0,1,1
42,34,8,1,1,0
18,37,-19,0,1,1
40,28,12,1,1,0
-49,-30,-19,0,1,1
-57,-37,-20,0,1,1
-14,4,-18,0,0,0
-27,-33,6,1,0,1
-9,-18,9,1,0,1
38,19,19,1,0,1
-25,-11,-14,0,0,0
-7,4,-11,0,0,0
50,40,10,1,0,1
-3,-16,13,1,0,1
-22,-24,2,1,0,1
-24,-26,2,1,0,1
9,14,-5,0,0,0
0,-11,11,1,0,1
-1,-4,3,1,0,1
-33,-13,-20,0,0,0
29,10,19,1,0,1
12,28,-16,0,0,0
0,-7,7,1,0,1
48,38,10,1,0,1
46,26,20,1,0,1
-53,-34,-19,0,0,0
-29,-13,-16,0,0,0
-12,-10,-2,0,1,1
18,9,9,1,1,0
-10,10,-20,0,1,1
-58,-44,-14,0,1,1
41,33,8,1,1,0
-54,-40,-14,0,1,1
-28,-14,-14,0,1,1
-15,-31,16,1,1,0
-42,-25,-17,0,1,1
9,-1,10,1,1,0
43,23,20,1,1,0
-22,-27,5,1,1,0
-3,5,-8,0,1,1
-26,-41,15,1,1,0
-5,-21,16,1,0,1
-18,-31,13,1,0,1
-9,-27,18,1,0,1
-24,-27,3,1,0,1
-12,-8,-4,0,0,0
25,41,-16,0,0,0
41,25,16,1,0,1
36,34,2,1,0,1
10,25,-15,0,0,0
-13,-21,8,1,0,1
-4,5,-9,0,0,0
20,7,13,1,0,1
3,-4,7,1,0,1
-18,-2,-16,0,0,0
31,17,14,1,1,0
-16,-34,18,1,1,0
11,11,0,0,1,1
-2,13,-15,0,1,1
32,41,-9,0,1,1
-37,-43,6,1,1,0
-38,-31,-7,0,1,1
13,12,1,1,1,0
-34,-14,-20,0,1,1
-34,-30,-4,0,1,1
-3,9,-12,0,1,1
55,39,16,1,1,0
-8,-16,8,1,1,0
18,29,-11,0,1,1
-23,-24,1,1,1,0
10,6,4,1,1,0
-21,-21,0,0,1,1
47,40,7,1,1,0
-15,3,-18,0,1,1
33,14,19,1,1,0
21,17,4,1,1,0
54,43,11,1,0,1
31,39,-8,0,0,0
-59,-43,-16,0,0,0
-8,1,-9,0,0,0
-2,2,-4,0,0,0
-26,-32,6,1,0,1
13,6,7,1,0,1
-35,-16,-19,0,0,0
3,15,-12,0,0,0
-41,-28,-13,0,0,0
23,23,0,0,0,0
8,5,3,1,1,0
14,16,-2,0,1,1
-19,-38,19,1,1,0
-33,-24,-9,0,1,1
-17,-23,6,1,1,0
-25,-16,-9,0,1,1
-37,-19,-18,0,1,1
25,40,-15,0,1,1
-10,-24,14,1,1,0
34,28,6,1,1,0
24,40,-16,0,1,1
-58,-43,-15,0,1,1
19,2,17,1,1,0
37,20,17,1,1,0
-18,-19,1,1,1,0
3,-1,4,1,1,0
-14,-33,19,1,1,0
-25,-11,-14,0,1,1
60,42,18,1,1,0
-31,-18,-13,0,1,1
31,18,13,1,1,0
10,25,-15,0,0,0
16,6,10,1,0,1
32,41,-9,0,0,0
23,31,-8,0,0,0
-32,-20,-12,0,0,0
-16,-22,6,1,0,1
-19,-20,1,1,0,1
17,28,-11,0,0,0
-23,-21,-2,0,0,0
-26,-20,-6,0,0,0
-16,-1,-15,0,1,1
-30,-41,11,1,1,0
9,-2,11,1,1,0
15,6,9,1,1,0
-7,10,-17,0,1,1
-2,3,-5,0,1,1
47,36,11,1,1,0
25,34,-9,0,1,1
-30,-30,0,0,1,1
-7,-17,10,1,1,0
-22,-39,17,1,1,0
-47,-38,-9,0,0,0
3,18,-15,0,0,0
32,20,12,1,0,1
24,23,1,1,0,1
-21,-3,-18,0,0,0
-40,-45,5,1,0,1
43,28,15,1,0,1
-35,-18,-17,0,0,0
10,24,-14,0,0,0
19,18,1,1,0,1
2,-17,19,1,0,1
33,31,2,1,0,1
-13,3,-16,0,0,0
20,1,19,1,0,1
-52,-33,-19,0,0,0
-29,-29,0,0,0,0
20,22,-2,0,0,0
39,26,13,1,0,1
-47,-44,-3,0,0,0
-4,6,-10,0,0,0
-18,-3,-15,0,0,0
20,39,-19,0,1,1
-34,-33,-1,0,1,1
-23,-42,19,1,1,0
-31,-39,8,1,1,0
-35,-37,2,1,1,0
1,-10,11,1,1,0
-15,0,-15,0,1,1
43,42,1,1,1,0
15,25,-10,0,1,1
60,44,16,1,1,0
-34,-17,-17,0,1,1
-19,-37,18,1,1,0
33,26,7,1,1,0
23,29,-6,0,1,1
-32,-39,7,1,1,0
-32,-33,1,1,1,0
-32,-40,8,1,1,0
37,34,3,1,1,0
-20,-4,-16,0,1,1
-34,-24,-10,0,1,1
-31,-17,-14,0,1,1
34,42,-8,0,0,0
-12,-15,3,1,0,1
-1,9,-10,0,0,0
24,8,16,1,0,1
-18,-10,-8,0,0,0
-30,-31,1,1,0,1
-5,8,-13,0,0,0
22,5,17,1,0,1
49,32,17,1,0,1
-14,1,-15,0,0,0
-28,-15,-13,0,0,0
34,21,13,1,0,1
-36,-41,5,1,0,1
13,-7,20,1,0,1
-53,-33,-20,0,0,0
15,33,-18,0,0,0
5,24,-19,0,0,0
32,33,-1,0,0,0
22,10,12,1,0,1
-3,-6,3,1,0,1
-1,1,-2,0,0,0
-30,-19,-11,0,1,1
18,9,9,1,1,0
-25,-14,-11,0,1,1
21,41,-20,0,1,1
16,-1,17,1,1,0
43,38,5,1,1,0
48,30,18,1,1,0
55,40,15,1,1,0
-15,3,-18,0,1,1
5,13,-8,0,1,1
-44,-35,-9,0,1,1
-38,-39,1,1,1,0
25,41,-16,0,1,1
-8,11,-19,0,1,1
19,16,3,1,1,0
10,16,-6,0,1,1
-17,-14,-3,0,1,1
29,23,6,1,1,0
-37,-37,0,0,1,1
0,-12,12,1,1,0
14,11,3,1,1,0
-29,-19,-10,0,0,0
22,6,16,1,0,1
1,-4,5,1,0,1
8,22,-14,0,0,0
13,27,-14,0,0,0
-51,-34,-17,0,0,0
-44,-43,-1,0,0,0
10,10,0,0,0,0
-31,-42,11,1,0,1
-9,-11,2,1,0,1
31,18,13,1,0,1
19,2,17,1,0,1
30,26,4,1,0,1
-28,-18,-10,0,0,0
23,5,18,1,0,1
13,1,12,1,0,1
-56,-36,-20,0,0,0
-19,-17,-2,0,0,0
-18,-27,9,1,0,1
-16,-16,0,0,1,1
-28,-44,16,1,1,0
8,22,-14,0,1,1
2,-9,11,1,1,0
15,5,10,1,1,0
-27,-43,16,1,1,0
-53,-37,-16,0,1,1
-63,-43,-20,0,1,1
-7,10,-17,0,1,1
15,4,11,1,1,0
-19,-35,16,1,1,0
27,30,-3,0,1,1
-26,-9,-17,0,1,1
21,4,17,1,1,0
-33,-25,-8,0,1,1
18,22,-4,0,1,1
-14,-27,13,1,1,0
-20,-13,-7,0,1,1
16,31,-15,0,1,1
42,36,6,1,1,0
-16,-32,16,1,1,0
-12,2,-14,0,0,0
-25,-38,13,1,0,1
-15,-19,4,1,0,1
-19,-26,7,1,0,1
2,4,-2,0,0,0
16,20,-4,0,0,0
-20,-13,-7,0,0,0
-55,-44,-11,0,0,0
17,36,-19,0,0,0
19,5,14,1,0,1
-8,6,-14,0,0,0
-55,-40,-15,0,0,0
-6,-9,3,1,0,1
1,9,-8,0,0,0
29,35,-6,0,0,0
12,25,-13,0,0,0
-22,-27,5,1,0,1
-30,-11,-19,0,0,0
-17,-35,18,1,0,1
23,38,-15,0,0,0
-42,-45,3,1,0,1
-21,-17,-4,0,1,1
-5,-7,2,1,1,0
-42,-23,-19,0,1,1
10,24,-14,0,1,1
-28,-23,-5,0,1,1
-8,-28,20,1,1,0
16,29,-13,0,1,1
-3,-11,8,1,1,0
5,14,-9,0,1,1
-12,-4,-8,0,1,1
26,13,13,1,1,0
18,5,13,1,1,0
8,11,-3,0,1,1
22,23,-1,0,1,1
20,17,3,1,1,0
-10,-30,20,1,0,1
-5,-6,1,1,0,1
36,25,11,1,0,1
37,35,2,1,0,1
40,27,13,1,0,1
5,0,5,1,0,1
-8,-23,15,1,0,1
-56,-43,-13,0,0,0
28,42,-14,0,0,0
12,6,6,1,0,1
-45,-25,-20,0,0,0
9,27,-18,0,0,0
0,11,-11,0,0,0
-27,-34,7,1,0,1
14,14,0,0,0,0
-48,-44,-4,0,0,0
33,22,11,1,0,1
53,42,11,1,0,1
37,27,10,1,0,1
-32,-25,-7,0,0,0
29,21,8,1,1,0
-14,6,-20,0,1,1
-13,-18,5,1,1,0
-7,-19,12,1,1,0
-17,-3,-14,0,1,1
-27,-15,-12,0,1,1
-8,-14,6,1,1,0
8,-8,16,1,1,0
16,14,2,1,1,0
-16,-12,-4,0,1,1
-61,-44,-17,0,1,1
27,12,15,1,1,0
7,24,-17,0,1,1
-24,-32,8,1,1,0
-9,-25,16,1,1,0
7,2,5,1,1,0
32,32,0,0,1,1
13,23,-10,0,1,1
18,5,13,1,1,0
26,26,0,0,1,1
-12,-25,13,1,1,0
13,-1,14,1,0,1
23,16,7,1,0,1
8,16,-8,0,0,0
-57,-43,-14,0,0,0
-7,-14,7,1,0,1
6,-4,10,1,0,1
16,16,0,0,0,0
2,-3,5,1,0,1
30,43,-13,0,0,0
-40,-45,5,1,0,1
0,0,0,0,0,0
-3,6,-9,0,0,0
-48,-32,-16,0,0,0
-22,-27,5,1,0,1
10,-10,20,1,0,1
20,13,7,1,0,1
2,-16,18,1,0,1
-21,-30,9,1,0,1
-10,9,-19,0,0,0
18,-1,19,1,0,1
-37,-45,8,1,0,1
1,-16,17,1,1,0
11,14,-3,0,1,1
39,40,-1,0,1,1
54,42,12,1,1,0
-21,-32,11,1,1,0
17,5,12,1,1,0
47,43,4,1,1,0
25,42,-17,0,1,1
-40,-33,-7,0,1,1
-36,-25,-11,0,1,1
-29,-15,-14,0,1,1
11,9,2,1,1,0
26,24,2,1,0,1
-31,-32,1,1,0,1
24,35,-11,0,0,0
-57,-41,-16,0,0,0
0,-15,15,1,0,1
-12,-31,19,1,0,1
49,39,10,1,0,1
23,37,-14,0,0,0
-17,-21,4,1,0,1
-32,-12,-20,0,0,0
23,43,-20,0,0,0
12,9,3,1,0,1
-19,-26,7,1,0,1
-22,-5,-17,0,0,0
18,36,-18,0,0,0
-15,5,-20,0,0,0
1,-14,15,1,0,1
-10,-21,11,1,0,1
33,21,12,1,0,1
-36,-23,-13,0,0,0
29,20,9,1,0,1
21,10,11,1,1,0
-26,-11,-15,0,1,1
38,23,15,1,1,0
-7,-4,-3,0,1,1
12,18,-6,0,1,1
-16,-1,-15,0,1,1
-25,-40,15,1,1,0
-7,-17,10,1,1,0
-37,-37,0,0,1,1
-17,-2,-15,0,1,1
41,42,-1,0,1,1
6,22,-16,0,1,1
-19,-3,-16,0,1,1
8,-3,11,1,1,0
62,42,20,1,1,0
2,-11,13,1,1,0
-25,-11,-14,0,1,1
28,15,13,1,1,0
-5,-5,0,0,0,0
32,40,-8,0,0,0
-10,-22,12,1,0,1
-12,-15,3,1,0,1
13,6,7,1,0,1
-18,-23,5,1,0,1
-27,-15,-12,0,0,0
-23,-20,-3,0,0,0
-16,-35,19,1,0,1
-13,-1,-12,0,0,0
-13,-2,-11,0,0,0
-27,-32,5,1,0,1
19,30,-11,0,0,0
11,30,-19,0,0,0
49,32,17,1,0,1
12,8,4,1,0,1
-8,3,-11,0,0,0
41,39,2,1,1,0
5,-3,8,1,1,0
25,34,-9,0,1,1
-27,-41,14,1,1,0
57,42,15,1,1,0
29,11,18,1,1,0
54,36,18,1,1,0
25,40,-15,0,1,1
17,16,1,1,1,0
0,-12,12,1,1,0
-9,-3,-6,0,1,1
-33,-26,-7,0,1,1
-6,-24,18,1,1,0
-47,-43,-4,0,1,1
2,11,-9,0,1,1
-15,-30,15,1,1,0
-15,0,-15,0,1,1
32,44,-12,0,1,1
-27,-32,5,1,1,0
-1,-17,16,1,1,0
33,36,-3,0,1,1
18,20,-2,0,0,0
16,16,0,0,0,0
-34,-43,9,1,0,1
4,-10,14,1,0,1
47,44,3,1,0,1
4,5,-1,0,0,0
30,28,2,1,0,1
47,29,18,1,0,1
25,39,-14,0,0,0
-11,-11,0,0,0,0
23,35,-12,0,0,0
-34,-30,-4,0,0,0
-14,-15,1,1,0,1
37,19,18,1,0,1
25,36,-11,0,1,1
-21,-17,-4,0,1,1
-29,-17,-12,0,1,1
-34,-45,11,1,1,0
-42,-42,0,0,1,1
38,29,9,1,1,0
52,36,16,1,1,0
33,34,-1,0,1,1
-23,-38,15,1,0,1
1,-5,6,1,0,1
28,32,-4,0,0,0
17,13,4,1,0,1
-60,-44,-16,0,0,0
-41,-24,-17,0,0,0
-8,-7,-1,0,0,0
36,20,16,1,0,1
-41,-25,-16,0,0,0
5,24,-19,0,0,0
35,28,7,1,0,1
-32,-27,-5,0,0,0
-15,-5,-10,0,1,1
9,19,-10,0,1,1
7,-6,13,1,1,0
-27,-23,-4,0,1,1
10,-10,20,1,1,0
-3,-16,13,1,1,0
-9,-4,-5,0,1,1
43,32,11,1,1,0
-7,7,-14,0,1,1
34,29,5,1,1,0
-6,-3,-3,0,1,1
17,11,6,1,1,0
-8,-23,15,1,1,0
-47,-43,-4,0,1,1
24,25,-1,0,1,1
-32,-13,-19,0,1,1
35,42,-7,0,1,1
-28,-38,10,1,1,0
-50,-31,-19,0,1,1
30,13,17,1,1,0
-54,-41,-13,0,1,1
10,14,-4,0,0,0
19,16,3,1,0,1
51,36,15,1,0,1
24,34,-10,0,0,0
28,38,-10,0,0,0
17,7,10,1,0,1
26,33,-7,0,0,0
35,30,5,1,0,1
-36,-20,-16,0,0,0
-62,-42,-20,0,0,0
-44,-39,-5,0,1,1
3,1,2,1,1,0
18,25,-7,0,1,1
30,41,-11,0,1,1
-31,-33,2,1,1,0
9,11,-2,0,1,1
-39,-33,-6,0,1,1
0,3,-3,0,1,1
-2,-19,17,1,0,1
3,15,-12,0,0,0
11,13,-2,0,0,0
-40,-36,-4,0,0,0
-3,2,-5,0,0,0
-10,-25,15,1,0,1
-35,-19,-16,0,0,0
38,39,-1,0,0,0
-51,-39,-12,0,0,0
-9,-16,7,1,0,1
-38,-41,3,1,0,1
-16,-25,9,1,0,1
15,-1,16,1,0,1
-31,-39,8,1,0,1
-35,-27,-8,0,1,1
41,21,20,1,1,0
-23,-36,13,1,1,0
-41,-21,-20,0,1,1
-31,-38,7,1,1,0
-17,-14,-3,0,1,1
-24,-17,-7,0,1,1
25,35,-10,0,1,1
-23,-23,0,0,1,1
-23,-39,16,1,1,0
-6,-4,-2,0,1,1
-6,-7,1,1,1,0
6,8,-2,0,1,1
-10,-12,2,1,1,0
27,12,15,1,1,0
17,20,-3,0,1,1
-46,-27,-19,0,1,1
-14,-12,-2,0,1,1
-25,-32,7,1,1,0
-33,-32,-1,0,1,1
-2,-12,10,1,1,0
-52,-44,-8,0,0,0
40,24,16,1,0,1
4,2,2,1,0,1
-9,-15,6,1,0,1
31,37,-6,0,0,0
35,37,-2,0,0,0
21,7,14,1,0,1
7,16,-9,0,0,0
-24,-40,16,1,0,1
-5,-13,8,1,0,1
5,0,5,1,0,1
-54,-42,-12,0,0,0
-9,10,-19,0,0,0
-8,6,-14,0,0,0
-2,-12,10,1,0,1
-1,-1,0,0,1,1
-19,-13,-6,0,1,1
18,31,-13,0,1,1
-46,-36,-10,0,1,1
1,-19,20,1,1,0
30,13,17,1,1,0
-7,-2,-5,0,1,1
-36,-28,-8,0,1,1
-18,-1,-17,0,1,1
10,10,0,0,1,1
-6,-7,1,1,1,0
7,-12,19,1,0,1
-14,-9,-5,0,0,0
7,15,-8,0,0,0
-21,-8,-13,0,0,0
-9,-15,6,1,0,1
2,-6,8,1,0,1
31,29,2,1,0,1
-30,-22,-8,0,0,0
25,22,3,1,0,1
-61,-43,-18,0,0,0
-25,-21,-4,0,0,0
42,32,10,1,0,1
48,30,18,1,0,1
14,6,8,1,0,1
39,43,-4,0,0,0
-20,-35,15,1,0,1
35,16,19,1,0,1
-48,-37,-11,0,0,0
-33,-30,-3,0,0,0
-9,-10,1,1,0,1
0,19,-19,0,0,0
-7,-27,20,1,1,0
30,11,19,1,1,0
16,10,6,1,1,0
-15,-21,6,1,1,0
8,6,2,1,1,0
13,1,12,1,1,0
33,27,6,1,1,0
24,19,5,1,1,0
-21,-39,18,1,1,0
-29,-21,-8,0,1,1
-30,-35,5,1,1,0
28,15,13,1,1,0
36,25,11,1,1,0
21,6,15,1,1,0
-11,-24,13,1,1,0
-25,-30,5,1,0,1
0,-12,12,1,0,1
38,29,9,1,0,1
18,6,12,1,0,1
20,27,-7,0,0,0
7,14,-7,0,0,0
11,16,-5,0,0,0
-49,-32,-17,0,0,0
33,13,20,1,0,1
-63,-43,-20,0,0,0
25,36,-11,0,0,0
0,-20,20,1,0,1
19,24,-5,0,0,0
6,23,-17,0,0,0
-4,-22,18,1,0,1
11,5,6,1,0,1
21,16,5,1,1,0
28,43,-15,0,1,1
29,34,-5,0,1,1
32,19,13,1,1,0
31,13,18,1,1,0
-4,8,-12,0,1,1
9,12,-3,0,1,1
30,30,0,0,1,1
19,22,-3,0,1,1
7,-7,14,1,1,0
-33,-35,2,1,0,1
14,30,-16,0,0,0
40,26,14,1,0,1
13,27,-14,0,0,0
-25,-27,2,1,0,1
1,0,1,1,0,1
-39,-22,-17,0,0,0
20,18,2,1,0,1
-21,-15,-6,0,0,0
20,35,-15,0,0,0
41,31,10,1,0,1
16,22,-6,0,0,0
-30,-17,-13,0,0,0
-42,-22,-20,0,0,0
42,22,20,1,0,1
9,11,-2,0,0,0
30,44,-14,0,0,0
10,23,-13,0,0,0
3,-7,10,1,0,1
30,31,-1,0,0,0
18,20,-2,0,0,0
-18,-35,17,1,1,0
9,-5,14,1,1,0
-22,-36,14,1,1,0
-18,-5,-13,0,1,1
3,19,-16,0,1,1
-2,-10,8,1,1,0
10,-2,12,1,1,0
-35,-22,-13,0,1,1
25,43,-18,0,0,0
42,36,6,1,0,1
25,34,-9,0,0,0
28,23,5,1,0,1
-26,-23,-3,0,0,0
23,19,4,1,0,1
-52,-42,-10,0,0,0
31,17,14,1,0,1
-6,9,-15,0,0,0
42,26,16,1,0,1
27,38,-11,0,0,0
27,13,14,1,0,1
-9,-26,17,1,1,0
-40,-22,-18,0,1,1
-27,-13,-14,0,1,1
45,35,10,1,1,0
-25,-11,-14,0,1,1
13,25,-12,0,1,1
-7,-8,1,1,1,0
-31,-19,-12,0,1,1
4,-8,12,1,1,0
-4,-7,3,1,1,0
10,16,-6,0,1,1
31,42,-11,0,0,0
7,7,0,0,0,0
-33,-29,-4,0,0,0
-28,-42,14,1,0,1
5,9,-4,0,0,0
-13,-6,-7,0,0,0
-40,-32,-8,0,0,0
48,42,6,1,0,1
29,34,-5,0,0,0
-2,8,-10,0,1,1
45,26,19,1,1,0
20,20,0,0,1,1
-28,-44,16,1,1,0
5,-14,19,1,1,0
-30,-41,11,1,1,0
-14,-24,10,1,1,0
0,-8,8,1,1,0
-42,-43,1,1,0,1
13,33,-20,0,0,0
29,41,-12,0,0,0
17,15,2,1,0,1
51,38,13,1,0,1
13,22,-9,0,0,0
-26,-10,-16,0,0,0
43,30,13,1,0,1
-13,-9,-4,0,0,0
20,3,17,1,1,0
-41,-26,-15,0,1,1
-25,-31,6,1,1,0
-30,-34,4,1,1,0
33,44,-11,0,1,1
10,28,-18,0,1,1
-45,-39,-6,0,1,1
-44,-42,-2,0,1,1
-23,-33,10,1,1,0
3,13,-10,0,1,1
-31,-33,2,1,1,0
-46,-43,-3,0,1,1
30,27,3,1,1,0
-23,-30,7,1,1,0
35,34,1,1,1,0
-53,-34,-19,0,1,1
-16,1,-17,0,0,0
-33,-42,9,1,0,1
7,7,0,0,0,0
15,-4,19,1,0,1
-8,-22,14,1,0,1
0,6,-6,0,0,0
19,1,18,1,0,1
20,38,-18,0,0,0
-34,-30,-4,0,0,0
6,5,1,1,1,0
53,37,16,1,1,0
-33,-22,-11,0,1,1
21,11,10,1,1,0
5,7,-2,0,1,1
-10,5,-15,0,1,1
9,16,-7,0,1,1
50,41,9,1,1,0
39,30,9,1,1,0
44,29,15,1,0,1
-47,-34,-13,0,0,0
9,15,-6,0,0,0
-10,-22,12,1,0,1
9,14,-5,0,0,0
-22,-23,1,1,0,1
-14,0,-14,0,0,0
39,23,16,1,0,1
-53,-35,-18,0,0,0
-41,-41,0,0,0,0
-41,-32,-9,0,0,0
-1,-5,4,1,0,1
-42,-41,-1,0,0,0
27,25,2,1,0,1
40,37,3,1,0,1
-27,-37,10,1,0,1
-56,-44,-12,0,0,0
-50,-43,-7,0,0,0
-18,-8,-10,0,0,0
-2,-5,3,1,0,1
13,-7,20,1,0,1
9,21,-12,0,1,1
-20,-23,3,1,1,0
45,43,2,1,1,0
-57,-40,-17,0,1,1
8,8,0,0,1,1
25,18,7,1,1,0
8,23,-15,0,1,1
40,26,14,1,1,0
-37,-37,0,0,1,1
-29,-30,1,1,1,0
14,30,-16,0,1,1
8,9,-1,0,1,1
33,38,-5,0,1,1
-52,-41,-11,0,0,0
-22,-4,-18,0,0,0
-40,-43,3,1,0,1
2,-11,13,1,0,1
-4,5,-9,0,0,0
-25,-5,-20,0,0,0
31,12,19,1,0,1
-11,-15,4,1,0,1
13,3,10,1,0,1
-10,-11,1,1,0,1
-32,-43,11,1,0,1
-13,2,-15,0,0,0
35,33,2,1,0,1
-6,13,-19,0,1,1
23,33,-10,0,1,1
14,22,-8,0,1,1
8,1,7,1,1,0
-12,-20,8,1,1,0
-33,-35,2,1,1,0
-58,-45,-13,0,1,1
-26,-45,19,1,1,0
-45,-34,-11,0,0,0
-11,-8,-3,0,0,0
-45,-29,-16,0,0,0
23,13,10,1,0,1
9,20,-11,0,0,0
-36,-36,0,0,0,0
15,27,-12,0,0,0
35,32,3,1,0,1
23,42,-19,0,0,0
22,9,13,1,0,1
51,31,20,1,0,1
29,12,17,1,0,1
21,39,-18,0,0,0
-1,7,-8,0,1,1
31,24,7,1,1,0
-9,9,-18,0,1,1
-58,-43,-15,0,1,1
22,10,12,1,1,0
4,-11,15,1,1,0
21,24,-3,0,1,1
6,20,-14,0,1,1
-19,-32,13,1,1,0
-12,-4,-8,0,1,1
-53,-44,-9,0,0,0
-4,-13,9,1,0,1
-54,-39,-15,0,0,0
33,29,4,1,0,1
-38,-45,7,1,0,1
55,36,19,1,0,1
-2,5,-7,0,0,0
-43,-37,-6,0,0,0
-11,0,-11,0,0,0
-24,-36,12,1,0,1
24,15,9,1,0,1
37,19,18,1,0,1
9,5,4,1,0,1
17,11,6,1,0,1
-25,-41,16,1,0,1
-47,-31,-16,0,0,0
-7,11,-18,0,0,0
-4,-8,4,1,0,1
10,9,1,1,0,1
13,25,-12,0,0,0
-34,-31,-3,0,0,0
17,1,16,1,1,0
-9,-11,2,1,1,0
-4,-24,20,1,1,0
37,43,-6,0,1,1
-15,5,-20,0,1,1
-39,-32,-7,0,1,1
-19,-26,7,1,1,0
6,10,-4,0,1,1
14,13,1,1,1,0
37,26,11,1,1,0
8,27,-19,0,1,1
13,26,-13,0,1,1
43,25,18,1,1,0
15,13,2,1,1,0
-17,-32,15,1,1,0
-17,-34,17,1,1,0
-52,-39,-13,0,0,0
-30,-12,-18,0,0,0
12,24,-12,0,0,0
-13,-3,-10,0,0,0
-58,-38,-20,0,0,0
-41,-30,-11,0,0,0
-17,-34,17,1,0,1
-28,-24,-4,0,0,0
51,40,11,1,0,1
-30,-29,-1,0,0,0
-12,-6,-6,0,0,0
18,37,-19,0,0,0
37,32,5,1,0,1
-24,-22,-2,0,0,0
-38,-42,4,1,0,1
2,-11,13,1,0,1
-1,6,-7,0,0,0
-34,-39,5,1,0,1
30,25,5,1,0,1
-17,-29,12,1,0,1
20,38,-18,0,0,0
30,10,20,1,1,0
-32,-22,-10,0,1,1
-52,-34,-18,0,1,1
18,19,-1,0,1,1
14,16,-2,0,1,1
-14,-17,3,1,1,0
-22,-36,14,1,1,0
25,6,19,1,1,0
-33,-21,-12,0,0,0
-30,-38,8,1,0,1
6,-1,7,1,0,1
23,7,16,1,0,1
-46,-40,-6,0,0,0
-57,-44,-13,0,0,0
5,20,-15,0,0,0
-20,-26,6,1,0,1
35,36,-1,0,1,1
15,28,-13,0,1,1
50,31,19,1,1,0
22,7,15,1,1,0
-38,-26,-12,0,1,1
43,37,6,1,1,0
14,25,-11,0,1,1
-14,0,-14,0,1,1
18,34,-16,0,1,1
-11,-31,20,1,1,0
27,13,14,1,1,0
18,1,17,1,0,1
50,34,16,1,0,1
-16,-3,-13,0,0,0
0,-2,2,1,0,1
12,28,-16,0,0,0
-59,-44,-15,0,0,0
-14,-20,6,1,0,1
14,9,5,1,0,1
52,35,17,1,0,1
15,5,10,1,0,1
14,17,-3,0,0,0
-20,-40,20,1,0,1
-22,-38,16,1,0,1
-17,-27,10,1,0,1
-43,-35,-8,0,0,0
37,38,-1,0,0,0
-64,-44,-20,0,0,0
-3,-13,10,1,0,1
-29,-20,-9,0,0,0
41,41,0,0,0,0
-34,-21,-13,0,0,0
5,24,-19,0,1,1
-33,-43,10,1,1,0
-27,-39,12,1,1,0
2,7,-5,0,1,1
-13,-2,-11,0,1,1
41,35,6,1,1,0
33,32,1,1,1,0
-13,-18,5,1,1,0
8,7,1,1,1,0
9,9,0,0,1,1
-35,-45,10,1,1,0
-23,-14,-9,0,1,1
-3,17,-20,0,1,1
-8,0,-8,0,1,1
-36,-32,-4,0,1,1
31,33,-2,0,1,1
-36,-29,-7,0,1,1
22,9,13,1,1,0
-21,-1,-20,0,1,1
8,-7,15,1,1,0
-56,-42,-14,0,0,0
22,25,-3,0,0,0
-44,-29,-15,0,0,0
41,30,11,1,0,1
53,43,10,1,0,1
7,-3,10,1,0,1
22,27,-5,0,0,0
2,14,-12,0,0,0
-57,-37,-20,0,0,0
-10,-6,-4,0,0,0
39,27,12,1,0,1
-11,-12,1,1,1,0
32,42,-10,0,1,1
8,7,1,1,1,0
-11,-13,2,1,1,0
-33,-27,-6,0,1,1
-43,-26,-17,0,1,1
-11,-5,-6,0,1,1
-29,-41,12,1,1,0
-10,-29,19,1,0,1
8,-12,20,1,0,1
24,38,-14,0,0,0
-39,-43,4,1,0,1
-30,-23,-7,0,0,0
46,27,19,1,0,1
-21,-25,4,1,0,1
-23,-35,12,1,0,1
1,-7,8,1,0,1
55,43,12,1,0,1
-6,-3,-3,0,0,0
-27,-18,-9,0,0,0
-49,-31,-18,0,0,0
35,34,1,1,0,1
21,19,2,1,0,1
3,3,0,0,0,0
-29,-15,-14,0,0,0
39,22,17,1,0,1
-16,-36,20,1,0,1
10,-4,14,1,0,1
-19,-27,8,1,0,1
14,5,9,1,1,0
29,13,16,1,1,0
-58,-43,-15,0,1,1
-34,-33,-1,0,1,1
-36,-35,-1,0,1,1
0,-16,16,1,1,0
22,26,-4,0,1,1
-56,-45,-11,0,1,1
51,41,10,1,1,0
-46,-38,-8,0,1,1
-45,-35,-10,0,1,1
-26,-37,11,1,1,0
-26,-30,4,1,1,0
-52,-41,-11,0,1,1
37,35,2,1,1,0
-36,-23,-13,0,1,1
28,18,10,1,1,0
13,14,-1,0,1,1
-9,-27,18,1,1,0
-19,-24,5,1,1,0
-43,-36,-7,0,0,0
34,22,12,1,0,1
-19,-13,-6,0,0,0
11,29,-18,0,0,0
-8,5,-13,0,0,0
-30,-10,-20,0,0,0
32,37,-5,0,0,0
0,0,0,0,0,0
20,5,15,1,0,1
-3,0,-3,0,0,0
25,37,-12,0,0,0
59,40,19,1,0,1
-21,-14,-7,0,0,0
40,31,9,1,0,1
44,31,13,1,0,1
-37,-43,6,1,0,1
15,14,1,1,0,1
15,35,-20,0,0,0
16,13,3,1,0,1
-25,-43,18,1,0,1
-30,-22,-8,0,0,0
-44,-40,-4,0,1,1
11,27,-16,0,1,1
46,39,7,1,1,0
-30,-37,7,1,1,0
62,43,19,1,1,0
-4,13,-17,0,1,1
15,1,14,1,1,0
-31,-22,-9,0,1,1
-24,-7,-17,0,1,1
-29,-31,2,1,1,0
6,15,-9,0,1,1
26,18,8,1,1,0
-11,-19,8,1,0,1
32,41,-9,0,0,0
17,20,-3,0,0,0
-46,-26,-20,0,0,0
9,16,-7,0,0,0
29,22,7,1,0,1
-34,-40,6,1,0,1
-35,-20,-15,0,0,0
-19,-21,2,1,0,1
-36,-21,-15,0,0,0
-38,-41,3,1,0,1
-31,-25,-6,0,0,0
-33,-38,5,1,1,0
-13,-22,9,1,1,0
-10,-2,-8,0,1,1
-12,-18,6,1,1,0
26,6,20,1,1,0
-16,-20,4,1,1,0
37,23,14,1,1,0
-22,-9,-13,0,1,1
51,44,7,1,0,1
21,33,-12,0,0,0
41,31,10,1,0,1
37,40,-3,0,0,0
-36,-24,-12,0,0,0
-37,-32,-5,0,0,0
27,35,-8,0,0,0
19,1,18,1,0,1
-34,-33,-1,0,0,0
-5,-3,-2,0,1,1
-14,-6,-8,0,1,1
-16,-21,5,1,1,0
-3,13,-16,0,1,1
-2,-22,20,1,1,0
14,5,9,1,1,0
8,-8,16,1,1,0
14,-6,20,1,1,0
-36,-17,-19,0,1,1
-1,-5,4,1,1,0
35,19,16,1,1,0
-19,-3,-16,0,1,1
19,-1,20,1,1,0
10,21,-11,0,1,1
-3,-23,20,1,1,0
31,34,-3,0,1,1
3,-6,9,1,1,0
21,11,10,1,1,0
13,31,-18,0,1,1
14,15,-1,0,1,1
-10,-1,-9,0,0,0
-44,-33,-11,0,0,0
54,44,10,1,0,1
40,34,6,1,0,1
-22,-23,1,1,0,1
7,-8,15,1,0,1
-1,7,-8,0,0,0
-22,-11,-11,0,0,0
-31,-31,0,0,0,0
-26,-22,-4,0,0,0
11,16,-5,0,0,0
-23,-18,-5,0,0,0
2,0,2,1,0,1
33,25,8,1,0,1
-42,-30,-12,0,0,0
-49,-32,-17,0,0,0
38,29,9,1,0,1
-34,-20,-14,0,0,0
-43,-44,1,1,0,1
19,28,-9,0,0,0
4,-10,14,1,0,1
18,29,-11,0,1,1
9,14,-5,0,1,1
18,8,10,1,1,0
17,20,-3,0,1,1
-8,3,-11,0,1,1
-2,18,-20,0,1,1
-41,-33,-8,0,1,1
-12,-13,1,1,1,0
49,38,11,1,1,0
30,18,12,1,1,0
-15,-23,8,1,1,0
-46,-28,-18,0,1,1
54,39,15,1,1,0
-3,-12,9,1,1,0
-11,3,-14,0,1,1
49,42,7,1,1,0
-14,-1,-13,0,0,0
-14,-22,8,1,0,1
30,38,-8,0,0,0
-24,-25,1,1,0,1
-17,-12,-5,0,0,0
-27,-44,17,1,0,1
10,26,-16,0,0,0
-1,-17,16,1,0,1
-4,15,-19,0,0,0
-39,-37,-2,0,0,0
31,16,15,1,0,1
4,16,-12,0,0,0
23,17,6,1,0,1
10,-8,18,1,0,1
-2,1,-3,0,0,0
-2,-19,17,1,0,1
-34,-23,-11,0,0,0
-26,-21,-5,0,0,0
-21,-25,4,1,0,1
-4,-15,11,1,0,1
-31,-14,-17,0,0,0
-12,-21,9,1,1,0
-49,-33,-16,0,1,1
11,15,-4,0,1,1
-37,-25,-12,0,1,1
-2,0,-2,0,1,1
-25,-24,-1,0,1,1
-49,-33,-16,0,1,1
-25,-43,18,1,1,0
36,41,-5,0,1,1
-4,7,-11,0,1,1
-6,12,-18,0,1,1
39,27,12,1,1,0
34,28,6,1,1,0
-30,-16,-14,0,1,1
15,15,0,0,1,1
-11,-30,19,1,1,0
2,2,0,0,1,1
-9,3,-12,0,1,1
40,24,16,1,1,0
29,11,18,1,1,0
-38,-27,-11,0,0,0
20,16,4,1,0,1
22,39,-17,0,0,0
-5,-18,13,1,0,1
36,25,11,1,0,1
41,31,10,1,0,1
24,11,13,1,0,1
30,11,19,1,0,1
-36,-26,-10,0,0,0
0,-19,19,1,0,1
38,29,9,1,0,1
-40,-30,-10,0,0,0
32,26,6,1,0,1
-26,-12,-14,0,0,0
15,-5,20,1,0,1
4,23,-19,0,0,0
-27,-15,-12,0,0,0
-27,-35,8,1,0,1
-11,-27,16,1,1,0
3,10,-7,0,1,1
-39,-34,-5,0,1,1
6,23,-17,0,1,1
-22,-15,-7,0,1,1
54,41,13,1,1,0
-4,0,-4,0,1,1
-26,-25,-1,0,1,1
-21,-11,-10,0,1,1
12,23,-11,0,1,1
24,42,-18,0,1,1
14,-5,19,1,1,0
37,23,14,1,1,0
52,42,10,1,1,0
-36,-23,-13,0,0,0
-43,-32,-11,0,0,0
-13,2,-15,0,0,0
20,32,-12,0,0,0
-39,-36,-3,0,0,0
-48,-34,-14,0,0,0
11,-9,20,1,0,1
27,25,2,1,0,1
28,35,-7,0,0,0
33,24,9,1,0,1
-22,-39,17,1,0,1
17,25,-8,0,0,0
-19,-2,-17,0,1,1
31,36,-5,0,1,1
-34,-14,-20,0,1,1
-30,-33,3,1,1,0
-17,-14,-3,0,1,1
6,21,-15,0,1,1
-18,-9,-9,0,1,1
5,-1,6,1,1,0
13,21,-8,0,1,1
-22,-13,-9,0,1,1
-5,-18,13,1,1,0
50,31,19,1,1,0
5,13,-8,0,1,1
1,6,-5,0,1,1
-7,-25,18,1,1,0
11,17,-6,0,1,1
31,12,19,1,1,0
20,18,2,1,1,0
-17,0,-17,0,1,1
-21,-10,-11,0,1,1
15,23,-8,0,1,1
-1,-17,16,1,0,1
-20,-26,6,1,0,1
-58,-45,-13,0,0,0
12,15,-3,0,0,0
-39,-45,6,1,0,1
5,17,-12,0,0,0
18,31,-13,0,0,0
-33,-22,-11,0,0,0
-14,-29,15,1,0,1
-31,-11,-20,0,0,0
-39,-26,-13,0,0,0
-22,-23,1,1,0,1
-14,-17,3,1,0,1
-41,-31,-10,0,0,0
-12,-10,-2,0,0,0
41,22,19,1,0,1
59,42,17,1,1,0
25,30,-5,0,1,1
-44,-30,-14,0,1,1
-10,-25,15,1,1,0
0,-16,16,1,1,0
-30,-21,-9,0,1,1
36,20,16,1,1,0
-41,-36,-5,0,1,1
-44,-45,1,1,1,0
-46,-38,-8,0,1,1
21,6,15,1,1,0
24,22,2,1,1,0
-21,-12,-9,0,1,1
36,41,-5,0,1,1
26,31,-5,0,1,1
-23,-31,8,1,1,0
-18,-22,4,1,1,0
-8,7,-15,0,1,1
-18,-5,-13,0,1,1
40,31,9,1,0,1
8,-12,20,1,0,1
17,6,11,1,0,1
-37,-41,4,1,0,1
20,12,8,1,0,1
36,18,18,1,0,1
21,27,-6,0,0,0
13,29,-16,0,0,0
-1,16,-17,0,0,0
9,-3,12,1,0,1
-42,-31,-11,0,1,1
-28,-44,16,1,1,0
4,0,4,1,1,0
12,-6,18,1,1,0
-20,0,-20,0,1,1
0,-18,18,1,1,0
17,11,6,1,1,0
11,12,-1,0,1,1
24,43,-19,0,1,1
-43,-28,-15,0,1,1
-23,-10,-13,0,1,1
-2,-1,-1,0,1,1
32,42,-10,0,1,1
44,26,18,1,1,0
31,19,12,1,1,0
9,0,9,1,1,0
-29,-20,-9,0,1,1
-9,5,-14,0,1,1
-54,-36,-18,0,1,1
22,26,-4,0,1,1
24,37,-13,0,1,1
-42,-36,-6,0,0,0
30,23,7,1,0,1
-9,-19,10,1,0,1
27,26,1,1,0,1
-13,-6,-7,0,0,0
26,10,16,1,0,1
0,-20,20,1,0,1
27,10,17,1,0,1
-39,-23,-16,0,0,0
-30,-27,-3,0,0,0
-1,-20,19,1,0,1
16,20,-4,0,0,0
2,11,-9,0,1,1
-43,-42,-1,0,1,1
-7,-25,18,1,1,0
36,35,1,1,1,0
-47,-42,-5,0,1,1
10,-3,13,1,1,0
11,-2,13,1,1,0
10,11,-1,0,1,1
18,6,12,1,1,0
-19,-4,-15,0,1,1
6,4,2,1,0,1
24,27,-3,0,0,0
-47,-37,-10,0,0,0
21,18,3,1,0,1
55,43,12,1,0,1
-22,-24,2,1,0,1
4,10,-6,0,0,0
-31,-11,-20,0,0,0
2,-15,17,1,0,1
22,17,5,1,0,1
-31,-33,2,1,0,1
4,-4,8,1,0,1
10,-2,12,1,0,1
27,8,19,1,0,1
-41,-21,-20,0,0,0
-58,-38,-20,0,0,0
18,24,-6,0,0,0
-2,15,-17,0,0,0
-23,-24,1,1,0,1
-44,-41,-3,0,0,0
-9,8,-17,0,0,0
28,19,9,1,1,0
-22,-28,6,1,1,0
42,44,-2,0,1,1
44,24,20,1,1,0
-48,-42,-6,0,1,1
-30,-43,13,1,1,0
5,12,-7,0,1,1
-28,-8,-20,0,1,1
-26,-9,-17,0,1,1
19,11,8,1,1,0
49,32,17,1,1,0
26,37,-11,0,1,1
43,25,18,1,1,0
3,-5,8,1,1,0
-7,4,-11,0,1,1
-24,-33,9,1,0,1
-10,-22,12,1,0,1
-7,-7,0,0,0,0
-1,-7,6,1,0,1
-7,-3,-4,0,0,0
45,35,10,1,0,1
46,37,9,1,0,1
14,23,-9,0,0,0
-21,-6,-15,0,0,0
19,13,6,1,1,0
4,20,-16,0,1,1
8,6,2,1,1,0
-43,-40,-3,0,1,1
-35,-23,-12,0,1,1
-18,-10,-8,0,1,1
27,20,7,1,1,0
11,18,-7,0,1,1
-58,-41,-17,0,1,1
2,-9,11,1,1,0
5,-1,6,1,1,0
26,32,-6,0,1,1
8,5,3,1,1,0
4,-10,14,1,1,0
38,29,9,1,0,1
27,12,15,1,0,1
-27,-40,13,1,0,1
-23,-25,2,1,0,1
-29,-27,-2,0,0,0
-51,-33,-18,0,0,0
0,1,-1,0,0,0
-10,-12,2,1,0,1
39,22,17,1,0,1
20,32,-12,0,0,0
-26,-18,-8,0,0,0
-51,-44,-7,0,0,0
-23,-19,-4,0,0,0
24,13,11,1,0,1
-37,-31,-6,0,0,0
1,13,-12,0,0,0
8,4,4,1,0,1
-12,-19,7,1,0,1
8,15,-7,0,0,0
48,32,16,1,0,1
-4,-23,19,1,1,0
44,41,3,1,1,0
22,5,17,1,1,0
-15,-35,20,1,1,0
-16,-22,6,1,1,0
33,25,8,1,1,0
-9,-22,13,1,1,0
-29,-18,-11,0,1,1
-36,-18,-18,0,1,1
-22,-5,-17,0,1,1
24,21,3,1,1,0
-25,-12,-13,0,1,1
20,23,-3,0,0,0
-24,-21,-3,0,0,0
-12,2,-14,0,0,0
20,21,-1,0,0,0
-23,-41,18,1,0,1
-49,-31,-18,0,0,0
-13,-33,20,1,0,1
-36,-38,2,1,0,1
-23,-3,-20,0,0,0
24,12,12,1,0,1
-29,-14,-15,0,0,0
-41,-43,2,1,0,1
20,14,6,1,0,1
35,40,-5,0,1,1
26,21,5,1,1,0
22,6,16,1,1,0
-10,8,-18,0,1,1
-24,-11,-13,0,1,1
-30,-36,6,1,1,0
53,42,11,1,1,0
28,16,12,1,1,0
-9,-15,6,1,1,0
53,40,13,1,1,0
-12,-29,17,1,1,0
34,22,12,1,1,0
18,21,-3,0,0,0
-44,-26,-18,0,0,0
23,31,-8,0,0,0
-41,-30,-11,0,0,0
-3,-11,8,1,0,1
-17,-4,-13,0,0,0
-62,-45,-17,0,0,0
-30,-32,2,1,0,1
-54,-37,-17,0,0,0
-12,-23,11,1,0,1
-27,-22,-5,0,1,1
-3,-8,5,1,1,0
13,-6,19,1,1,0
38,29,9,1,1,0
2,-1,3,1,1,0
24,10,14,1,1,0
-47,-41,-6,0,1,1
35,38,-3,0,1,1
-19,-37,18,1,1,0
8,-2,10,1,1,0
-5,-19,14,1,1,0
-42,-28,-14,0,1,1
54,34,20,1,1,0
27,40,-13,0,1,1
2,19,-17,0,1,1
22,24,-2,0,1,1
-22,-36,14,1,1,0
8,-9,17,1,1,0
-26,-16,-10,0,0,0
-12,7,-19,0,0,0
-44,-38,-6,0,0,0
11,28,-17,0,0,0
-54,-34,-20,0,0,0
-24,-5,-19,0,0,0
-23,-32,9,1,0,1
-26,-18,-8,0,0,0
-3,1,-4,0,0,0
-43,-45,2,1,0,1
-19,-1,-18,0,0,0
22,5,17,1,0,1
-11,-20,9,1,0,1
-43,-45,2,1,0,1
-25,-9,-16,0,0,0
12,25,-13,0,0,0
7,26,-19,0,0,0
-15,-5,-10,0,0,0
7,-6,13,1,0,1
-4,-6,2,1,0,1
15,27,-12,0,0,0
64,44,20,1,1,0
11,20,-9,0,1,1
-60,-41,-19,0,1,1
-29,-28,-1,0,1,1
-5,14,-19,0,1,1
-8,10,-18,0,1,1
-38,-30,-8,0,1,1
1,11,-10,0,1,1
12,12,0,0,1,1
24,6,18,1,1,0
45,27,18,1,1,0
4,23,-19,0,0,0
-23,-43,20,1,0,1
56,36,20,1,0,1
41,29,12,1,0,1
2,10,-8,0,0,0
60,42,18,1,0,1
-2,8,-10,0,0,0
31,33,-2,0,0,0
-27,-7,-20,0,0,0
23,11,12,1,0,1
-7,3,-10,0,0,0
-10,-7,-3,0,0,0
-23,-12,-11,0,0,0
-33,-35,2,1,0,1
38,22,16,1,0,1
8,-1,9,1,0,1
37,22,15,1,0,1
52,41,11,1,0,1
-23,-13,-10,0,0,0
-8,-16,8,1,0,1
-19,-15,-4,0,0,0
-16,-1,-15,0,1,1
6,24,-18,0,1,1
9,18,-9,0,1,1
-43,-29,-14,0,1,1
33,17,16,1,1,0
53,39,14,1,1,0
-11,-25,14,1,1,0
8,-7,15,1,1,0
6,13,-7,0,1,1
-23,-35,12,1,1,0
-34,-43,9,1,1,0
9,21,-12,0,1,1
-30,-25,-5,0,1,1
-28,-39,11,1,1,0
-47,-45,-2,0,1,1
7,17,-10,0,1,1
36,17,19,1,1,0
12,4,8,1,0,1
44,33,11,1,0,1
38,21,17,1,0,1
41,40,1,1,0,1
4,-13,17,1,0,1
-53,-35,-18,0,0,0
-25,-35,10,1,0,1
-38,-44,6,1,0,1
-54,-34,-20,0,0,0
4,24,-20,0,0,0
-27,-19,-8,0,0,0
22,10,12,1,0,1
16,3,13,1,1,0
50,34,16,1,1,0
52,35,17,1,1,0
-40,-20,-20,0,1,1
-26,-21,-5,0,1,1
0,-9,9,1,1,0
-38,-40,2,1,1,0
19,-1,20,1,1,0
17,20,-3,0,1,1
-27,-30,3,1,1,0
11,-1,12,1,1,0
7,12,-5,0,1,1
-23,-42,19,1,1,0
9,4,5,1,1,0
6,19,-13,0,1,1
4,22,-18,0,1,1
-35,-43,8,1,1,0
0,-5,5,1,1,0
-24,-5,-19,0,1,1
2,-11,13,1,1,0
46,29,17,1,1,0
-64,-44,-20,0,0,0
-7,-18,11,1,0,1
12,0,12,1,0,1
14,31,-17,0,0,0
-21,-28,7,1,0,1
43,37,6,1,0,1
48,40,8,1,0,1
-24,-25,1,1,0,1
-40,-38,-2,0,0,0
-48,-31,-17,0,0,0
-14,-9,-5,0,0,0
-45,-43,-2,0,1,1
-26,-20,-6,0,1,1
-39,-19,-20,0,1,1
-15,-8,-7,0,1,1
42,38,4,1,1,0
-17,-34,17,1,1,0
-26,-45,19,1,1,0
7,12,-5,0,1,1
32,28,4,1,1,0
47,43,4,1,1,0
15,23,-8,0,1,1
11,1,10,1,1,0
-15,-27,12,1,1,0
-38,-31,-7,0,1,1
10,14,-4,0,1,1
-7,10,-17,0,1,1
-45,-31,-14,0,1,1
20,21,-1,0,1,1
6,8,-2,0,1,1
-29,-10,-19,0,1,1
20,10,10,1,1,0
-27,-32,5,1,0,1
-15,-32,17,1,0,1
3,-11,14,1,0,1
-25,-26,1,1,0,1
-9,7,-16,0,0,0
5,-9,14,1,0,1
32,42,-10,0,0,0
-2,-4,2,1,0,1
-3,11,-14,0,0,0
38,21,17,1,0,1
-47,-33,-14,0,0,0
-31,-36,5,1,0,1
-56,-44,-12,0,0,0
-43,-45,2,1,0,1
-21,-16,-5,0,0,0
-25,-30,5,1,0,1
4,16,-12,0,0,0
-61,-43,-18,0,0,0
-42,-38,-4,0,0,0
-28,-26,-2,0,0,0
-8,2,-10,0,0,0
38,39,-1,0,1,1
-3,12,-15,0,1,1
57,41,16,1,1,0
3,-7,10,1,1,0
21,7,14,1,1,0
46,28,18,1,1,0
59,40,19,1,1,0
11,-8,19,1,1,0
8,24,-16,0,1,1
-55,-36,-19,0,1,1
-44,-31,-13,0,1,1
-12,0,-12,0,1,1
29,43,-14,0,1,1
15,7,8,1,1,0
-1,-11,10,1,1,0
32,33,-1,0,1,1
12,-3,15,1,1,0
-21,-38,17,1,1,0
-32,-18,-14,0,1,1
-10,-8,-2,0,1,1
-47,-42,-5,0,1,1
-39,-20,-19,0,0,0
-32,-13,-19,0,0,0
11,-3,14,1,0,1
18,34,-16,0,0,0
38,26,12,1,0,1
38,26,12,1,0,1
0,5,-5,0,0,0
44,44,0,0,0,0
-29,-25,-4,0,0,0
20,7,13,1,0,1
0,-2,2,1,0,1
4,12,-8,0,0,0
-29,-23,-6,0,0,0
-13,-23,10,1,0,1
-18,-9,-9,0,0,0
-2,11,-13,0,0,0
29,35,-6,0,0,0
19,24,-5,0,0,0
-38,-26,-12,0,0,0
14,24,-10,0,0,0
35,29,6,1,0,1
9,-7,16,1,1,0
44,24,20,1,1,0
12,-1,13,1,1,0
51,36,15,1,1,0
51,33,18,1,1,0
21,32,-11,0,1,1
-60,-43,-17,0,1,1
16,16,0,0,1,1
29,16,13,1,1,0
-4,-11,7,1,1,0
38,25,13,1,1,0
31,43,-12,0,1,1
-37,-34,-3,0,1,1
-60,-43,-17,0,1,1
-37,-19,-18,0,1,1
13,29,-16,0,0,0
-51,-36,-15,0,0,0
-30,-26,-4,0,0,0
10,-4,14,1,0,1
35,20,15,1,0,1
29,35,-6,0,0,0
-4,-13,9,1,0,1
-10,-9,-1,0,0,0
-12,-28,16,1,1,0
-17,-2,-15,0,1,1
-27,-32,5,1,1,0
-44,-28,-16,0,1,1
-7,-4,-3,0,1,1
21,33,-12,0,1,1
10,14,-4,0,1,1
35,21,14,1,1,0
37,41,-4,0,1,1
-31,-26,-5,0,1,1
24,25,-1,0,1,1
-58,-40,-18,0,1,1
33,22,11,1,0,1
36,20,16,1,0,1
0,5,-5,0,0,0
19,39,-20,0,0,0
-28,-24,-4,0,0,0
-38,-38,0,0,0,0
34,38,-4,0,0,0
22,8,14,1,0,1
20,11,9,1,0,1
26,15,11,1,0,1
6,-12,18,1,0,1
-38,-36,-2,0,0,0
38,37,1,1,1,0
-25,-31,6,1,1,0
39,42,-3,0,1,1
28,19,9,1,1,0
-48,-40,-8,0,1,1
-56,-37,-19,0,1,1
12,14,-2,0,1,1
-46,-35,-11,0,1,1
33,35,-2,0,1,1
-11,-17,6,1,1,0
-10,-29,19,1,1,0
18,13,5,1,0,1
-5,-25,20,1,0,1
-34,-17,-17,0,0,0
-55,-43,-12,0,0,0
-33,-25,-8,0,0,0
-40,-32,-8,0,0,0
20,33,-13,0,0,0
-4,-10,6,1,0,1
-30,-34,4,1,0,1
33,42,-9,0,1,1
-24,-25,1,1,1,0
-50,-38,-12,0,1,1
-45,-28,-17,0,1,1
-4,-21,17,1,1,0
11,-8,19,1,1,0
14,11,3,1,1,0
42,37,5,1,1,0
10,-9,19,1,1,0
-28,-33,5,1,1,0
42,40,2,1,1,0
-17,-30,13,1,1,0
19,6,13,1,1,0
-4,10,-14,0,0,0
-3,-7,4,1,0,1
-20,0,-20,0,0,0
31,29,2,1,0,1
16,29,-13,0,0,0
25,39,-14,0,0,0
29,23,6,1,0,1
-21,-21,0,0,0,0
3,0,3,1,0,1
35,34,1,1,0,1
7,-4,11,1,0,1
-39,-20,-19,0,0,0
9,9,0,0,0,0
23,5,18,1,0,1
41,30,11,1,0,1
-5,-19,14,1,0,1
-7,11,-18,0,0,0
-63,-45,-18,0,0,0
-18,-14,-4,0,0,0
-11,-19,8,1,0,1
14,18,-4,0,0,0
21,27,-6,0,1,1
5,21,-16,0,1,1
7,27,-20,0,1,1
1,7,-6,0,1,1
2,-1,3,1,1,0
-16,-26,10,1,1,0
-17,-17,0,0,1,1
-28,-36,8,1,1,0
23,20,3,1,1,0
24,15,9,1,1,0
23,30,-7,0,1,1
13,28,-15,0,1,1
1,-17,18,1,1,0
19,10,9,1,1,0
25,16,9,1,1,0
6,16,-10,0,1,1
31,14,17,1,0,1
42,32,10,1,0,1
-43,-42,-1,0,0,0
-51,-43,-8,0,0,0
37,35,2,1,0,1
29,9,20,1,0,1
-47,-28,-19,0,0,0
-27,-40,13,1,0,1
32,14,18,1,0,1
29,37,-8,0,0,0
5,2,3,1,0,1
56,36,20,1,0,1
-22,-10,-12,0,0,0
43,39,4,1,0,1
48,38,10,1,0,1
-3,-14,11,1,0,1
11,4,7,1,0,1
46,37,9,1,0,1
-36,-25,-11,0,0,0
28,18,10,1,0,1
40,27,13,1,0,1
23,7,16,1,1,0
-25,-36,11,1,1,0
29,36,-7,0,1,1
-20,-13,-7,0,1,1
57,38,19,1,1,0
-51,-33,-18,0,1,1
-31,-37,6,1,1,0
-5,14,-19,0,1,1
8,23,-15,0,1,1
29,20,9,1,1,0
-7,-5,-2,0,1,1
12,21,-9,0,1,1
31,42,-11,0,1,1
42,38,4,1,1,0
-3,13,-16,0,1,1
59,39,20,1,1,0
21,16,5,1,1,0
-5,-22,17,1,1,0
32,33,-1,0,1,1
-16,-5,-11,0,1,1
30,14,16,1,1,0
-54,-41,-13,0,0,0
-13,4,-17,0,0,0
12,13,-1,0,0,0
-22,-32,10,1,0,1
30,16,14,1,0,1
51,37,14,1,0,1
-14,-8,-6,0,0,0
11,31,-20,0,0,0
9,-10,19,1,0,1
13,13,0,0,0,0
20,12,8,1,0,1
33,23,10,1,1,0
18,2,16,1,1,0
5,5,0,0,1,1
-7,9,-16,0,1,1
-23,-42,19,1,1,0
14,11,3,1,1,0
-19,-1,-18,0,1,1
33,44,-11,0,1,1
-11,-4,-7,0,1,1
9,16,-7,0,1,1
-39,-24,-15,0,1,1
10,3,7,1,1,0
-25,-15,-10,0,1,1
-33,-15,-18,0,1,1
47,43,4,1,1,0
1,-15,16,1,1,0
51,43,8,1,1,0
17,22,-5,0,1,1
-43,-44,1,1,1,0
-44,-26,-18,0,1,1
-15,3,-18,0,1,1
10,3,7,1,0,1
6,7,-1,0,0,0
-48,-38,-10,0,0,0
10,12,-2,0,0,0
-39,-29,-10,0,0,0
42,43,-1,0,0,0
-7,-25,18,1,0,1
32,31,1,1,0,1
-8,-22,14,1,0,1
-33,-23,-10,0,0,0
54,35,19,1,1,0
-35,-21,-14,0,1,1
4,4,0,0,1,1
50,39,11,1,1,0
-12,0,-12,0,1,1
-31,-32,1,1,1,0
-8,5,-13,0,1,1
8,7,1,1,1,0
-62,-44,-18,0,1,1
5,-4,9,1,1,0
1,-19,20,1,1,0
28,26,2,1,1,0
43,26,17,1,0,1
-13,-4,-9,0,0,0
27,27,0,0,0,0
-19,-15,-4,0,0,0
52,33,19,1,0,1
-31,-29,-2,0,0,0
43,42,1,1,0,1
28,33,-5,0,0,0
-7,-18,11,1,0,1
-38,-26,-12,0,0,0
13,18,-5,0,0,0
0,18,-18,0,0,0
37,23,14,1,0,1
55,43,12,1,0,1
-32,-13,-19,0,0,0
-58,-38,-20,0,0,0
-36,-23,-13,0,0,0
-6,-15,9,1,0,1
25,43,-18,0,0,0
-10,-21,11,1,0,1
-20,0,-20,0,0,0
-3,17,-20,0,1,1
11,5,6,1,1,0
15,22,-7,0,1,1
-19,-34,15,1,1,0
-3,17,-20,0,1,1
2,-14,16,1,1,0
-47,-45,-2,0,1,1
-30,-31,1,1,1,0
4,-14,18,1,1,0
-25,-28,3,1,1,0
24,23,1,1,1,0
-41,-26,-15,0,1,1
-25,-39,14,1,1,0
-40,-21,-19,0,1,1
-39,-32,-7,0,1,1
-14,-17,3,1,1,0
-34,-25,-9,0,1,1
59,39,20,1,1,0
-40,-43,3,1,1,0
-53,-43,-10,0,1,1
32,40,-8,0,1,1
15,19,-4,0,0,0
-28,-29,1,1,0,1
21,41,-20,0,0,0
-33,-15,-18,0,0,0
24,29,-5,0,0,0
-22,-5,-17,0,0,0
-3,-2,-1,0,0,0
29,38,-9,0,0,0
10,5,5,1,1,0
-37,-41,4,1,1,0
21,9,12,1,1,0
13,17,-4,0,1,1
59,39,20,1,1,0
8,1,7,1,1,0
43,38,5,1,1,0
-10,-28,18,1,1,0
17,16,1,1,1,0
47,44,3,1,0,1
-3,-17,14,1,0,1
-7,-10,3,1,0,1
24,44,-20,0,0,0
-38,-37,-1,0,0,0
-9,1,-10,0,0,0
38,23,15,1,0,1
-50,-34,-16,0,0,0
-38,-42,4,1,0,1
-17,-3,-14,0,0,0
-23,-6,-17,0,0,0
18,4,14,1,0,1
-1,-15,14,1,0,1
48,35,13,1,0,1
-27,-23,-4,0,0,0
-46,-45,-1,0,0,0
15,-2,17,1,0,1
-35,-18,-17,0,0,0
31,28,3,1,0,1
10,3,7,1,0,1
-29,-20,-9,0,0,0
5,-1,6,1,1,0
45,27,18,1,1,0
-37,-37,0,0,1,1
-30,-21,-9,0,1,1
-9,-10,1,1,1,0
4,-11,15,1,1,0
-24,-5,-19,0,1,1
-19,-8,-11,0,1,1
-20,-9,-11,0,1,1
-11,-22,11,1,1,0
-23,-37,14,1,1,0
-41,-37,-4,0,1,1
42,34,8,1,1,0
-5,2,-7,0,1,1
-18,-10,-8,0,1,1
6,0,6,1,1,0
-20,-13,-7,0,1,1
2,13,-11,0,1,1
26,22,4,1,0,1
-24,-23,-1,0,0,0
-18,-25,7,1,0,1
28,21,7,1,0,1
-21,-30,9,1,0,1
40,40,0,0,0,0
-50,-42,-8,0,0,0
-41,-30,-11,0,0,0
48,42,6,1,0,1
8,11,-3,0,0,0
-45,-40,-5,0,0,0
-15,-2,-13,0,0,0
-43,-44,1,1,0,1
-15,-4,-11,0,0,0
-25,-29,4,1,0,1
8,13,-5,0,0,0
-38,-29,-9,0,1,1
-10,-13,3,1,1,0
-43,-24,-19,0,1,1
-2,-14,12,1,1,0
14,0,14,1,1,0
10,10,0,0,1,1
57,39,18,1,1,0
-7,-16,9,1,1,0
32,13,19,1,1,0
15,10,5,1,0,1
-14,5,-19,0,0,0
-19,-25,6,1,0,1
39,41,-2,0,0,0
42,43,-1,0,0,0
3,20,-17,0,0,0
-20,-29,9,1,0,1
-28,-33,5,1,0,1
-16,-22,6,1,0,1
-8,-10,2,1,0,1
29,28,1,1,0,1
21,35,-14,0,0,0
27,10,17,1,0,1
5,11,-6,0,1,1
-24,-15,-9,0,1,1
32,35,-3,0,1,1
6,-8,14,1,1,0
8,-7,15,1,1,0
-31,-41,10,1,1,0
-33,-26,-7,0,1,1
-45,-43,-2,0,1,1
17,12,5,1,1,0
39,40,-1,0,1,1
23,20,3,1,1,0
-5,15,-20,0,1,1
-5,-9,4,1,1,0
41,37,4,1,1,0
-4,-3,-1,0,0,0
5,-1,6,1,0,1
10,5,5,1,0,1
1,2,-1,0,0,0
20,13,7,1,0,1
-32,-28,-4,0,0,0
16,31,-15,0,0,0
-32,-31,-1,0,0,0
-9,-4,-5,0,0,0
-13,-8,-5,0,0,0
10,17,-7,0,0,0
-26,-35,9,1,1,0
36,32,4,1,1,0
-21,-23,2,1,1,0
-13,0,-13,0,1,1
15,13,2,1,1,0
-31,-41,10,1,1,0
3,-2,5,1,1,0
40,35,5,1,1,0
31,33,-2,0,0,0
-10,8,-18,0,0,0
-22,-36,14,1,0,1
19,37,-18,0,0,0
10,15,-5,0,0,0
32,44,-12,0,0,0
-5,-15,10,1,0,1
60,44,16,1,0,1
25,43,-18,0,0,0
-40,-20,-20,0,0,0
10,-2,12,1,0,1
12,24,-12,0,0,0
-2,8,-10,0,0,0
-34,-27,-7,0,0,0
23,38,-15,0,1,1
-25,-20,-5,0,1,1
-13,-6,-7,0,1,1
49,35,14,1,1,0
36,41,-5,0,1,1
-12,-31,19,1,1,0
-46,-31,-15,0,1,1
-8,-12,4,1,1,0
5,15,-10,0,1,1
-29,-23,-6,0,1,1
27,42,-15,0,1,1
46,42,4,1,1,0
11,11,0,0,1,1
5,4,1,1,1,0
-13,-7,-6,0,1,1
-28,-12,-16,0,0,0
7,6,1,1,0,1
42,36,6,1,0,1
22,15,7,1,0,1
14,6,8,1,0,1
-33,-18,-15,0,0,0
20,11,9,1,0,1
3,6,-3,0,0,0
-23,-26,3,1,0,1
-10,-25,15,1,0,1
29,42,-13,0,0,0
15,-2,17,1,0,1
43,28,15,1,0,1
-50,-30,-20,0,1,1
22,17,5,1,1,0
2,0,2,1,1,0
-27,-41,14,1,1,0
-8,4,-12,0,1,1
9,-10,19,1,1,0
26,11,15,1,1,0
-47,-32,-15,0,1,1
-38,-22,-16,0,1,1
-28,-31,3,1,1,0
34,24,10,1,0,1
-26,-38,12,1,0,1
36,44,-8,0,0,0
10,26,-16,0,0,0
22,38,-16,0,0,0
-26,-13,-13,0,0,0
50,39,11,1,0,1
-29,-25,-4,0,0,0
8,8,0,0,0,0
-24,-27,3,1,0,1
-37,-17,-20,0,0,0
20,16,4,1,0,1
-2,-9,7,1,1,0
7,20,-13,0,1,1
8,14,-6,0,1,1
-42,-32,-10,0,1,1
26,13,13,1,1,0
-9,-16,7,1,1,0
-12,0,-12,0,1,1
24,18,6,1,1,0
54,35,19,1,1,0
45,32,13,1,1,0
-19,-8,-11,0,1,1
23,43,-20,0,0,0
-15,-35,20,1,0,1
59,41,18,1,0,1
5,0,5,1,0,1
21,10,11,1,0,1
-5,14,-19,0,0,0
-33,-35,2,1,0,1
7,-4,11,1,0,1
-40,-45,5,1,0,1
49,39,10,1,0,1
-27,-13,-14,0,0,0
-22,-3,-19,0,0,0
-28,-27,-1,0,1,1
-62,-45,-17,0,1,1
-28,-24,-4,0,1,1
-50,-43,-7,0,1,1
16,3,13,1,1,0
36,28,8,1,1,0
-15,-7,-8,0,1,1
-28,-41,13,1,1,0
-40,-28,-12,0,1,1
3,-3,6,1,1,0
39,40,-1,0,1,1
49,36,13,1,1,0
56,42,14,1,1,0
-15,4,-19,0,1,1
-26,-20,-6,0,1,1
5,-5,10,1,0,1
-35,-35,0,0,0,0
-26,-25,-1,0,0,0
7,-13,20,1,0,1
-5,14,-19,0,0,0
0,-9,9,1,0,1
-22,-42,20,1,0,1
-9,0,-9,0,0,0
8,12,-4,0,0,0
18,24,-6,0,0,0
-26,-27,1,1,0,1
-37,-32,-5,0,0,0
51,37,14,1,1,0
-18,1,-19,0,1,1
18,36,-18,0,1,1
-54,-44,-10,0,1,1
-22,-21,-1,0,1,1
39,22,17,1,1,0
-11,-31,20,1,1,0
43,37,6,1,1,0
-3,13,-16,0,1,1
7,17,-10,0,1,1
-4,-23,19,1,1,0
-1,-8,7,1,1,0
18,0,18,1,1,0
-29,-17,-12,0,1,1
29,19,10,1,1,0
-3,-8,5,1,1,0
39,37,2,1,1,0
3,14,-11,0,1,1
-20,-12,-8,0,1,1
-30,-42,12,1,1,0
-24,-44,20,1,1,0
-29,-10,-19,0,0,0
54,44,10,1,0,1
30,13,17,1,0,1
10,-3,13,1,0,1
-24,-37,13,1,0,1
-8,-5,-3,0,0,0
-6,-5,-1,0,0,0
35,31,4,1,0,1
-7,-23,16,1,0,1
-29,-27,-2,0,0,0
40,25,15,1,0,1
11,22,-11,0,0,0
18,14,4,1,0,1
-25,-45,20,1,0,1
18,24,-6,0,1,1
0,5,-5,0,1,1
-13,-15,2,1,1,0
-30,-11,-19,0,1,1
-33,-35,2,1,1,0
-62,-42,-20,0,1,1
36,44,-8,0,1,1
-10,0,-10,0,1,1
-46,-43,-3,0,1,1
41,35,6,1,1,0
23,43,-20,0,1,1
-26,-27,1,1,1,0
-21,-36,15,1,1,0
21,24,-3,0,0,0
29,35,-6,0,0,0
59,40,19,1,0,1
2,13,-11,0,0,0
6,1,5,1,0,1
0,-1,1,1,0,1
53,43,10,1,0,1
33,43,-10,0,0,0
37,28,9,1,0,1
-42,-28,-14,0,0,0
-22,-33,11,1,1,0
9,-8,17,1,1,0
20,15,5,1,1,0
-3,-2,-1,0,1,1
-52,-45,-7,0,1,1
-1,15,-16,0,1,1
12,20,-8,0,1,1
-36,-28,-8,0,1,1
-27,-27,0,0,1,1
2,-9,11,1,1,0
40,37,3,1,1,0
56,37,19,1,1,0
-13,-8,-5,0,1,1
-16,-1,-15,0,1,1
-6,-9,3,1,1,0
9,17,-8,0,1,1
44,28,16,1,1,0
-12,-12,0,0,0,0
9,6,3,1,0,1
-49,-29,-20,0,0,0
15,3,12,1,0,1
9,3,6,1,0,1
3,22,-19,0,0,0
3,-12,15,1,0,1
-18,-30,12,1,0,1
15,-4,19,1,0,1
-22,-25,3,1,0,1
37,35,2,1,0,1
31,26,5,1,1,0
7,15,-8,0,1,1
5,2,3,1,1,0
14,22,-8,0,1,1
-17,-28,11,1,1,0
46,39,7,1,1,0
-38,-44,6,1,1,0
10,1,9,1,1,0
44,40,4,1,1,0
15,1,14,1,0,1
-27,-38,11,1,0,1
-24,-11,-13,0,0,0
-5,6,-11,0,0,0
12,31,-19,0,0,0
-1,-14,13,1,0,1
-23,-42,19,1,0,1
42,35,7,1,0,1
-45,-37,-8,0,0,0
-35,-25,-10,0,0,0
10,18,-8,0,0,0
7,17,-10,0,0,0
-3,15,-18,0,0,0
-9,8,-17,0,0,0
-2,8,-10,0,0,0
-56,-40,-16,0,0,0
37,43,-6,0,1,1
23,15,8,1,1,0
-12,-9,-3,0,1,1
41,40,1,1,1,0
-32,-36,4,1,1,0
22,16,6,1,1,0
14,24,-10,0,1,1
26,25,1,1,1,0
25,7,18,1,1,0
-33,-42,9,1,1,0
-5,7,-12,0,1,1
-12,2,-14,0,1,1
-17,-16,-1,0,1,1
-1,6,-7,0,1,1
35,26,9,1,0,1
23,5,18,1,0,1
5,13,-8,0,0,0
-38,-27,-11,0,0,0
13,5,8,1,0,1
27,15,12,1,0,1
-29,-29,0,0,0,0
9,1,8,1,0,1
-17,-12,-5,0,0,0
-38,-20,-18,0,0,0
-22,-22,0,0,0,0
10,28,-18,0,0,0
-57,-44,-13,0,0,0
44,26,18,1,0,1
40,36,4,1,0,1
17,23,-6,0,0,0
-19,-27,8,1,0,1
-20,-22,2,1,0,1
58,42,16,1,0,1
13,-2,15,1,0,1
22,11,11,1,0,1
31,32,-1,0,1,1
-1,15,-16,0,1,1
35,43,-8,0,1,1
34,28,6,1,1,0
10,25,-15,0,1,1
60,42,18,1,1,0
10,29,-19,0,1,1
-57,-44,-13,0,1,1
-1,-18,17,1,1,0
-39,-30,-9,0,0,0
-27,-37,10,1,0,1
27,44,-17,0,0,0
-10,-25,15,1,0,1
25,30,-5,0,0,0
-16,-22,6,1,0,1
52,37,15,1,0,1
53,38,15,1,0,1
-7,-23,16,1,0,1
-29,-9,-20,0,1,1
-42,-38,-4,0,1,1
9,14,-5,0,1,1
43,33,10,1,1,0
19,8,11,1,1,0
-34,-19,-15,0,1,1
-9,8,-17,0,1,1
33,43,-10,0,1,1
-7,-8,1,1,1,0
13,15,-2,0,1,1
-46,-39,-7,0,1,1
35,38,-3,0,1,1
10,-5,15,1,1,0
7,27,-20,0,1,1
11,-4,15,1,1,0
42,31,11,1,1,0
-37,-42,5,1,1,0
-3,-11,8,1,1,0
-35,-22,-13,0,1,1
30,22,8,1,1,0
18,35,-17,0,1,1
-53,-35,-18,0,0,0
-22,-14,-8,0,0,0
-30,-33,3,1,0,1
43,27,16,1,0,1
-48,-42,-6,0,0,0
35,30,5,1,0,1
20,26,-6,0,0,0
-29,-21,-8,0,0,0
-40,-32,-8,0,1,1
22,41,-19,0,1,1
-3,10,-13,0,1,1
-8,-7,-1,0,1,1
-16,-31,15,1,1,0
7,-6,13,1,1,0
-24,-42,18,1,1,0
45,30,15,1,1,0
-27,-37,10,1,1,0
-3,-12,9,1,1,0
40,26,14,1,1,0
-15,5,-20,0,1,1
2,6,-4,0,1,1
-20,-22,2,1,1,0
59,43,16,1,1,0
19,17,2,1,1,0
12,7,5,1,1,0
-57,-45,-12,0,1,1
10,26,-16,0,1,1
-11,-9,-2,0,1,1
-20,-11,-9,0,1,1
15,31,-16,0,0,0
2,-14,16,1,0,1
30,28,2,1,0,1
-12,8,-20,0,0,0
-22,-30,8,1,0,1
-18,-24,6,1,0,1
-4,-1,-3,0,0,0
36,37,-1,0,0,0
-11,-20,9,1,0,1
12,6,6,1,0,1
34,18,16,1,1,0
17,32,-15,0,1,1
-13,-22,9,1,1,0
23,14,9,1,1,0
-34,-26,-8,0,1,1
-53,-45,-8,0,1,1
20,7,13,1,1,0
-12,-10,-2,0,1,1
-9,4,-13,0,1,1
6,13,-7,0,1,1
-42,-39,-3,0,0,0
46,29,17,1,0,1
-19,-11,-8,0,0,0
11,21,-10,0,0,0
8,1,7,1,0,1
37,44,-7,0,0,0
44,26,18,1,0,1
9,9,0,0,0,0
-26,-15,-11,0,0,0
-4,-22,18,1,0,1
-42,-42,0,0,0,0
25,18,7,1,0,1
-28,-43,15,1,0,1
-47,-44,-3,0,1,1
-15,-24,9,1,1,0
-28,-28,0,0,1,1
-1,-12,11,1,1,0
-22,-41,19,1,1,0
-11,-3,-8,0,1,1
-16,-7,-9,0,1,1
-37,-33,-4,0,1,1
-5,-17,12,1,1,0
2,-14,16,1,1,0
-27,-29,2,1,1,0
-27,-22,-5,0,1,1
35,25,10,1,1,0
36,38,-2,0,0,0
-22,-41,19,1,0,1
-32,-23,-9,0,0,0
-39,-40,1,1,0,1
-34,-33,-1,0,0,0
30,11,19,1,0,1
25,11,14,1,0,1
23,35,-12,0,0,0
-26,-39,13,1,0,1
10,28,-18,0,0,0
27,31,-4,0,1,1
-7,-24,17,1,1,0
35,17,18,1,1,0
-30,-45,15,1,1,0
46,33,13,1,1,0
17,34,-17,0,1,1
29,29,0,0,1,1
26,20,6,1,1,0
25,30,-5,0,1,1
-1,6,-7,0,1,1
20,40,-20,0,1,1
-8,-11,3,1,1,0
53,43,10,1,1,0
32,40,-8,0,1,1
13,13,0,0,1,1
-8,12,-20,0,1,1
10,-4,14,1,1,0
-49,-43,-6,0,1,1
33,43,-10,0,0,0
-10,2,-12,0,0,0
9,-2,11,1,0,1
26,30,-4,0,0,0
4,18,-14,0,0,0
38,30,8,1,0,1
49,35,14,1,0,1
-9,-13,4,1,0,1
17,32,-15,0,0,0
0,17,-17,0,0,0
9,10,-1,0,0,0
-56,-45,-11,0,1,1
24,37,-13,0,1,1
-25,-29,4,1,1,0
2,11,-9,0,1,1
-54,-43,-11,0,1,1
-13,-32,19,1,1,0
-36,-25,-11,0,1,1
-37,-23,-14,0,1,1
-11,-27,16,1,0,1
-10,-23,13,1,0,1
-4,-22,18,1,0,1
29,21,8,1,0,1
3,0,3,1,0,1
0,-18,18,1,0,1
-23,-35,12,1,0,1
-4,-11,7,1,0,1
43,25,18,1,0,1
-13,-19,6,1,0,1
-18,-9,-9,0,0,0
20,10,10,1,0,1
-51,-39,-12,0,0,0
-14,-23,9,1,0,1
-16,-4,-12,0,0,0
-24,-19,-5,0,0,0
20,5,15,1,0,1
6,26,-20,0,0,0
2,9,-7,0,0,0
45,43,2,1,0,1
16,22,-6,0,1,1
0,1,-1,0,1,1
12,19,-7,0,1,1
-13,-33,20,1,1,0
20,15,5,1,1,0
12,-6,18,1,1,0
-20,-37,17,1,1,0
55,43,12,1,1,0
-23,-39,16,1,1,0
-10,-18,8,1,1,0
41,21,20,1,1,0
28,8,20,1,1,0
12,-5,17,1,1,0
-62,-44,-18,0,1,1
-44,-42,-2,0,1,1
19,8,11,1,0,1
-6,-19,13,1,0,1
-23,-14,-9,0,0,0
-44,-34,-10,0,0,0
54,44,10,1,0,1
23,15,8,1,0,1
-30,-18,-12,0,0,0
-7,-11,4,1,0,1
16,14,2,1,0,1
-28,-9,-19,0,0,0
-42,-26,-16,0,0,0
-7,-6,-1,0,0,0
-45,-38,-7,0,0,0
8,4,4,1,0,1
20,13,7,1,0,1
-11,1,-12,0,0,0
19,34,-15,0,0,0
-28,-37,9,1,1,0
33,22,11,1,1,0
-4,-8,4,1,1,0
-14,-27,13,1,1,0
-50,-45,-5,0,1,1
-40,-44,4,1,1,0
12,26,-14,0,1,1
55,43,12,1,1,0
-29,-30,1,1,1,0
-27,-8,-19,0,1,1
21,33,-12,0,1,1
32,15,17,1,1,0
55,36,19,1,1,0
-19,-38,19,1,1,0
-12,0,-12,0,1,1
20,22,-2,0,1,1
-20,-1,-19,0,1,1
14,4,10,1,1,0
2,-16,18,1,1,0
-5,-16,11,1,1,0
11,16,-5,0,1,1
-52,-33,-19,0,0,0
-42,-23,-19,0,0,0
-24,-40,16,1,0,1
13,32,-19,0,0,0
24,11,13,1,0,1
-32,-27,-5,0,0,0
36,32,4,1,0,1
11,11,0,0,0,0
15,15,0,0,0,0
-31,-26,-5,0,1,1
27,13,14,1,1,0
18,3,15,1,1,0
20,23,-3,0,1,1
30,24,6,1,1,0
-21,-13,-8,0,1,1
-4,12,-16,0,1,1
7,23,-16,0,1,1
-23,-19,-4,0,1,1
-56,-36,-20,0,1,1
30,44,-14,0,1,1
36,18,18,1,1,0
-5,-11,6,1,1,0
39,34,5,1,1,0
-31,-45,14,1,1,0
-8,5,-13,0,1,1
26,40,-14,0,1,1
44,33,11,1,1,0
-10,-18,8,1,1,0
47,39,8,1,1,0
-1,-11,10,1,1,0
33,18,15,1,0,1
-1,15,-16,0,0,0
21,1,20,1,0,1
42,24,18,1,0,1
16,14,2,1,0,1
10,13,-3,0,0,0
-44,-33,-11,0,0,0
-53,-34,-19,0,0,0
-12,8,-20,0,1,1
30,34,-4,0,1,1
51,39,12,1,1,0
-48,-40,-8,0,1,1
19,20,-1,0,1,1
0,8,-8,0,1,1
11,3,8,1,1,0
14,27,-13,0,1,1
33,35,-2,0,1,1
-40,-37,-3,0,1,1
10,30,-20,0,0,0
-21,-33,12,1,0,1
2,-9,11,1,0,1
-56,-38,-18,0,0,0
-56,-37,-19,0,0,0
49,43,6,1,0,1
-5,-20,15,1,0,1
-37,-45,8,1,0,1
9,4,5,1,0,1
-7,0,-7,0,0,0
13,26,-13,0,0,0
37,28,9,1,0,1
33,14,19,1,0,1
-2,12,-14,0,0,0
8,-8,16,1,0,1
53,44,9,1,0,1
-16,-34,18,1,0,1
54,39,15,1,0,1
26,27,-1,0,1,1
26,13,13,1,1,0
-40,-43,3,1,1,0
-26,-6,-20,0,1,1
-11,0,-11,0,1,1
-15,-10,-5,0,1,1
-42,-23,-19,0,1,1
20,3,17,1,1,0
23,37,-14,0,1,1
-21,-24,3,1,1,0
4,4,0,0,1,1
-12,6,-18,0,1,1
30,39,-9,0,1,1
50,35,15,1,0,1
-32,-18,-14,0,0,0
-6,6,-12,0,0,0
26,21,5,1,0,1
-1,1,-2,0,0,0
15,17,-2,0,0,0
-18,-11,-7,0,0,0
-15,-31,16,1,0,1
25,41,-16,0,0,0
-51,-40,-11,0,0,0
11,21,-10,0,0,0
24,17,7,1,0,1
-19,-16,-3,0,1,1
-15,-12,-3,0,1,1
21,11,10,1,1,0
-40,-26,-14,0,1,1
-53,-34,-19,0,1,1
-16,-29,13,1,1,0
-10,-26,16,1,1,0
-9,-23,14,1,1,0
-32,-22,-10,0,1,1
-2,18,-20,0,0,0
3,20,-17,0,0,0
-18,-9,-9,0,0,0
37,26,11,1,0,1
-13,-17,4,1,0,1
19,21,-2,0,0,0
29,14,15,1,0,1
40,32,8,1,0,1
45,44,1,1,0,1
24,40,-16,0,0,0
21,30,-9,0,0,0
7,-2,9,1,0,1
-50,-33,-17,0,0,0
-29,-43,14,1,0,1
-25,-21,-4,0,1,1
-43,-26,-17,0,1,1
27,26,1,1,1,0
-9,-11,2,1,1,0
-23,-33,10,1,1,0
38,27,11,1,1,0
-3,-6,3,1,1,0
32,28,4,1,1,0
12,14,-2,0,1,1
28,17,11,1,1,0
-1,1,-2,0,1,1
21,5,16,1,1,0
-37,-44,7,1,1,0
-33,-16,-17,0,1,1
-57,-37,-20,0,1,1
-44,-31,-13,0,1,1
-29,-19,-10,0,1,1
-58,-43,-15,0,1,1
31,21,10,1,1,0
-8,-1,-7,0,1,1
41,23,18,1,1,0
6,-1,7,1,0,1
-30,-13,-17,0,0,0
-30,-42,12,1,0,1
-45,-35,-10,0,0,0
22,16,6,1,0,1
11,-2,13,1,0,1
-6,-7,1,1,0,1
59,43,16,1,0,1
-37,-20,-17,0,0,0
-17,-28,11,1,0,1
-38,-34,-4,0,0,0
-14,-4,-10,0,0,0
36,36,0,0,0,0
-4,1,-5,0,1,1
-46,-33,-13,0,1,1
56,38,18,1,1,0
41,23,18,1,1,0
24,34,-10,0,1,1
29,17,12,1,1,0
33,17,16,1,1,0
19,29,-10,0,1,1
-11,-20,9,1,1,0
-38,-33,-5,0,1,1
33,21,12,1,0,1
21,19,2,1,0,1
0,14,-14,0,0,0
-12,-2,-10,0,0,0
-2,-2,0,0,0,0
-11,-7,-4,0,0,0
7,15,-8,0,0,0
8,0,8,1,0,1
-35,-15,-20,0,0,0
-33,-21,-12,0,0,0
-1,-9,8,1,0,1
17,32,-15,0,1,1
-29,-20,-9,0,1,1
-26,-32,6,1,1,0
-30,-10,-20,0,1,1
17,21,-4,0,1,1
9,-9,18,1,1,0
28,21,7,1,1,0
-16,0,-16,0,1,1
8,10,-2,0,1,1
37,21,16,1,0,1
5,6,-1,0,0,0
18,27,-9,0,0,0
16,34,-18,0,0,0
-32,-18,-14,0,0,0
-8,3,-11,0,0,0
19,33,-14,0,0,0
-59,-43,-16,0,0,0
37,26,11,1,0,1
32,44,-12,0,0,0
50,37,13,1,0,1
-20,-33,13,1,0,1
-16,-26,10,1,0,1
24,30,-6,0,0,0
30,17,13,1,0,1
29,28,1,1,0,1
-28,-18,-10,0,0,0
26,24,2,1,1,0
26,26,0,0,1,1
-27,-38,11,1,1,0
-19,-38,19,1,1,0
16,-3,19,1,1,0
6,23,-17,0,1,1
-23,-27,4,1,1,0
-14,-30,16,1,1,0
8,24,-16,0,1,1
18,28,-10,0,1,1
12,0,12,1,1,0
8,9,-1,0,1,1
-57,-38,-19,0,1,1
-8,0,-8,0,1,1
-37,-33,-4,0,1,1
-14,-27,13,1,1,0
4,-4,8,1,1,0
40,41,-1,0,1,1
35,42,-7,0,1,1
21,1,20,1,1,0
18,9,9,1,1,0
4,0,4,1,0,1
-16,-19,3,1,0,1
34,14,20,1,0,1
12,5,7,1,0,1
-6,-3,-3,0,0,0
-14,6,-20,0,0,0
43,23,20,1,0,1
9,15,-6,0,0,0
31,36,-5,0,0,0
-27,-14,-13,0,0,0
-29,-37,8,1,0,1
-39,-42,3,1,0,1
25,12,13,1,0,1
-9,-25,16,1,0,1
9,-11,20,1,0,1
-34,-34,0,0,0,0
39,38,1,1,0,1
0,13,-13,0,0,0
-27,-30,3,1,0,1
-46,-43,-3,0,0,0
33,37,-4,0,0,0
54,43,11,1,1,0
-52,-34,-18,0,1,1
4,10,-6,0,1,1
-60,-44,-16,0,1,1
-7,8,-15,0,1,1
26,34,-8,0,1,1
35,25,10,1,1,0
18,9,9,1,1,0
-38,-33,-5,0,0,0
9,23,-14,0,0,0
-52,-32,-20,0,0,0
20,7,13,1,0,1
17,8,9,1,0,1
41,42,-1,0,0,0
40,32,8,1,0,1
-27,-13,-14,0,0,0
14,31,-17,0,0,0
17,37,-20,0,0,0
-12,0,-12,0,0,0
15,-4,19,1,1,0
-35,-27,-8,0,1,1
-39,-25,-14,0,1,1
-31,-36,5,1,1,0
43,31,12,1,1,0
28,25,3,1,1,0
34,20,14,1,1,0
45,34,11,1,1,0
-51,-45,-6,0,1,1
-9,-2,-7,0,1,1
-22,-13,-9,0,1,1
15,14,1,1,1,0
32,32,0,0,1,1
-26,-26,0,0,1,1
-26,-6,-20,0,1,1
48,32,16,1,1,0
-37,-35,-2,0,1,1
9,25,-16,0,0,0
52,44,8,1,0,1
-34,-15,-19,0,0,0
14,19,-5,0,0,0
-37,-22,-15,0,0,0
55,35,20,1,0,1
19,23,-4,0,0,0
-10,3,-13,0,0,0
-5,5,-10,0,0,0
38,24,14,1,0,1
-22,-8,-14,0,0,0
-50,-42,-8,0,1,1
3,0,3,1,1,0
-4,1,-5,0,1,1
1,-17,18,1,1,0
6,26,-20,0,1,1
-44,-25,-19,0,1,1
-58,-38,-20,0,1,1
7,15,-8,0,1,1
-8,7,-15,0,1,1
57,38,19,1,1,0
15,0,15,1,1,0
12,4,8,1,1,0
53,38,15,1,1,0
37,33,4,1,1,0
-14,-31,17,1,1,0
-25,-45,20,1,1,0
23,29,-6,0,1,1
18,27,-9,0,1,1
16,-2,18,1,1,0
-49,-41,-8,0,1,1
-24,-37,13,1,1,0
-35,-37,2,1,0,1
45,39,6,1,0,1
-7,-4,-3,0,0,0
-8,9,-17,0,0,0
-7,-15,8,1,0,1
-17,-19,2,1,0,1
24,16,8,1,0,1
27,20,7,1,0,1
-44,-42,-2,0,1,1
-19,-15,-4,0,1,1
-36,-35,-1,0,1,1
-26,-40,14,1,1,0
-17,0,-17,0,1,1
54,39,15,1,1,0
-6,13,-19,0,1,1
49,36,13,1,1,0
16,1,15,1,1,0
4,16,-12,0,1,1
46,43,3,1,1,0
-25,-15,-10,0,1,1
-16,-15,-1,0,0,0
-22,-11,-11,0,0,0
25,5,20,1,0,1
-14,-28,14,1,0,1
32,17,15,1,0,1
21,17,4,1,0,1
-51,-38,-13,0,0,0
51,32,19,1,0,1
23,13,10,1,0,1
47,34,13,1,0,1
-24,-39,15,1,0,1
-15,3,-18,0,0,0
29,11,18,1,0,1
-59,-40,-19,0,0,0
-17,-12,-5,0,1,1
22,11,11,1,1,0
6,-4,10,1,1,0
7,17,-10,0,1,1
41,28,13,1,1,0
13,8,5,1,1,0
-25,-38,13,1,1,0
-40,-39,-1,0,1,1
17,24,-7,0,0,0
5,8,-3,0,0,0
-14,-28,14,1,0,1
-8,-8,0,0,0,0
19,20,-1,0,0,0
16,31,-15,0,0,0
17,33,-16,0,0,0
9,10,-1,0,0,0
-25,-18,-7,0,0,0
-39,-33,-6,0,1,1
20,17,3,1,1,0
-33,-31,-2,0,1,1
9,-2,11,1,1,0
-26,-30,4,1,1,0
-41,-34,-7,0,1,1
-21,-9,-12,0,1,1
18,8,10,1,1,0
-13,-16,3,1,1,0
-33,-22,-11,0,1,1
19,36,-17,0,1,1
-22,-29,7,1,1,0
-32,-33,1,1,1,0
-43,-34,-9,0,0,0
-30,-27,-3,0,0,0
2,8,-6,0,0,0
-36,-17,-19,0,0,0
-27,-14,-13,0,0,0
41,32,9,1,0,1
25,10,15,1,0,1
-46,-26,-20,0,0,0
-12,-9,-3,0,0,0
-25,-34,9,1,0,1
42,25,17,1,0,1
4,13,-9,0,0,0
37,27,10,1,0,1
25,41,-16,0,0,0
-32,-25,-7,0,0,0
-6,-15,9,1,0,1
41,33,8,1,0,1
-37,-19,-18,0,0,0
-29,-39,10,1,0,1
-18,-27,9,1,0,1
7,19,-12,0,0,0
23,8,15,1,1,0
22,4,18,1,1,0
50,38,12,1,1,0
39,34,5,1,1,0
-26,-29,3,1,1,0
-12,-11,-1,0,1,1
-7,13,-20,0,1,1
-17,-26,9,1,1,0
32,28,4,1,1,0
3,19,-16,0,1,1
26,34,-8,0,1,1
-33,-13,-20,0,1,1
-28,-21,-7,0,1,1
-18,-25,7,1,1,0
9,15,-6,0,1,1
12,14,-2,0,1,1
2,-9,11,1,1,0
-9,3,-12,0,1,1
12,9,3,1,1,0
-52,-40,-12,0,1,1
-51,-38,-13,0,1,1
-28,-14,-14,0,0,0
-27,-11,-16,0,0,0
29,40,-11,0,0,0
21,7,14,1,0,1
43,25,18,1,0,1
-2,10,-12,0,0,0
-30,-29,-1,0,0,0
-27,-25,-2,0,0,0
41,38,3,1,0,1
41,26,15,1,1,0
15,13,2,1,1,0
-27,-17,-10,0,1,1
-44,-37,-7,0,1,1
1,-10,11,1,1,0
-29,-40,11,1,1,0
29,41,-12,0,1,1
27,29,-2,0,1,1
8,1,7,1,1,0
-7,-12,5,1,1,0
21,25,-4,0,1,1
-37,-32,-5,0,1,1
-2,-14,12,1,1,0
19,15,4,1,1,0
-53,-42,-11,0,1,1
54,43,11,1,1,0
-17,-14,-3,0,1,1
-45,-38,-7,0,0,0
-46,-30,-16,0,0,0
-38,-43,5,1,0,1
50,40,10,1,0,1
-11,-13,2,1,0,1
6,7,-1,0,0,0
32,18,14,1,0,1
1,15,-14,0,0,0
36,28,8,1,0,1
-29,-12,-17,0,0,0
21,32,-11,0,0,0
23,3,20,1,0,1
10,1,9,1,0,1
1,0,1,1,0,1
-46,-31,-15,0,0,0
44,36,8,1,0,1
-17,-13,-4,0,0,0
-28,-12,-16,0,0,0
36,25,11,1,0,1
-27,-38,11,1,0,1
11,26,-15,0,0,0
8,5,3,1,1,0
-17,-24,7,1,1,0
-55,-38,-17,0,1,1
-18,-37,19,1,1,0
18,35,-17,0,1,1
11,-4,15,1,1,0
45,27,18,1,1,0
-48,-32,-16,0,1,1
36,31,5,1,1,0
-3,16,-19,0,1,1
22,6,16,1,1,0
20,13,7,1,1,0
-16,-14,-2,0,1,1
-31,-41,10,1,1,0
54,44,10,1,1,0
-33,-20,-13,0,0,0
-22,-11,-11,0,0,0
28,40,-12,0,0,0
-18,-13,-5,0,0,0
-16,-27,11,1,0,1
-3,6,-9,0,0,0
-38,-41,3,1,0,1
-34,-31,-3,0,0,0
-3,-20,17,1,0,1
36,41,-5,0,1,1
-7,11,-18,0,1,1
-22,-32,10,1,1,0
-3,-13,10,1,1,0
-20,-3,-17,0,1,1
50,38,12,1,1,0
25,10,15,1,1,0
34,43,-9,0,1,1
-22,-3,-19,0,1,1
57,42,15,1,1,0
-31,-31,0,0,1,1
-10,-8,-2,0,1,1
28,24,4,1,1,0
9,4,5,1,1,0
2,-4,6,1,1,0
-58,-44,-14,0,1,1
12,-3,15,1,1,0
15,-1,16,1,1,0
-15,-17,2,1,1,0
24,9,15,1,1,0
16,20,-4,0,1,1
-12,-20,8,1,0,1
28,26,2,1,0,1
19,9,10,1,0,1
24,32,-8,0,0,0
-24,-39,15,1,0,1
18,19,-1,0,0,0
47,34,13,1,0,1
-37,-45,8,1,0,1
-24,-24,0,0,0,0
16,20,-4,0,1,1
39,42,-3,0,1,1
-6,5,-11,0,1,1
17,20,-3,0,1,1
12,-3,15,1,1,0
-35,-34,-1,0,1,1
47,40,7,1,1,0
42,33,9,1,1,0
-22,-5,-17,0,1,1
31,17,14,1,1,0
10,30,-20,0,1,1
22,23,-1,0,1,1
-26,-43,17,1,1,0
-7,7,-14,0,1,1
-18,-34,16,1,1,0
16,5,11,1,1,0
4,5,-1,0,1,1
-12,6,-18,0,1,1
-3,9,-12,0,1,1
-11,-23,12,1,0,1
-7,0,-7,0,0,0
18,38,-20,0,0,0
-53,-42,-11,0,0,0
43,38,5,1,0,1
9,-2,11,1,0,1
-43,-41,-2,0,0,0
-38,-27,-11,0,0,0
24,25,-1,0,0,0
-21,-23,2,1,0,1
53,44,9,1,0,1
32,15,17,1,0,1
-21,-31,10,1,0,1
-3,-6,3,1,0,1
-2,18,-20,0,0,0
-32,-42,10,1,0,1
44,33,11,1,0,1
33,23,10,1,0,1
-45,-44,-1,0,0,0
-19,0,-19,0,0,0
30,41,-11,0,0,0
-21,-15,-6,0,1,1
-32,-18,-14,0,1,1
-2,-12,10,1,1,0
5,-1,6,1,1,0
10,18,-8,0,1,1
24,30,-6,0,1,1
29,24,5,1,1,0
-37,-37,0,0,1,1
1,3,-2,0,1,1
-12,-18,6,1,0,1
41,37,4,1,0,1
-40,-32,-8,0,0,0
-34,-29,-5,0,0,0
9,-2,11,1,0,1
-25,-12,-13,0,0,0
-33,-44,11,1,0,1
-32,-25,-7,0,0,0
5,-15,20,1,1,0
-39,-38,-1,0,1,1
19,19,0,0,1,1
-19,-24,5,1,1,0
19,2,17,1,1,0
-56,-44,-12,0,1,1
-31,-28,-3,0,1,1
52,42,10,1,1,0
-7,-6,-1,0,1,1
-29,-42,13,1,1,0
-29,-31,2,1,0,1
22,17,5,1,0,1
-24,-20,-4,0,0,0
17,18,-1,0,0,0
11,26,-15,0,0,0
-3,7,-10,0,0,0
18,35,-17,0,0,0
5,20,-15,0,0,0
42,35,7,1,0,1
-36,-22,-14,0,0,0
8,-11,19,1,0,1
-47,-35,-12,0,0,0
-59,-39,-20,0,0,0
5,17,-12,0,0,0
-40,-36,-4,0,0,0
6,22,-16,0,0,0
-50,-37,-13,0,0,0
-38,-34,-4,0,0,0
8,7,1,1,0,1
-40,-20,-20,0,0,0
-22,-30,8,1,0,1
1,-17,18,1,1,0
-11,-13,2,1,1,0
25,18,7,1,1,0
-33,-35,2,1,1,0
-17,-16,-1,0,1,1
-13,-3,-10,0,1,1
20,12,8,1,1,0
-24,-23,-1,0,1,1
32,17,15,1,1,0
34,32,2,1,1,0
0,0,0,0,1,1
-17,-15,-2,0,1,1
-40,-32,-8,0,1,1
51,38,13,1,1,0
53,42,11,1,1,0
-15,-23,8,1,1,0
-8,-6,-2,0,1,1
11,21,-10,0,1,1
5,6,-1,0,1,1
37,33,4,1,1,0
-7,-4,-3,0,1,1
-33,-37,4,1,0,1
36,17,19,1,0,1
1,-8,9,1,0,1
-18,-2,-16,0,0,0
29,30,-1,0,0,0
24,8,16,1,0,1
27,16,11,1,0,1
16,20,-4,0,0,0
-39,-28,-11,0,0,0
37,31,6,1,0,1
-3,15,-18,0,0,0
2,22,-20,0,0,0
-16,3,-19,0,0,0
0,-11,11,1,0,1
15,31,-16,0,0,0
36,29,7,1,0,1
-15,1,-16,0,0,0
-33,-38,5,1,0,1
22,2,20,1,0,1
-16,-30,14,1,0,1
13,-5,18,1,0,1
-31,-38,7,1,1,0
-14,-3,-11,0,1,1
-16,-34,18,1,1,0
12,-8,20,1,1,0
24,4,20,1,1,0
14,27,-13,0,1,1
-4,-3,-1,0,1,1
11,20,-9,0,1,1
-31,-37,6,1,1,0
35,44,-9,0,1,1
55,35,20,1,0,1
48,35,13,1,0,1
10,28,-18,0,0,0
-46,-32,-14,0,0,0
24,12,12,1,0,1
-20,-2,-18,0,0,0
-16,-13,-3,0,0,0
-21,-12,-9,0,0,0
-10,8,-18,0,0,0
6,-6,12,1,0,1
1,3,-2,0,0,0
47,33,14,1,0,1
-19,-15,-4,0,0,0
-23,-5,-18,0,0,0
-32,-22,-10,0,0,0
-52,-32,-20,0,0,0
-13,-27,14,1,0,1
4,2,2,1,0,1
-8,-7,-1,0,0,0
-13,-32,19,1,0,1
39,35,4,1,0,1
47,34,13,1,1,0
52,36,16,1,1,0
29,26,3,1,1,0
-7,-8,1,1,1,0
2,17,-15,0,1,1
-3,-2,-1,0,1,1
26,34,-8,0,1,1
-20,-33,13,1,1,0
59,43,16,1,1,0
51,41,10,1,1,0
16,28,-12,0,1,1
5,12,-7,0,1,1
-13,3,-16,0,1,1
-25,-21,-4,0,1,1
-15,-13,-2,0,1,1
-32,-28,-4,0,1,1
12,-1,13,1,1,0
16,6,10,1,0,1
-26,-33,7,1,0,1
0,-17,17,1,0,1
57,38,19,1,0,1
9,-6,15,1,0,1
31,29,2,1,0,1
21,22,-1,0,0,0
-36,-39,3,1,0,1
-29,-37,8,1,0,1
12,-1,13,1,0,1
3,-3,6,1,0,1
-47,-27,-20,0,0,0
31,40,-9,0,0,0
25,7,18,1,0,1
-24,-10,-14,0,0,0
46,42,4,1,0,1
-13,5,-18,0,0,0
-7,-11,4,1,0,1
-24,-13,-11,0,0,0
10,24,-14,0,1,1
-31,-45,14,1,1,0
-57,-42,-15,0,1,1
-22,-2,-20,0,1,1
21,34,-13,0,1,1
-30,-10,-20,0,1,1
-43,-43,0,0,1,1
16,22,-6,0,1,1
-35,-37,2,1,1,0
57,40,17,1,1,0
2,-7,9,1,1,0
4,13,-9,0,1,1
-36,-34,-2,0,1,1
27,41,-14,0,1,1
3,15,-12,0,1,1
-41,-45,4,1,1,0
33,17,16,1,1,0
38,31,7,1,1,0
-18,-3,-15,0,1,1
0,-19,19,1,1,0
-31,-33,2,1,1,0
-17,-23,6,1,0,1
28,41,-13,0,0,0
30,40,-10,0,0,0
12,0,12,1,0,1
-44,-26,-18,0,0,0
13,13,0,0,0,0
18,27,-9,0,0,0
5,23,-18,0,0,0
-50,-44,-6,0,0,0
-5,12,-17,0,0,0
-16,-30,14,1,0,1
-29,-11,-18,0,0,0
46,39,7,1,0,1
-33,-31,-2,0,0,0
44,35,9,1,0,1
33,15,18,1,0,1
-14,-28,14,1,0,1
-25,-26,1,1,0,1
11,-6,17,1,0,1
-25,-35,10,1,0,1
20,22,-2,0,1,1
49,42,7,1,1,0
-40,-35,-5,0,1,1
30,28,2,1,1,0
-7,4,-11,0,1,1
-8,6,-14,0,1,1
-20,-10,-10,0,1,1
-26,-28,2,1,1,0
-26,-16,-10,0,0,0
-28,-16,-12,0,0,0
-17,-18,1,1,0,1
10,-10,20,1,0,1
-1,-19,18,1,0,1
-20,-3,-17,0,0,0
1,-2,3,1,0,1
16,36,-20,0,0,0
-30,-13,-17,0,0,0
-37,-33,-4,0,0,0
-1,-18,17,1,0,1
14,9,5,1,0,1
23,10,13,1,0,1
-26,-39,13,1,0,1
1,3,-2,0,0,0
-63,-45,-18,0,0,0
-2,9,-11,0,0,0
-12,-9,-3,0,0,0
-33,-15,-18,0,1,1
50,38,12,1,1,0
54,34,20,1,1,0
4,7,-3,0,1,1
-58,-45,-13,0,1,1
-23,-33,10,1,1,0
-61,-45,-16,0,1,1
-19,-2,-17,0,1,1
-20,-30,10,1,1,0
-4,-13,9,1,1,0
20,11,9,1,1,0
16,-4,20,1,1,0
-56,-38,-18,0,1,1
-1,-3,2,1,1,0
14,14,0,0,1,1
31,27,4,1,1,0
17,-2,19,1,1,0
-13,-27,14,1,1,0
4,20,-16,0,1,1
24,33,-9,0,1,1
15,5,10,1,1,0
-9,-17,8,1,0,1
29,44,-15,0,0,0
-26,-32,6,1,0,1
54,35,19,1,0,1
14,-1,15,1,0,1
-23,-8,-15,0,0,0
-55,-38,-17,0,0,0
-31,-13,-18,0,0,0
12,9,3,1,0,1
-49,-37,-12,0,0,0
-3,0,-3,0,0,0
29,24,5,1,0,1
-2,18,-20,0,0,0
-17,-37,20,1,1,0
32,39,-7,0,1,1
-42,-22,-20,0,1,1
-46,-41,-5,0,1,1
37,37,0,0,1,1
-16,2,-18,0,1,1
15,17,-2,0,1,1
-29,-34,5,1,1,0
-11,0,-11,0,1,1
-39,-40,1,1,0,1
5,-1,6,1,0,1
-9,-19,10,1,0,1
11,10,1,1,0,1
26,12,14,1,0,1
36,21,15,1,0,1
-25,-36,11,1,0,1
-7,10,-17,0,0,0
17,18,-1,0,0,0
32,24,8,1,0,1
-28,-19,-9,0,0,0
32,42,-10,0,1,1
31,18,13,1,1,0
29,21,8,1,1,0
-19,-9,-10,0,1,1
-43,-31,-12,0,1,1
-17,-21,4,1,1,0
9,-1,10,1,1,0
-46,-43,-3,0,1,1
-9,-21,12,1,1,0
-10,-25,15,1,0,1
25,35,-10,0,0,0
4,17,-13,0,0,0
-5,15,-20,0,0,0
23,26,-3,0,0,0
15,23,-8,0,0,0
13,1,12,1,0,1
-17,-26,9,1,0,1
-24,-36,12,1,0,1
-48,-43,-5,0,0,0
-50,-43,-7,0,0,0
-36,-32,-4,0,0,0
-17,-35,18,1,0,1
13,-3,16,1,0,1
13,19,-6,0,0,0
3,-5,8,1,0,1
-11,8,-19,0,1,1
-9,-13,4,1,1,0
-40,-38,-2,0,1,1
18,24,-6,0,1,1
-13,4,-17,0,1,1
-46,-41,-5,0,1,1
-10,6,-16,0,1,1
-23,-17,-6,0,1,1
0,4,-4,0,1,1
-18,-8,-10,0,1,1
-21,-29,8,1,1,0
-24,-37,13,1,0,1
38,30,8,1,0,1
-40,-45,5,1,0,1
-6,-22,16,1,0,1
5,5,0,0,0,0
-28,-45,17,1,0,1
28,19,9,1,0,1
-47,-45,-2,0,0,0
38,36,2,1,0,1
-5,-4,-1,0,0,0
-20,-7,-13,0,0,0
-59,-40,-19,0,0,0
38,35,3,1,0,1
51,37,14,1,0,1
47,40,7,1,0,1
21,20,1,1,0,1
-20,-21,1,1,0,1
-23,-20,-3,0,0,0
40,39,1,1,0,1
32,24,8,1,0,1
-56,-38,-18,0,0,0
28,43,-15,0,1,1
-38,-45,7,1,1,0
35,31,4,1,1,0
41,29,12,1,1,0
-27,-18,-9,0,1,1
36,30,6,1,1,0
11,21,-10,0,1,1
-57,-40,-17,0,1,1
19,31,-12,0,1,1
24,28,-4,0,1,1
-50,-44,-6,0,1,1
1,-4,5,1,1,0
-1,-20,19,1,1,0
-49,-32,-17,0,1,1
-61,-43,-18,0,1,1
6,10,-4,0,1,1
40,22,18,1,1,0
-10,-15,5,1,1,0
-25,-9,-16,0,1,1
30,23,7,1,1,0
-11,-19,8,1,1,0
-29,-42,13,1,0,1
-30,-27,-3,0,0,0
26,34,-8,0,0,0
1,10,-9,0,0,0
15,-1,16,1,0,1
-3,-8,5,1,0,1
9,13,-4,0,0,0
-22,-18,-4,0,0,0
-25,-11,-14,0,1,1
-3,2,-5,0,1,1
-10,-30,20,1,1,0
38,19,19,1,1,0
13,33,-20,0,1,1
31,25,6,1,1,0
-7,-1,-6,0,1,1
-7,-1,-6,0,1,1
22,35,-13,0,1,1
22,25,-3,0,1,1
-41,-21,-20,0,1,1
9,11,-2,0,1,1
41,23,18,1,1,0
-44,-28,-16,0,1,1
-10,-11,1,1,1,0
34,32,2,1,1,0
8,5,3,1,1,0
4,-9,13,1,1,0
-5,-1,-4,0,0,0
-61,-44,-17,0,0,0
-49,-43,-6,0,0,0
-15,-29,14,1,0,1
-32,-41,9,1,0,1
-15,5,-20,0,0,0
17,31,-14,0,0,0
-6,14,-20,0,0,0
14,19,-5,0,0,0
44,36,8,1,0,1
-20,-32,12,1,0,1
35,26,9,1,0,1
-1,5,-6,0,0,0
53,35,18,1,0,1
46,31,15,1,0,1
14,10,4,1,0,1
-12,-4,-8,0,0,0
-18,-15,-3,0,1,1
37,35,2,1,1,0
-55,-40,-15,0,1,1
40,43,-3,0,1,1
54,41,13,1,1,0
-8,-13,5,1,1,0
1,15,-14,0,1,1
45,42,3,1,1,0
-29,-19,-10,0,0,0
-24,-22,-2,0,0,0
-22,-4,-18,0,0,0
-3,-16,13,1,0,1
-17,-29,12,1,0,1
23,20,3,1,0,1
-31,-34,3,1,0,1
-27,-44,17,1,0,1
45,34,11,1,1,0
23,21,2,1,1,0
4,7,-3,0,1,1
22,18,4,1,1,0
29,28,1,1,1,0
-33,-31,-2,0,1,1
31,28,3,1,1,0
31,12,19,1,1,0
-6,14,-20,0,1,1
-1,-15,14,1,1,0
-18,-33,15,1,1,0
14,30,-16,0,1,1
33,44,-11,0,0,0
55,38,17,1,0,1
0,10,-10,0,0,0
-11,-15,4,1,0,1
-21,-38,17,1,0,1
-22,-25,3,1,0,1
12,13,-1,0,0,0
-21,-21,0,0,0,0
-6,-15,9,1,0,1
44,33,11,1,0,1
18,8,10,1,0,1
-38,-36,-2,0,0,0
-3,12,-15,0,0,0
24,33,-9,0,0,0
-59,-43,-16,0,0,0
-45,-45,0,0,1,1
51,31,20,1,1,0
-10,-26,16,1,1,0
-45,-44,-1,0,1,1
-44,-38,-6,0,1,1
14,6,8,1,1,0
-17,-24,7,1,1,0
23,36,-13,0,1,1
-15,-24,9,1,1,0
-15,-1,-14,0,1,1
-3,-5,2,1,1,0
-53,-36,-17,0,1,1
-26,-24,-2,0,1,1
31,15,16,1,1,0
-19,-8,-11,0,1,1
23,30,-7,0,1,1
35,34,1,1,1,0
14,0,14,1,1,0
7,14,-7,0,1,1
3,10,-7,0,1,1
-48,-34,-14,0,1,1
-31,-11,-20,0,0,0
-33,-13,-20,0,0,0
4,11,-7,0,0,0
-42,-44,2,1,0,1
3,-8,11,1,0,1
2,0,2,1,0,1
38,36,2,1,0,1
-10,-2,-8,0,0,0
29,28,1,1,0,1
-17,-15,-2,0,1,1
24,36,-12,0,1,1
30,35,-5,0,1,1
-33,-36,3,1,1,0
31,23,8,1,1,0
-16,1,-17,0,1,1
-24,-27,3,1,1,0
-33,-17,-16,0,1,1
17,11,6,1,1,0
5,-1,6,1,1,0
45,35,10,1,1,0
-54,-35,-19,0,1,1
27,30,-3,0,1,1
35,38,-3,0,1,1
7,17,-10,0,0,0
4,19,-15,0,0,0
-49,-30,-19,0,0,0
8,-3,11,1,0,1
-39,-31,-8,0,0,0
-2,-4,2,1,0,1
36,17,19,1,0,1
-20,-7,-13,0,0,0
5,-7,12,1,0,1
0,-18,18,1,0,1
-35,-20,-15,0,0,0
47,28,19,1,0,1
56,44,12,1,0,1
-27,-7,-20,0,0,0
39,41,-2,0,0,0
-38,-41,3,1,0,1
-13,-32,19,1,0,1
-8,-24,16,1,0,1
-21,-41,20,1,0,1
13,16,-3,0,0,0
-9,-13,4,1,0,1
-49,-36,-13,0,1,1
29,23,6,1,1,0
57,41,16,1,1,0
-57,-45,-12,0,1,1
-22,-39,17,1,1,0
-17,-6,-11,0,1,1
-19,-5,-14,0,1,1
21,10,11,1,1,0
-10,9,-19,0,1,1
14,13,1,1,1,0
-26,-16,-10,0,1,1
35,21,14,1,1,0
-23,-39,16,1,1,0
-29,-10,-19,0,1,1
-3,15,-18,0,0,0
-22,-5,-17,0,0,0
9,22,-13,0,0,0
-28,-8,-20,0,0,0
-30,-10,-20,0,0,0
24,40,-16,0,0,0
-33,-18,-15,0,0,0
8,24,-16,0,0,0
-49,-31,-18,0,0,0
-43,-38,-5,0,0,0
-3,-18,15,1,0,1
-20,-14,-6,0,0,0
-35,-26,-9,0,0,0
-17,-32,15,1,0,1
1,-8,9,1,0,1
23,35,-12,0,0,0
37,26,11,1,0,1
-9,-15,6,1,0,1
2,8,-6,0,0,0
28,42,-14,0,0,0
33,30,3,1,0,1
22,41,-19,0,1,1
-22,-39,17,1,1,0
19,17,2,1,1,0
17,34,-17,0,1,1
3,4,-1,0,1,1
12,3,9,1,1,0
-51,-45,-6,0,1,1
-30,-40,10,1,1,0
-4,-3,-1,0,1,1
35,21,14,1,1,0
37,43,-6,0,1,1
-17,-17,0,0,1,1
-16,-22,6,1,1,0
28,28,0,0,1,1
-25,-29,4,1,1,0
-29,-41,12,1,1,0
38,41,-3,0,0,0
33,29,4,1,0,1
19,16,3,1,0,1
-15,2,-17,0,0,0
-24,-39,15,1,0,1
-44,-37,-7,0,0,0
43,31,12,1,0,1
-41,-31,-10,0,0,0
-22,-4,-18,0,0,0
34,37,-3,0,0,0
-7,-12,5,1,0,1
-53,-44,-9,0,0,0
-33,-33,0,0,0,0
-38,-40,2,1,0,1
10,0,10,1,0,1
28,21,7,1,0,1
5,-4,9,1,0,1
-20,-2,-18,0,0,0
-54,-43,-11,0,0,0
-12,-23,11,1,0,1
-61,-42,-19,0,0,0
6,7,-1,0,1,1
-4,-8,4,1,1,0
40,33,7,1,1,0
58,38,20,1,1,0
18,6,12,1,1,0
-13,-4,-9,0,1,1
27,16,11,1,1,0
44,32,12,1,1,0
-43,-26,-17,0,1,1
-18,-1,-17,0,1,1
-5,9,-14,0,1,1
-17,-11,-6,0,1,1
3,6,-3,0,1,1
-13,-2,-11,0,1,1
-44,-33,-11,0,1,1
24,31,-7,0,1,1
-1,4,-5,0,1,1
-26,-11,-15,0,1,1
7,-13,20,1,1,0
11,18,-7,0,1,1
16,35,-19,0,1,1
4,0,4,1,0,1
44,36,8,1,0,1
29,16,13,1,0,1
-56,-45,-11,0,0,0
34,42,-8,0,0,0
-27,-11,-16,0,0,0
-17,-22,5,1,0,1
-26,-36,10,1,0,1
43,41,2,1,0,1
4,-15,19,1,0,1
-35,-25,-10,0,0,0
-29,-43,14,1,1,0
18,2,16,1,1,0
-10,9,-19,0,1,1
-23,-34,11,1,1,0
3,14,-11,0,1,1
-6,-23,17,1,1,0
-44,-34,-10,0,1,1
36,19,17,1,1,0
23,32,-9,0,1,1
-9,-3,-6,0,0,0
-1,-14,13,1,0,1
24,41,-17,0,0,0
60,43,17,1,0,1
6,6,0,0,0,0
28,42,-14,0,0,0
-5,-19,14,1,0,1
-29,-45,16,1,0,1
21,20,1,1,0,1
10,23,-13,0,0,0
-38,-34,-4,0,1,1
-24,-6,-18,0,1,1
13,15,-2,0,1,1
-34,-41,7,1,1,0
6,-7,13,1,1,0
21,8,13,1,1,0
-16,-32,16,1,1,0
46,35,11,1,1,0
30,14,16,1,1,0
-42,-41,-1,0,0,0
-1,4,-5,0,0,0
37,31,6,1,0,1
-26,-33,7,1,0,1
-26,-37,11,1,0,1
40,40,0,0,0,0
-28,-35,7,1,0,1
-12,7,-19,0,0,0
-25,-9,-16,0,0,0
-26,-12,-14,0,0,0
-26,-33,7,1,0,1
36,22,14,1,0,1
6,20,-14,0,0,0
28,30,-2,0,0,0
19,27,-8,0,0,0
17,4,13,1,0,1
-36,-32,-4,0,0,0
50,34,16,1,0,1
-55,-36,-19,0,0,0
-33,-36,3,1,0,1
-8,-3,-5,0,0,0
-9,-8,-1,0,1,1
22,7,15,1,1,0
16,-3,19,1,1,0
5,-2,7,1,1,0
16,1,15,1,1,0
34,21,13,1,1,0
29,39,-10,0,1,1
-58,-41,-17,0,1,1
15,33,-18,0,1,1
-36,-36,0,0,1,1
56,42,14,1,0,1
-33,-42,9,1,0,1
-31,-32,1,1,0,1
62,42,20,1,0,1
31,29,2,1,0,1
-14,-34,20,1,0,1
7,4,3,1,0,1
-27,-33,6,1,0,1
11,16,-5,0,0,0
-3,-19,16,1,0,1
39,35,4,1,0,1
-55,-37,-18,0,0,0
46,39,7,1,0,1
-36,-41,5,1,0,1
19,16,3,1,0,1
-33,-20,-13,0,0,0
36,30,6,1,0,1
-3,5,-8,0,0,0
-47,-31,-16,0,0,0
0,3,-3,0,0,0
32,34,-2,0,0,0
-23,-33,10,1,1,0
22,18,4,1,1,0
-23,-14,-9,0,1,1
-47,-45,-2,0,1,1
47,28,19,1,1,0
56,42,14,1,1,0
-7,-21,14,1,1,0
-46,-43,-3,0,1,1
8,16,-8,0,0,0
-53,-33,-20,0,0,0
1,17,-16,0,0,0
55,43,12,1,0,1
6,-7,13,1,0,1
-1,12,-13,0,0,0
-6,-13,7,1,0,1
-20,-39,19,1,0,1
32,32,0,0,0,0
-46,-36,-10,0,0,0
11,-4,15,1,0,1
-11,-18,7,1,0,1
12,8,4,1,0,1
-53,-40,-13,0,0,0
22,38,-16,0,0,0
15,11,4,1,0,1
-15,-18,3,1,0,1
-9,-2,-7,0,0,0
20,35,-15,0,0,0
-3,-12,9,1,0,1
-11,-17,6,1,0,1
2,-15,17,1,1,0
-51,-43,-8,0,1,1
33,31,2,1,1,0
16,21,-5,0,1,1
37,41,-4,0,1,1
-39,-27,-12,0,1,1
2,-3,5,1,1,0
-14,-21,7,1,1,0
-18,-23,5,1,0,1
-17,-8,-9,0,0,0
22,38,-16,0,0,0
-28,-35,7,1,0,1
-16,-14,-2,0,0,0
22,41,-19,0,0,0
6,9,-3,0,0,0
38,44,-6,0,0,0
-12,-10,-2,0,1,1
4,-14,18,1,1,0
-37,-37,0,0,1,1
-58,-45,-13,0,1,1
-12,-32,20,1,1,0
14,25,-11,0,1,1
-1,-5,4,1,1,0
-51,-42,-9,0,1,1
41,35,6,1,1,0
-14,-6,-8,0,1,1
-6,-3,-3,0,1,1
12,6,6,1,1,0
17,30,-13,0,1,1
0,17,-17,0,1,1
33,18,15,1,1,0
32,19,13,1,1,0
16,17,-1,0,1,1
-42,-43,1,1,1,0
-29,-42,13,1,1,0
-32,-45,13,1,1,0
-29,-28,-1,0,1,1
-7,-24,17,1,0,1
4,22,-18,0,0,0
-33,-43,10,1,0,1
14,-3,17,1,0,1
-40,-38,-2,0,0,0
-34,-21,-13,0,0,0
28,12,16,1,0,1
-43,-45,2,1,0,1
36,22,14,1,0,1
-12,4,-16,0,0,0
2,13,-11,0,0,0
-54,-39,-15,0,0,0
13,5,8,1,0,1
-14,-1,-13,0,0,0
-42,-43,1,1,0,1
-64,-45,-19,0,0,0
-41,-21,-20,0,0,0
-22,-26,4,1,0,1
30,27,3,1,0,1
-4,-1,-3,0,0,0
-26,-18,-8,0,0,0
12,23,-11,0,1,1
14,20,-6,0,1,1
19,22,-3,0,1,1
41,35,6,1,1,0
-3,7,-10,0,1,1
28,34,-6,0,1,1
-11,-13,2,1,1,0
10,4,6,1,1,0
-31,-22,-9,0,1,1
36,31,5,1,1,0
9,21,-12,0,1,1
-5,-22,17,1,1,0
34,41,-7,0,1,1
21,35,-14,0,1,1
33,15,18,1,1,0
-28,-45,17,1,1,0
7,18,-11,0,1,1
-3,12,-15,0,1,1
23,17,6,1,1,0
-33,-37,4,1,1,0
-12,-14,2,1,1,0
-32,-45,13,1,0,1
19,17,2,1,0,1
42,40,2,1,0,1
-58,-44,-14,0,0,0
-27,-32,5,1,0,1
-18,-17,-1,0,0,0
-57,-44,-13,0,0,0
18,26,-8,0,0,0
-34,-42,8,1,0,1
20,25,-5,0,1,1
-10,-3,-7,0,1,1
-53,-39,-14,0,1,1
15,24,-9,0,1,1
54,42,12,1,1,0
9,3,6,1,1,0
-27,-19,-8,0,1,1
-7,7,-14,0,1,1
-3,-9,6,1,1,0
-9,-23,14,1,1,0
-17,-21,4,1,0,1
22,27,-5,0,0,0
41,44,-3,0,0,0
-23,-27,4,1,0,1
-54,-34,-20,0,0,0
-28,-12,-16,0,0,0
43,36,7,1,0,1
-1,0,-1,0,0,0
39,25,14,1,0,1
47,30,17,1,0,1
16,28,-12,0,0,0
-9,5,-14,0,0,0
-14,0,-14,0,0,0
-17,-10,-7,0,0,0
-7,9,-16,0,0,0
20,27,-7,0,0,0
-6,3,-9,0,0,0
8,23,-15,0,0,0
28,20,8,1,0,1
0,7,-7,0,0,0
-1,12,-13,0,0,0
-39,-40,1,1,1,0
11,27,-16,0,1,1
31,43,-12,0,1,1
-39,-37,-2,0,1,1
46,38,8,1,1,0
0,-9,9,1,1,0
-53,-39,-14,0,1,1
28,14,14,1,1,0
23,31,-8,0,0,0
11,12,-1,0,0,0
15,32,-17,0,0,0
0,5,-5,0,0,0
8,9,-1,0,0,0
-13,-2,-11,0,0,0
-35,-31,-4,0,0,0
-24,-18,-6,0,0,0
-28,-16,-12,0,0,0
-13,-18,5,1,0,1
39,28,11,1,0,1
17,-3,20,1,0,1
45,40,5,1,0,1
-16,-15,-1,0,0,0
48,29,19,1,0,1
-14,-28,14,1,0,1
-34,-41,7,1,0,1
12,0,12,1,0,1
-46,-34,-12,0,0,0
-55,-43,-12,0,0,0
29,12,17,1,0,1
-5,4,-9,0,1,1
9,-1,10,1,1,0
23,22,1,1,1,0
-13,2,-15,0,1,1
36,19,17,1,1,0
11,-2,13,1,1,0
25,13,12,1,1,0
41,34,7,1,1,0
4,0,4,1,1,0
54,36,18,1,1,0
-31,-38,7,1,1,0
30,23,7,1,1,0
-43,-32,-11,0,1,1
34,42,-8,0,1,1
27,17,10,1,1,0
-32,-39,7,1,1,0
2,-1,3,1,1,0
-35,-25,-10,0,1,1
40,42,-2,0,0,0
23,34,-11,0,0,0
8,2,6,1,0,1
-10,-5,-5,0,0,0
-34,-36,2,1,0,1
-41,-41,0,0,0,0
-43,-45,2,1,0,1
27,16,11,1,0,1
24,36,-12,0,0,0
-40,-42,2,1,0,1
25,38,-13,0,0,0
-3,-7,4,1,0,1
-33,-37,4,1,0,1
35,24,11,1,0,1
28,23,5,1,0,1
-9,-21,12,1,0,1
6,2,4,1,0,1
9,25,-16,0,0,0
-48,-29,-19,0,0,0
-35,-17,-18,0,0,0
-9,-20,11,1,0,1
-21,-15,-6,0,1,1
40,32,8,1,1,0
-16,-28,12,1,1,0
1,2,-1,0,1,1
9,1,8,1,1,0
-2,18,-20,0,1,1
15,5,10,1,1,0
-19,-21,2,1,1,0
2,12,-10,0,1,1
46,34,12,1,1,0
5,-7,12,1,1,0
-21,-19,-2,0,1,1
-30,-42,12,1,1,0
41,24,17,1,1,0
-38,-43,5,1,1,0
-55,-39,-16,0,1,1
28,9,19,1,1,0
-11,-30,19,1,1,0
36,41,-5,0,1,1
35,25,10,1,1,0
16,14,2,1,1,0
-9,-7,-2,0,0,0
-33,-42,9,1,0,1
20,10,10,1,0,1
-2,-7,5,1,0,1
0,-16,16,1,0,1
47,29,18,1,0,1
29,21,8,1,0,1
50,30,20,1,0,1
24,15,9,1,0,1
20,39,-19,0,0,0
-56,-44,-12,0,0,0
-9,-9,0,0,0,0
-19,-34,15,1,0,1
-47,-38,-9,0,0,0
-22,-9,-13,0,0,0
-12,-2,-10,0,1,1
21,25,-4,0,1,1
-14,-28,14,1,1,0
-15,1,-16,0,1,1
10,22,-12,0,1,1
-16,-15,-1,0,1,1
16,15,1,1,1,0
29,18,11,1,1,0
-48,-36,-12,0,1,1
9,11,-2,0,1,1
19,27,-8,0,1,1
-35,-26,-9,0,1,1
21,30,-9,0,1,1
-46,-31,-15,0,1,1
-30,-34,4,1,1,0
17,31,-14,0,1,1
48,32,16,1,1,0
3,-6,9,1,1,0
23,6,17,1,1,0
21,28,-7,0,1,1
-4,-17,13,1,1,0
-16,-33,17,1,0,1
-36,-29,-7,0,0,0
37,18,19,1,0,1
-18,-7,-11,0,0,0
13,22,-9,0,0,0
18,28,-10,0,0,0
41,34,7,1,0,1
0,0,0,0,0,0
-11,-11,0,0,0,0
3,23,-20,0,0,0
-12,2,-14,0,0,0
37,40,-3,0,0,0
0,-19,19,1,0,1
37,24,13,1,0,1
-15,-1,-14,0,0,0
-6,-9,3,1,0,1
-17,-29,12,1,0,1
38,23,15,1,0,1
2,1,1,1,0,1
24,14,10,1,0,1
8,18,-10,0,0,0
13,24,-11,0,1,1
33,30,3,1,1,0
-9,-13,4,1,1,0
33,33,0,0,1,1
-52,-37,-15,0,1,1
21,37,-16,0,1,1
-23,-41,18,1,1,0
16,20,-4,0,1,1
-11,-7,-4,0,0,0
16,28,-12,0,0,0
-16,-29,13,1,0,1
-23,-7,-16,0,0,0
22,33,-11,0,0,0
34,21,13,1,0,1
-20,-37,17,1,0,1
-8,-20,12,1,0,1
-28,-40,12,1,0,1
7,-13,20,1,0,1
26,30,-4,0,0,0
-29,-17,-12,0,1,1
7,-7,14,1,1,0
-24,-27,3,1,1,0
-27,-30,3,1,1,0
19,28,-9,0,1,1
-24,-39,15,1,1,0
-1,-4,3,1,1,0
46,40,6,1,1,0
7,9,-2,0,0,0
8,12,-4,0,0,0
-29,-11,-18,0,0,0
-30,-31,1,1,0,1
29,41,-12,0,0,0
-31,-44,13,1,0,1
24,27,-3,0,0,0
29,30,-1,0,0,0
17,4,13,1,0,1
29,37,-8,0,0,0
-23,-6,-17,0,0,0
-17,-20,3,1,0,1
-11,-19,8,1,0,1
31,24,7,1,0,1
10,-8,18,1,0,1
-9,-15,6,1,1,0
-16,-3,-13,0,1,1
41,37,4,1,1,0
-18,-1,-17,0,1,1
20,14,6,1,1,0
-17,-3,-14,0,1,1
-10,0,-10,0,1,1
-15,-20,5,1,1,0
31,19,12,1,1,0
25,20,5,1,1,0
-35,-40,5,1,1,0
48,31,17,1,1,0
-15,-22,7,1,1,0
-23,-34,11,1,1,0
-53,-43,-10,0,1,1
7,25,-18,0,1,1
32,13,19,1,1,0
19,36,-17,0,1,1
-41,-21,-20,0,1,1
21,26,-5,0,1,1
29,13,16,1,1,0
-18,-11,-7,0,0,0
-13,3,-16,0,0,0
-21,-17,-4,0,0,0
37,37,0,0,0,0
35,26,9,1,0,1
11,11,0,0,0,0
6,6,0,0,0,0
-33,-40,7,1,0,1
-1,13,-14,0,0,0
58,40,18,1,0,1
47,28,19,1,0,1
38,28,10,1,0,1
14,23,-9,0,0,0
-28,-25,-3,0,0,0
23,13,10,1,0,1
20,6,14,1,0,1
-42,-41,-1,0,0,0
15,15,0,0,0,0
-28,-31,3,1,0,1
-20,-9,-11,0,0,0
4,20,-16,0,0,0
27,25,2,1,1,0
-26,-28,2,1,1,0
-19,-36,17,1,1,0
2,20,-18,0,1,1
-16,-29,13,1,1,0
10,8,2,1,1,0
39,35,4,1,1,0
12,30,-18,0,1,1
-40,-45,5,1,1,0
9,28,-19,0,1,1
-18,-33,15,1,0,1
-39,-21,-18,0,0,0
25,14,11,1,0,1
51,32,19,1,0,1
38,31,7,1,0,1
-34,-15,-19,0,0,0
-23,-6,-17,0,0,0
2,-15,17,1,0,1
45,39,6,1,0,1
-28,-28,0,0,0,0
2,-7,9,1,0,1
-51,-42,-9,0,0,0
8,24,-16,0,0,0
-18,-3,-15,0,0,0
-7,-7,0,0,0,0
5,7,-2,0,0,0
-24,-22,-2,0,0,0
-6,-21,15,1,0,1
7,10,-3,0,0,0
11,15,-4,0,0,0
-18,2,-20,0,0,0
8,3,5,1,1,0
-24,-25,1,1,1,0
17,13,4,1,1,0
4,-4,8,1,1,0
-18,-38,20,1,1,0
-35,-29,-6,0,1,1
15,3,12,1,1,0
28,14,14,1,1,0
41,43,-2,0,1,1
-5,7,-12,0,1,1
-14,-2,-12,0,1,1
37,24,13,1,1,0
12,20,-8,0,1,1
24,30,-6,0,1,1
5,20,-15,0,1,1
-41,-35,-6,0,1,1
-7,12,-19,0,1,1
11,17,-6,0,1,1
-18,-11,-7,0,1,1
-14,-34,20,1,1,0
42,39,3,1,1,0
-29,-21,-8,0,0,0
-25,-36,11,1,0,1
-8,-28,20,1,0,1
-19,-34,15,1,0,1
-52,-41,-11,0,0,0
23,42,-19,0,0,0
-35,-21,-14,0,0,0
-27,-37,10,1,0,1
-4,0,-4,0,0,0
57,43,14,1,0,1
34,22,12,1,0,1
18,29,-11,0,0,0
24,10,14,1,0,1
-21,-20,-1,0,0,0
-31,-42,11,1,0,1
9,3,6,1,0,1
35,19,16,1,0,1
13,28,-15,0,0,0
-17,-26,9,1,0,1
49,35,14,1,1,0
-15,-23,8,1,1,0
-5,-25,20,1,1,0
-27,-11,-16,0,1,1
31,16,15,1,1,0
-16,-13,-3,0,1,1
24,32,-8,0,1,1
-2,3,-5,0,1,1
-42,-29,-13,0,1,1
23,4,19,1,1,0
-1,11,-12,0,1,1
9,1,8,1,1,0
37,23,14,1,1,0
42,37,5,1,1,0
22,25,-3,0,1,1
39,36,3,1,1,0
31,21,10,1,1,0
-55,-40,-15,0,1,1
1,-8,9,1,1,0
5,-2,7,1,1,0
23,15,8,1,1,0
23,40,-17,0,0,0
42,41,1,1,0,1
-31,-32,1,1,0,1
-32,-26,-6,0,0,0
31,36,-5,0,0,0
33,13,20,1,0,1
-10,-22,12,1,0,1
-45,-31,-14,0,0,0
31,23,8,1,0,1
17,35,-18,0,0,0
-5,5,-10,0,0,0
-34,-29,-5,0,0,0
-38,-20,-18,0,1,1
-50,-34,-16,0,1,1
-20,-14,-6,0,1,1
-39,-21,-18,0,1,1
18,37,-19,0,1,1
31,30,1,1,1,0
53,38,15,1,1,0
18,27,-9,0,1,1
-24,-22,-2,0,1,1
18,11,7,1,0,1
-8,-14,6,1,0,1
7,27,-20,0,0,0
-17,-30,13,1,0,1
-29,-44,15,1,0,1
2,3,-1,0,0,0
-43,-27,-16,0,0,0
3,13,-10,0,0,0
51,33,18,1,0,1
7,25,-18,0,0,0
-28,-32,4,1,0,1
-4,-24,20,1,0,1
-23,-38,15,1,0,1
-30,-22,-8,0,0,0
-10,9,-19,0,0,0
-28,-26,-2,0,0,0
-42,-24,-18,0,0,0
-18,-2,-16,0,0,0
63,43,20,1,0,1
31,38,-7,0,0,0
23,14,9,1,1,0
22,27,-5,0,1,1
24,13,11,1,1,0
-31,-31,0,0,1,1
-10,-28,18,1,1,0
-16,-28,12,1,1,0
16,29,-13,0,1,1
-13,3,-16,0,1,1
37,21,16,1,1,0
-1,-10,9,1,1,0
34,36,-2,0,1,1
-27,-21,-6,0,1,1
-50,-31,-19,0,1,1
-38,-37,-1,0,1,1
9,21,-12,0,0,0
-42,-37,-5,0,0,0
-44,-44,0,0,0,0
-22,-23,1,1,0,1
-16,-25,9,1,0,1
-4,-21,17,1,0,1
-63,-43,-20,0,0,0
52,36,16,1,0,1
24,22,2,1,0,1
-50,-40,-10,0,0,0
-20,-23,3,1,1,0
34,41,-7,0,1,1
-12,-2,-10,0,1,1
16,3,13,1,1,0
-12,-15,3,1,1,0
0,-11,11,1,1,0
23,38,-15,0,1,1
38,40,-2,0,1,1
-30,-28,-2,0,1,1
16,15,1,1,1,0
14,2,12,1,1,0
16,2,14,1,1,0
5,-12,17,1,1,0
-53,-44,-9,0,1,1
-20,-40,20,1,1,0
13,0,13,1,1,0
13,5,8,1,1,0
-32,-17,-15,0,1,1
28,17,11,1,1,0
-1,-20,19,1,0,1
-57,-38,-19,0,0,0
9,-7,16,1,0,1
-22,-31,9,1,0,1
-30,-14,-16,0,0,0
42,39,3,1,0,1
8,9,-1,0,0,0
53,40,13,1,0,1
-30,-39,9,1,0,1
58,42,16,1,0,1
-34,-41,7,1,0,1
17,-1,18,1,0,1
-58,-44,-14,0,0,0
0,-5,5,1,0,1
-52,-35,-17,0,0,0
-16,-30,14,1,0,1
-2,18,-20,0,0,0
35,21,14,1,0,1
-4,10,-14,0,0,0
-56,-43,-13,0,0,0
-33,-32,-1,0,0,0
7,26,-19,0,1,1
3,4,-1,0,1,1
-35,-36,1,1,1,0
5,-10,15,1,1,0
-36,-38,2,1,1,0
-17,-29,12,1,1,0
12,18,-6,0,1,1
27,17,10,1,1,0
-11,5,-16,0,1,1
-26,-30,4,1,0,1
1,-17,18,1,0,1
-2,6,-8,0,0,0
36,41,-5,0,0,0
-53,-42,-11,0,0,0
-27,-44,17,1,0,1
19,39,-20,0,0,0
-40,-25,-15,0,0,0
-30,-11,-19,0,0,0
1,0,1,1,0,1
-39,-26,-13,0,0,0
-5,-24,19,1,0,1
14,-4,18,1,0,1
54,40,14,1,0,1
-20,-34,14,1,0,1
4,13,-9,0,0,0
-14,6,-20,0,1,1
35,38,-3,0,1,1
-20,-36,16,1,1,0
-23,-12,-11,0,1,1
-18,-18,0,0,1,1
18,24,-6,0,1,1
39,43,-4,0,1,1
-3,7,-10,0,1,1
-50,-35,-15,0,1,1
22,25,-3,0,1,1
-35,-19,-16,0,1,1
13,13,0,0,1,1
16,21,-5,0,1,1
28,26,2,1,1,0
-53,-43,-10,0,1,1
13,33,-20,0,1,1
55,40,15,1,1,0
-9,-13,4,1,1,0
-14,5,-19,0,1,1
-27,-39,12,1,1,0
51,44,7,1,1,0
-3,16,-19,0,0,0
0,-17,17,1,0,1
-52,-43,-9,0,0,0
20,9,11,1,0,1
-23,-18,-5,0,0,0
36,26,10,1,0,1
28,24,4,1,0,1
-13,-3,-10,0,0,0
36,41,-5,0,0,0
53,43,10,1,0,1
-13,-27,14,1,0,1
18,5,13,1,1,0
-54,-42,-12,0,1,1
-18,-4,-14,0,1,1
17,28,-11,0,1,1
-11,-9,-2,0,1,1
-4,16,-20,0,1,1
-23,-24,1,1,1,0
17,15,2,1,1,0
-47,-43,-4,0,1,1
-19,-13,-6,0,1,1
-23,-36,13,1,1,0
21,5,16,1,1,0
-26,-18,-8,0,1,1
-4,-18,14,1,0,1
-7,-5,-2,0,0,0
36,17,19,1,0,1
39,22,17,1,0,1
29,26,3,1,0,1
-2,-12,10,1,0,1
-35,-42,7,1,0,1
-12,-23,11,1,0,1
30,22,8,1,0,1
-9,-21,12,1,0,1
-24,-24,0,0,0,0
-25,-6,-19,0,1,1
-17,-22,5,1,1,0
41,36,5,1,1,0
-34,-37,3,1,1,0
-45,-31,-14,0,1,1
-13,-29,16,1,1,0
-24,-31,7,1,1,0
-50,-31,-19,0,1,1
24,39,-15,0,1,1
-30,-12,-18,0,1,1
-6,11,-17,0,0,0
33,44,-11,0,0,0
-3,9,-12,0,0,0
12,27,-15,0,0,0
-30,-19,-11,0,0,0
-19,-10,-9,0,0,0
37,27,10,1,0,1
38,41,-3,0,0,0
43,26,17,1,0,1
25,11,14,1,0,1
2,19,-17,0,0,0
38,39,-1,0,0,0
24,22,2,1,1,0
-36,-32,-4,0,1,1
24,43,-19,0,1,1
-19,-29,10,1,1,0
9,-7,16,1,1,0
-28,-20,-8,0,1,1
-8,-27,19,1,1,0
-63,-43,-20,0,1,1
-30,-38,8,1,1,0
-16,-15,-1,0,1,1
-6,3,-9,0,0,0
-38,-22,-16,0,0,0
-9,-27,18,1,0,1
19,0,19,1,0,1
53,37,16,1,0,1
25,10,15,1,0,1
-15,-10,-5,0,0,0
20,19,1,1,0,1
-4,15,-19,0,1,1
20,26,-6,0,1,1
12,11,1,1,1,0
37,43,-6,0,1,1
59,44,15,1,1,0
-34,-23,-11,0,1,1
-20,-17,-3,0,1,1
49,36,13,1,1,0
-39,-19,-20,0,1,1
8,26,-18,0,1,1
-40,-40,0,0,1,1
-47,-39,-8,0,1,1
-2,-17,15,1,1,0
-6,-4,-2,0,1,1
33,28,5,1,1,0
-14,-6,-8,0,1,1
-52,-42,-10,0,1,1
-25,-26,1,1,1,0
3,17,-14,0,1,1
-38,-31,-7,0,1,1
2,7,-5,0,1,1
8,20,-12,0,0,0
10,7,3,1,0,1
1,5,-4,0,0,0
-9,-26,17,1,0,1
52,37,15,1,0,1
7,15,-8,0,0,0
20,28,-8,0,0,0
-19,-7,-12,0,0,0
38,43,-5,0,0,0
-46,-45,-1,0,0,0
-17,-16,-1,0,0,0
22,14,8,1,0,1
-48,-29,-19,0,0,0
18,32,-14,0,0,0
-10,-30,20,1,0,1
-19,-33,14,1,0,1
2,-8,10,1,0,1
-22,-6,-16,0,0,0
-25,-34,9,1,0,1
-7,-18,11,1,0,1
22,22,0,0,0,0
-37,-24,-13,0,1,1
-3,-20,17,1,1,0
-12,-15,3,1,1,0
4,21,-17,0,1,1
3,9,-6,0,1,1
15,22,-7,0,1,1
28,16,12,1,1,0
9,14,-5,0,1,1
33,27,6,1,1,0
22,40,-18,0,1,1
-17,-24,7,1,1,0
13,33,-20,0,1,1
-2,-12,10,1,0,1
-5,-23,18,1,0,1
12,4,8,1,0,1
7,7,0,0,0,0
-15,-3,-12,0,0,0
20,9,11,1,0,1
28,44,-16,0,0,0
0,-4,4,1,0,1
35,30,5,1,0,1
-10,-15,5,1,0,1
-13,-19,6,1,0,1
4,-11,15,1,0,1
15,26,-11,0,0,0
-1,11,-12,0,0,0
44,34,10,1,0,1
-29,-16,-13,0,0,0
41,43,-2,0,0,0
17,24,-7,0,0,0
11,7,4,1,1,0
-9,10,-19,0,1,1
7,-10,17,1,1,0
-32,-29,-3,0,1,1
-14,2,-16,0,1,1
28,26,2,1,1,0
-31,-15,-16,0,1,1
3,-11,14,1,1,0
20,19,1,1,1,0
-45,-25,-20,0,1,1
6,3,3,1,1,0
-16,-35,19,1,1,0
-10,-27,17,1,1,0
16,4,12,1,1,0
-2,1,-3,0,1,1
-20,-7,-13,0,1,1
-6,11,-17,0,1,1
38,28,10,1,1,0
57,38,19,1,1,0
22,30,-8,0,1,1
-5,-24,19,1,1,0
22,11,11,1,0,1
46,43,3,1,0,1
-17,-29,12,1,0,1
-3,-17,14,1,0,1
28,40,-12,0,0,0
24,30,-6,0,0,0
-44,-33,-11,0,0,0
-46,-36,-10,0,0,0
-12,7,-19,0,0,0
8,19,-11,0,0,0
-46,-31,-15,0,0,0
25,44,-19,0,0,0
-33,-27,-6,0,0,0
-7,-11,4,1,0,1
-15,-1,-14,0,0,0
14,1,13,1,0,1
-19,-6,-13,0,0,0
-38,-41,3,1,0,1
-5,-25,20,1,0,1
-19,1,-20,0,0,0
17,14,3,1,0,1
39,41,-2,0,1,1
-12,-7,-5,0,1,1
-38,-25,-13,0,1,1
14,0,14,1,1,0
17,15,2,1,1,0
-26,-41,15,1,1,0
43,33,10,1,1,0
-39,-28,-11,0,1,1
1,21,-20,0,1,1
16,3,13,1,1,0
55,41,14,1,1,0
14,11,3,1,1,0
-13,7,-20,0,1,1
61,41,20,1,1,0
-4,0,-4,0,1,1
-54,-41,-13,0,1,1
-54,-36,-18,0,1,1
14,33,-19,0,1,1
-21,-23,2,1,1,0
-10,-24,14,1,1,0
-33,-23,-10,0,1,1
55,37,18,1,0,1
-54,-39,-15,0,0,0
21,28,-7,0,0,0
-39,-31,-8,0,0,0
-11,1,-12,0,0,0
-44,-45,1,1,0,1
35,24,11,1,0,1
13,1,12,1,0,1
-15,-23,8,1,0,1
-35,-35,0,0,0,0
-19,-6,-13,0,0,0
1,-15,16,1,0,1
17,7,10,1,0,1
4,-10,14,1,0,1
-14,-33,19,1,0,1
-5,-8,3,1,0,1
1,-1,2,1,1,0
-38,-43,5,1,1,0
-2,17,-19,0,1,1
52,41,11,1,1,0
-14,-24,10,1,1,0
1,5,-4,0,1,1
-3,-19,16,1,1,0
14,19,-5,0,1,1
-20,-18,-2,0,1,1
16,0,16,1,1,0
-14,-9,-5,0,1,1
-11,3,-14,0,1,1
-28,-12,-16,0,1,1
30,35,-5,0,1,1
0,-7,7,1,1,0
-42,-44,2,1,1,0
-31,-19,-12,0,0,0
-24,-41,17,1,0,1
7,15,-8,0,0,0
23,16,7,1,0,1
-10,-7,-3,0,0,0
-17,-35,18,1,0,1
15,21,-6,0,0,0
-20,-1,-19,0,0,0
-4,1,-5,0,0,0
33,19,14,1,0,1
7,10,-3,0,1,1
-9,-18,9,1,1,0
46,32,14,1,1,0
-26,-40,14,1,1,0
45,41,4,1,1,0
-8,5,-13,0,1,1
14,-6,20,1,1,0
38,36,2,1,1,0
19,24,-5,0,1,1
-13,-31,18,1,1,0
-24,-24,0,0,1,1
16,24,-8,0,1,1
-10,-1,-9,0,1,1
-26,-9,-17,0,1,1
36,41,-5,0,1,1
8,23,-15,0,1,1
-31,-32,1,1,0,1
49,42,7,1,0,1
-35,-16,-19,0,0,0
-2,-1,-1,0,0,0
19,31,-12,0,0,0
32,19,13,1,0,1
-33,-44,11,1,0,1
54,41,13,1,0,1
32,24,8,1,0,1
7,-11,18,1,0,1
6,24,-18,0,0,0
30,33,-3,0,0,0
-32,-13,-19,0,0,0
23,41,-18,0,0,0
12,21,-9,0,0,0
-34,-41,7,1,0,1
-14,-13,-1,0,0,0
27,16,11,1,0,1
-59,-44,-15,0,1,1
-6,12,-18,0,1,1
9,-5,14,1,1,0
-6,5,-11,0,1,1
16,34,-18,0,1,1
5,24,-19,0,1,1
8,1,7,1,1,0
29,11,18,1,1,0
39,36,3,1,1,0
15,1,14,1,1,0
-14,-24,10,1,1,0
2,20,-18,0,1,1
-14,-31,17,1,1,0
18,3,15,1,1,0
-21,-36,15,1,1,0
-15,-30,15,1,1,0
-5,-6,1,1,1,0
-35,-29,-6,0,1,1
-31,-24,-7,0,1,1
-14,-15,1,1,1,0
42,28,14,1,1,0
-44,-24,-20,0,0,0
-35,-26,-9,0,0,0
11,16,-5,0,0,0
-45,-40,-5,0,0,0
-2,7,-9,0,0,0
-37,-32,-5,0,0,0
-7,-4,-3,0,0,0
20,40,-20,0,0,0
-47,-31,-16,0,0,0
24,33,-9,0,1,1
-30,-32,2,1,1,0
13,14,-1,0,1,1
6,21,-15,0,1,1
-20,-10,-10,0,1,1
7,2,5,1,1,0
-46,-35,-11,0,1,1
-29,-18,-11,0,1,1
-30,-37,7,1,1,0
28,41,-13,0,1,1
-42,-29,-13,0,1,1
4,20,-16,0,1,1
49,42,7,1,1,0
-28,-10,-18,0,0,0
43,29,14,1,0,1
-20,-35,15,1,0,1
16,8,8,1,0,1
-14,-10,-4,0,0,0
-23,-39,16,1,0,1
37,31,6,1,0,1
-24,-12,-12,0,0,0
17,34,-17,0,0,0
26,30,-4,0,0,0
22,24,-2,0,0,0
28,43,-15,0,0,0
-11,-5,-6,0,0,0
12,23,-11,0,0,0
40,20,20,1,0,1
-18,-17,-1,0,1,1
24,39,-15,0,1,1
18,10,8,1,1,0
-38,-36,-2,0,1,1
37,43,-6,0,1,1
26,18,8,1,1,0
-20,-36,16,1,1,0
-2,5,-7,0,1,1
-42,-39,-3,0,1,1
26,7,19,1,1,0
41,43,-2,0,1,1
-34,-27,-7,0,1,1
13,21,-8,0,1,1
-7,-5,-2,0,1,1
-51,-39,-12,0,1,1
-35,-34,-1,0,1,1
-11,-16,5,1,1,0
-1,5,-6,0,1,1
15,26,-11,0,1,1
-35,-16,-19,0,1,1
10,-9,19,1,0,1
15,2,13,1,0,1
-39,-35,-4,0,0,0
33,33,0,0,0,0
-1,-14,13,1,0,1
6,0,6,1,0,1
-33,-27,-6,0,0,0
-7,-4,-3,0,0,0
-5,-19,14,1,0,1
36,30,6,1,0,1
-32,-27,-5,0,0,0
-38,-45,7,1,0,1
33,19,14,1,0,1
-30,-36,6,1,0,1
41,44,-3,0,0,0
-12,-12,0,0,0,0
10,8,2,1,0,1
25,41,-16,0,0,0
34,41,-7,0,0,0
-52,-35,-17,0,1,1
6,8,-2,0,1,1
10,16,-6,0,1,1
-7,-21,14,1,1,0
34,39,-5,0,1,1
-38,-33,-5,0,1,1
43,24,19,1,1,0
35,33,2,1,1,0
4,-12,16,1,1,0
-12,-15,3,1,1,0
10,11,-1,0,1,1
3,10,-7,0,1,1
-33,-21,-12,0,1,1
1,-1,2,1,1,0
-49,-31,-18,0,1,1
29,35,-6,0,1,1
-5,-6,1,1,1,0
-40,-36,-4,0,1,1
-23,-29,6,1,1,0
-41,-43,2,1,1,0
-36,-23,-13,0,1,1
-17,-2,-15,0,0,0
-9,-22,13,1,0,1
-4,3,-7,0,0,0
28,35,-7,0,0,0
-26,-25,-1,0,0,0
21,29,-8,0,0,0
33,43,-10,0,0,0
-34,-23,-11,0,0,0
-20,-13,-7,0,0,0
25,17,8,1,1,0
25,35,-10,0,1,1
31,31,0,0,1,1
16,24,-8,0,1,1
11,8,3,1,1,0
-53,-43,-10,0,1,1
-49,-31,-18,0,1,1
-48,-45,-3,0,1,1
-20,-10,-10,0,1,1
0,-3,3,1,1,0
37,24,13,1,1,0
27,11,16,1,0,1
-37,-23,-14,0,0,0
44,27,17,1,0,1
-41,-38,-3,0,0,0
36,38,-2,0,0,0
-12,-29,17,1,0,1
11,29,-18,0,0,0
-12,-14,2,1,0,1
-3,5,-8,0,0,0
6,19,-13,0,1,1
30,28,2,1,1,0
26,22,4,1,1,0
18,1,17,1,1,0
7,1,6,1,1,0
-3,-7,4,1,1,0
17,29,-12,0,1,1
-31,-42,11,1,1,0
49,37,12,1,0,1
22,8,14,1,0,1
40,39,1,1,0,1
-57,-38,-19,0,0,0
15,-2,17,1,0,1
-5,-5,0,0,0,0
-18,-8,-10,0,0,0
-39,-40,1,1,0,1
-15,3,-18,0,0,0
32,15,17,1,1,0
20,6,14,1,1,0
21,1,20,1,1,0
12,12,0,0,1,1
-8,-17,9,1,1,0
-22,-11,-11,0,1,1
44,38,6,1,1,0
-39,-45,6,1,1,0
19,26,-7,0,1,1
3,-12,15,1,1,0
36,43,-7,0,1,1
31,17,14,1,1,0
-30,-32,2,1,1,0
-26,-21,-5,0,1,1
10,9,1,1,1,0
48,29,19,1,1,0
-24,-4,-20,0,1,1
-15,-11,-4,0,1,1
-3,16,-19,0,1,1
25,21,4,1,1,0
11,18,-7,0,1,1
-12,-16,4,1,0,1
-35,-43,8,1,0,1
37,28,9,1,0,1
-39,-34,-5,0,0,0
46,34,12,1,0,1
-26,-24,-2,0,0,0
13,33,-20,0,0,0
-2,17,-19,0,0,0
-37,-39,2,1,0,1
23,43,-20,0,0,0
33,42,-9,0,0,0
-37,-44,7,1,0,1
13,4,9,1,0,1
-41,-44,3,1,0,1
34,35,-1,0,0,0
12,0,12,1,0,1
13,2,11,1,1,0
-44,-39,-5,0,1,1
-5,-7,2,1,1,0
10,-3,13,1,1,0
-23,-9,-14,0,1,1
15,9,6,1,1,0
-46,-33,-13,0,1,1
-27,-42,15,1,1,0
-43,-36,-7,0,0,0
15,19,-4,0,0,0
26,24,2,1,0,1
33,27,6,1,0,1
-51,-37,-14,0,0,0
-28,-29,1,1,0,1
1,-13,14,1,0,1
15,14,1,1,0,1
-11,-8,-3,0,0,0
-51,-31,-20,0,0,0
-40,-20,-20,0,0,0
-38,-44,6,1,0,1
-24,-42,18,1,0,1
-26,-14,-12,0,0,0
-22,-3,-19,0,0,0
-6,14,-20,0,0,0
-35,-45,10,1,0,1
-37,-45,8,1,0,1
27,42,-15,0,0,0
4,3,1,1,0,1
1,-2,3,1,1,0
-15,-28,13,1,1,0
-10,-17,7,1,1,0
26,6,20,1,1,0
34,32,2,1,1,0
5,8,-3,0,1,1
-43,-28,-15,0,1,1
28,40,-12,0,1,1
3,1,2,1,1,0
44,30,14,1,1,0
-6,-3,-3,0,1,1
20,21,-1,0,1,1
-41,-22,-19,0,1,1
-43,-25,-18,0,1,1
3,21,-18,0,1,1
-46,-37,-9,0,1,1
13,33,-20,0,1,1
-14,-4,-10,0,1,1
23,28,-5,0,1,1
11,17,-6,0,1,1
26,34,-8,0,1,1
-37,-41,4,1,0,1
-25,-14,-11,0,0,0
-4,-16,12,1,0,1
-31,-45,14,1,0,1
-12,-11,-1,0,0,0
-34,-14,-20,0,0,0
21,39,-18,0,0,0
30,44,-14,0,0,0
-12,-28,16,1,0,1
22,17,5,1,0,1
-27,-45,18,1,0,1
-20,-20,0,0,1,1
-22,-31,9,1,1,0
13,16,-3,0,1,1
-23,-6,-17,0,1,1
10,25,-15,0,1,1
-40,-27,-13,0,1,1
15,31,-16,0,1,1
29,9,20,1,1,0
13,2,11,1,1,0
51,41,10,1,1,0
-4,4,-8,0,1,1
-7,0,-7,0,0,0
39,25,14,1,0,1
56,43,13,1,0,1
-7,12,-19,0,0,0
19,9,10,1,0,1
10,10,0,0,0,0
34,26,8,1,0,1
-38,-35,-3,0,0,0
7,25,-18,0,0,0
-12,-14,2,1,0,1
21,6,15,1,0,1
-4,7,-11,0,0,0
1,-19,20,1,0,1
29,38,-9,0,0,0
8,19,-11,0,0,0
27,32,-5,0,0,0
-15,-3,-12,0,0,0
-33,-31,-2,0,0,0
61,42,19,1,0,1
-5,-1,-4,0,0,0
-4,7,-11,0,1,1
-2,7,-9,0,1,1
1,-13,14,1,1,0
38,24,14,1,1,0
-31,-38,7,1,1,0
-30,-27,-3,0,1,1
32,32,0,0,1,1
-5,-11,6,1,1,0
42,40,2,1,1,0
-42,-23,-19,0,1,1
-45,-37,-8,0,1,1
43,43,0,0,1,1
-30,-23,-7,0,1,1
19,39,-20,0,1,1
-3,17,-20,0,0,0
-7,12,-19,0,0,0
7,1,6,1,0,1
9,3,6,1,0,1
-20,0,-20,0,0,0
21,17,4,1,0,1
26,26,0,0,0,0
-18,2,-20,0,0,0
0,-10,10,1,0,1
-24,-26,2,1,1,0
-25,-12,-13,0,1,1
-24,-27,3,1,1,0
-33,-30,-3,0,1,1
-40,-35,-5,0,1,1
-59,-42,-17,0,1,1
-2,-17,15,1,1,0
-2,-17,15,1,1,0
-39,-25,-14,0,1,1
-1,-21,20,1,1,0
16,6,10,1,1,0
-33,-32,-1,0,1,1
23,28,-5,0,1,1
4,-13,17,1,1,0
-40,-31,-9,0,1,1
43,28,15,1,1,0
-17,-4,-13,0,0,0
-37,-27,-10,0,0,0
-17,2,-19,0,0,0
-47,-44,-3,0,0,0
15,28,-13,0,0,0
43,26,17,1,0,1
49,41,8,1,0,1
6,-10,16,1,0,1
33,19,14,1,0,1
-54,-45,-9,0,0,0
18,8,10,1,0,1
-21,-12,-9,0,0,0
32,38,-6,0,0,0
4,-13,17,1,0,1
57,38,19,1,1,0
-44,-34,-10,0,1,1
19,12,7,1,1,0
-51,-34,-17,0,1,1
-22,-21,-1,0,1,1
-17,-3,-14,0,1,1
5,-8,13,1,1,0
34,24,10,1,1,0
-32,-14,-18,0,1,1
-42,-42,0,0,1,1
19,34,-15,0,1,1
6,16,-10,0,1,1
-57,-40,-17,0,1,1
31,33,-2,0,1,1
61,44,17,1,0,1
-14,0,-14,0,0,0
-8,12,-20,0,0,0
-23,-21,-2,0,0,0
-8,-3,-5,0,0,0
-26,-25,-1,0,0,0
-7,-27,20,1,0,1
-33,-45,12,1,0,1
35,30,5,1,1,0
-48,-34,-14,0,1,1
-25,-20,-5,0,1,1
-22,-9,-13,0,1,1
54,39,15,1,1,0
36,33,3,1,1,0
-22,-35,13,1,1,0
0,7,-7,0,1,1
-55,-39,-16,0,1,1
-9,-12,3,1,1,0
-9,-13,4,1,1,0
6,11,-5,0,1,1
-44,-30,-14,0,1,1
-21,-14,-7,0,1,1
45,44,1,1,1,0
-29,-34,5,1,1,0
-25,-37,12,1,1,0
-30,-23,-7,0,1,1
-20,-40,20,1,1,0
-16,-21,5,1,1,0
-25,-35,10,1,1,0
15,16,-1,0,0,0
-1,0,-1,0,0,0
32,19,13,1,0,1
5,17,-12,0,0,0
27,14,13,1,0,1
2,9,-7,0,0,0
-49,-45,-4,0,0,0
9,29,-20,0,0,0
-44,-38,-6,0,0,0
32,21,11,1,0,1
11,-2,13,1,0,1
38,18,20,1,0,1
-28,-38,10,1,0,1
-60,-40,-20,0,0,0
-43,-38,-5,0,0,0
29,13,16,1,0,1
50,31,19,1,0,1
-46,-39,-7,0,0,0
5,20,-15,0,0,0
-34,-14,-20,0,1,1
-55,-45,-10,0,1,1
-57,-39,-18,0,1,1
-16,-32,16,1,1,0
29,33,-4,0,1,1
47,33,14,1,1,0
50,37,13,1,1,0
28,10,18,1,1,0
-20,-16,-4,0,1,1
-39,-35,-4,0,1,1
-56,-37,-19,0,1,1
-31,-31,0,0,1,1
-7,-15,8,1,1,0
23,35,-12,0,1,1
22,23,-1,0,1,1
48,32,16,1,1,0
-46,-38,-8,0,1,1
13,15,-2,0,1,1
-7,-2,-5,0,1,1
31,14,17,1,1,0
22,15,7,1,1,0
22,34,-12,0,0,0
15,22,-7,0,0,0
-8,-6,-2,0,0,0
32,12,20,1,0,1
44,25,19,1,0,1
-27,-25,-2,0,0,0
7,5,2,1,0,1
48,28,20,1,0,1
19,29,-10,0,0,0
33,19,14,1,0,1
-8,5,-13,0,0,0
22,2,20,1,0,1
-13,-31,18,1,0,1
-34,-31,-3,0,0,0
-25,-27,2,1,0,1
10,-1,11,1,0,1
31,12,19,1,0,1
-51,-36,-15,0,0,0
-16,-17,1,1,0,1
-37,-37,0,0,0,0
-17,2,-19,0,0,0
-34,-20,-14,0,1,1
-12,-9,-3,0,1,1
3,-12,15,1,1,0
-51,-33,-18,0,1,1
-33,-42,9,1,1,0
17,25,-8,0,1,1
-46,-40,-6,0,1,1
-29,-25,-4,0,1,1
19,39,-20,0,0,0
-4,6,-10,0,0,0
7,27,-20,0,0,0
-34,-20,-14,0,0,0
13,24,-11,0,0,0
-7,13,-20,0,0,0
-37,-27,-10,0,0,0
-20,-24,4,1,0,1
32,14,18,1,0,1
19,10,9,1,0,1
7,-9,16,1,0,1
-16,-30,14,1,0,1
10,9,1,1,0,1
43,32,11,1,0,1
42,31,11,1,0,1
-9,-12,3,1,0,1
24,15,9,1,0,1
7,6,1,1,0,1
44,34,10,1,0,1
46,38,8,1,0,1
-14,5,-19,0,0,0
3,13,-10,0,1,1
25,29,-4,0,1,1
36,16,20,1,1,0
23,41,-18,0,1,1
-26,-17,-9,0,1,1
-1,-14,13,1,1,0
4,-15,19,1,1,0
-19,-4,-15,0,1,1
-21,-31,10,1,1,0
-27,-44,17,1,1,0
53,37,16,1,0,1
13,7,6,1,0,1
-48,-42,-6,0,0,0
9,2,7,1,0,1
12,13,-1,0,0,0
1,10,-9,0,0,0
7,3,4,1,0,1
-17,2,-19,0,0,0
14,-2,16,1,0,1
18,12,6,1,0,1
31,21,10,1,1,0
13,32,-19,0,1,1
31,21,10,1,1,0
-27,-9,-18,0,1,1
-19,-32,13,1,1,0
-44,-43,-1,0,1,1
38,24,14,1,1,0
33,26,7,1,1,0
4,8,-4,0,1,1
21,32,-11,0,1,1
-13,0,-13,0,1,1
49,32,17,1,1,0
-27,-27,0,0,1,1
8,-12,20,1,1,0
20,13,7,1,1,0
21,38,-17,0,1,1
43,23,20,1,1,0
22,13,9,1,1,0
-3,1,-4,0,1,1
1,11,-10,0,0,0
-45,-40,-5,0,0,0
0,20,-20,0,0,0
-2,-18,16,1,0,1
-11,-3,-8,0,0,0
-51,-44,-7,0,0,0
37,28,9,1,0,1
18,15,3,1,0,1
-1,14,-15,0,0,0
-10,3,-13,0,0,0
4,-1,5,1,0,1
37,27,10,1,0,1
-24,-22,-2,0,0,0
-17,-13,-4,0,0,0
-30,-23,-7,0,0,0
-16,-7,-9,0,1,1
-9,8,-17,0,1,1
-22,-41,19,1,1,0
-1,0,-1,0,1,1
9,24,-15,0,1,1
11,-2,13,1,1,0
27,27,0,0,1,1
42,35,7,1,1,0
15,31,-16,0,1,1
35,33,2,1,1,0
-38,-24,-14,0,0,0
-42,-28,-14,0,0,0
-13,-30,17,1,0,1
-8,7,-15,0,0,0
51,37,14,1,0,1
-19,-35,16,1,0,1
-28,-11,-17,0,0,0
7,-5,12,1,0,1
-27,-11,-16,0,1,1
45,44,1,1,1,0
46,33,13,1,1,0
-30,-45,15,1,1,0
3,4,-1,0,1,1
-41,-44,3,1,1,0
39,21,18,1,1,0
-10,-18,8,1,1,0
-11,1,-12,0,1,1
-6,-11,5,1,1,0
-9,-5,-4,0,1,1
43,29,14,1,1,0
38,34,4,1,0,1
16,6,10,1,0,1
-21,-17,-4,0,0,0
43,23,20,1,0,1
-35,-29,-6,0,0,0
21,35,-14,0,0,0
-49,-30,-19,0,0,0
-33,-17,-16,0,0,0
-16,-11,-5,0,0,0
55,38,17,1,0,1
-12,-22,10,1,1,0
-29,-39,10,1,1,0
-21,-26,5,1,1,0
-3,-8,5,1,1,0
-18,-1,-17,0,1,1
-1,-9,8,1,1,0
31,23,8,1,1,0
-34,-38,4,1,1,0
14,33,-19,0,1,1
50,32,18,1,1,0
-26,-33,7,1,1,0
31,40,-9,0,1,1
-1,-1,0,0,1,1
52,42,10,1,1,0
-16,-35,19,1,1,0
22,39,-17,0,1,1
-18,-34,16,1,1,0
2,-8,10,1,1,0
58,44,14,1,1,0
-40,-26,-14,0,1,1
40,38,2,1,1,0
-24,-34,10,1,0,1
-19,-28,9,1,0,1
33,26,7,1,0,1
-10,-6,-4,0,0,0
2,-12,14,1,0,1
-23,-12,-11,0,0,0
-53,-42,-11,0,0,0
15,-3,18,1,0,1
-41,-36,-5,0,0,0
7,-11,18,1,0,1
5,-9,14,1,0,1
-16,-23,7,1,0,1
50,31,19,1,1,0
-4,4,-8,0,1,1
15,25,-10,0,1,1
-11,-14,3,1,1,0
41,30,11,1,1,0
24,10,14,1,1,0
20,8,12,1,1,0
-19,-4,-15,0,1,1
-2,-17,15,1,1,0
54,42,12,1,1,0
2,-13,15,1,1,0
-4,-3,-1,0,1,1
12,-6,18,1,1,0
29,30,-1,0,0,0
-63,-45,-18,0,0,0
52,34,18,1,0,1
31,43,-12,0,0,0
14,-2,16,1,0,1
8,-2,10,1,0,1
-16,-34,18,1,0,1
32,29,3,1,0,1
-4,-12,8,1,0,1
17,30,-13,0,0,0
16,34,-18,0,0,0
9,16,-7,0,0,0
-56,-43,-13,0,0,0
21,11,10,1,0,1
-17,-34,17,1,0,1
17,29,-12,0,1,1
-6,-21,15,1,1,0
-40,-39,-1,0,1,1
-29,-32,3,1,1,0
40,28,12,1,1,0
15,12,3,1,1,0
-8,-22,14,1,1,0
-22,-20,-2,0,1,1
7,0,7,1,1,0
21,14,7,1,1,0
-23,-35,12,1,1,0
-38,-23,-15,0,1,1
-18,-34,16,1,1,0
-19,-9,-10,0,1,1
22,29,-7,0,1,1
9,17,-8,0,1,1
15,15,0,0,1,1
5,12,-7,0,1,1
-30,-14,-16,0,1,1
24,36,-12,0,0,0
30,42,-12,0,0,0
-9,-28,19,1,0,1
42,24,18,1,0,1
-7,-12,5,1,0,1
15,26,-11,0,0,0
13,32,-19,0,0,0
40,32,8,1,0,1
-38,-43,5,1,0,1
16,14,2,1,0,1
-11,5,-16,0,0,0
-53,-43,-10,0,0,0
34,31,3,1,0,1
26,24,2,1,0,1
7,20,-13,0,0,0
-31,-43,12,1,0,1
28,12,16,1,1,0
-32,-40,8,1,1,0
-49,-42,-7,0,1,1
-35,-30,-5,0,1,1
-10,4,-14,0,1,1
-17,-37,20,1,1,0
26,32,-6,0,1,1
-31,-11,-20,0,1,1
-2,10,-12,0,1,1
13,15,-2,0,1,1
-7,-6,-1,0,1,1
12,-2,14,1,0,1
-51,-31,-20,0,0,0
-19,-6,-13,0,0,0
27,25,2,1,0,1
-28,-13,-15,0,0,0
-50,-37,-13,0,0,0
-7,-13,6,1,0,1
42,33,9,1,0,1
27,42,-15,0,0,0
-50,-44,-6,0,1,1
-52,-45,-7,0,1,1
-19,-20,1,1,1,0
-38,-32,-6,0,1,1
-36,-31,-5,0,1,1
-6,-15,9,1,1,0
22,38,-16,0,1,1
-37,-30,-7,0,1,1
-17,3,-20,0,1,1
35,32,3,1,1,0
-58,-45,-13,0,0,0
34,42,-8,0,0,0
34,42,-8,0,0,0
41,25,16,1,0,1
31,29,2,1,0,1
7,10,-3,0,0,0
29,30,-1,0,0,0
19,19,0,0,0,0
-34,-42,8,1,0,1
60,44,16,1,0,1
-16,-13,-3,0,0,0
-14,-32,18,1,0,1
-17,-28,11,1,0,1
-23,-43,20,1,0,1
-3,-23,20,1,0,1
-40,-28,-12,0,0,0
34,22,12,1,0,1
37,32,5,1,0,1
-55,-43,-12,0,0,0
-46,-45,-1,0,0,0
-54,-34,-20,0,0,0
-32,-32,0,0,1,1
1,9,-8,0,1,1
18,20,-2,0,1,1
2,13,-11,0,1,1
-21,-30,9,1,1,0
26,15,11,1,1,0
-16,-14,-2,0,1,1
49,44,5,1,1,0
-30,-14,-16,0,1,1
46,43,3,1,1,0
6,15,-9,0,1,1
-39,-45,6,1,1,0
-20,-17,-3,0,1,1
8,-8,16,1,1,0
15,10,5,1,1,0
-19,-6,-13,0,0,0
-25,-31,6,1,0,1
26,39,-13,0,0,0
36,36,0,0,0,0
-32,-44,12,1,0,1
15,-4,19,1,0,1
16,26,-10,0,0,0
54,37,17,1,0,1
33,36,-3,0,0,0
-23,-23,0,0,0,0
-24,-33,9,1,1,0
32,40,-8,0,1,1
-47,-28,-19,0,1,1
12,29,-17,0,1,1
-28,-24,-4,0,1,1
-45,-42,-3,0,1,1
-24,-40,16,1,1,0
7,15,-8,0,1,1
-39,-31,-8,0,1,1
20,28,-8,0,1,1
-5,-5,0,0,1,1
-3,-20,17,1,0,1
34,33,1,1,0,1
17,1,16,1,0,1
-22,-10,-12,0,0,0
-7,-5,-2,0,0,0
34,21,13,1,0,1
19,24,-5,0,0,0
27,21,6,1,0,1
25,29,-4,0,0,0
-29,-32,3,1,1,0
39,20,19,1,1,0
-27,-45,18,1,1,0
-19,-27,8,1,1,0
5,4,1,1,1,0
-23,-25,2,1,1,0
-39,-31,-8,0,1,1
-1,-4,3,1,1,0
12,0,12,1,1,0
17,24,-7,0,1,1
-14,-9,-5,0,1,1
-16,4,-20,0,1,1
-24,-16,-8,0,0,0
-13,-27,14,1,0,1
44,37,7,1,0,1
-14,5,-19,0,0,0
12,20,-8,0,0,0
29,11,18,1,0,1
46,39,7,1,0,1
-61,-45,-16,0,0,0
-25,-16,-9,0,0,0
8,-11,19,1,0,1
11,0,11,1,0,1
38,22,16,1,0,1
22,18,4,1,0,1
2,-6,8,1,0,1
18,6,12,1,0,1
-27,-41,14,1,0,1
11,-8,19,1,0,1
-19,-18,-1,0,0,0
6,11,-5,0,0,0
13,-3,16,1,0,1
19,33,-14,0,0,0
-31,-16,-15,0,1,1
17,2,15,1,1,0
-24,-16,-8,0,1,1
-46,-35,-11,0,1,1
-14,-5,-9,0,1,1
17,9,8,1,1,0
2,14,-12,0,1,1
-8,-23,15,1,1,0
-4,-6,2,1,1,0
-59,-39,-20,0,1,1
-54,-44,-10,0,1,1
-4,-16,12,1,0,1
-3,-21,18,1,0,1
-38,-24,-14,0,0,0
9,-11,20,1,0,1
-13,-21,8,1,0,1
9,11,-2,0,0,0
4,7,-3,0,0,0
-14,-33,19,1,0,1
-1,18,-19,0,0,0
-22,-33,11,1,0,1
39,39,0,0,0,0
46,26,20,1,0,1
9,0,9,1,1,0
14,23,-9,0,1,1
-37,-27,-10,0,1,1
26,14,12,1,1,0
-7,6,-13,0,1,1
37,19,18,1,1,0
3,-17,20,1,1,0
-2,-4,2,1,1,0
34,22,12,1,1,0
15,31,-16,0,1,1
10,24,-14,0,1,1
29,37,-8,0,1,1
28,38,-10,0,1,1
47,42,5,1,1,0
-2,-8,6,1,1,0
-10,-30,20,1,1,0
-32,-40,8,1,1,0
-44,-43,-1,0,1,1
5,25,-20,0,1,1
-17,-30,13,1,1,0
28,44,-16,0,1,1
4,-8,12,1,0,1
-54,-45,-9,0,0,0
20,13,7,1,0,1
1,16,-15,0,0,0
7,-5,12,1,0,1
46,42,4,1,0,1
34,17,17,1,0,1
21,14,7,1,0,1
-2,-16,14,1,0,1
-33,-27,-6,0,0,0
2,7,-5,0,0,0
23,29,-6,0,0,0
32,15,17,1,0,1
-1,-8,7,1,0,1
19,1,18,1,0,1
-44,-27,-17,0,0,0
-35,-20,-15,0,0,0
9,2,7,1,0,1
-29,-28,-1,0,0,0
-4,1,-5,0,0,0
13,1,12,1,0,1
41,40,1,1,1,0
0,0,0,0,1,1
16,35,-19,0,1,1
5,7,-2,0,1,1
-7,-26,19,1,1,0
-49,-38,-11,0,1,1
-32,-27,-5,0,1,1
-9,-6,-3,0,1,1
6,22,-16,0,1,1
-41,-34,-7,0,1,1
16,3,13,1,1,0
-15,-21,6,1,0,1
43,44,-1,0,0,0
-22,-6,-16,0,0,0
56,43,13,1,0,1
24,27,-3,0,0,0
41,38,3,1,0,1
18,31,-13,0,0,0
5,4,1,1,0,1
-36,-18,-18,0,0,0
4,5,-1,0,0,0
-28,-38,10,1,0,1
26,29,-3,0,0,0
-25,-40,15,1,0,1
-28,-14,-14,0,0,0
36,43,-7,0,0,0
-7,7,-14,0,0,0
1,21,-20,0,0,0
-25,-39,14,1,1,0
-33,-29,-4,0,1,1
31,22,9,1,1,0
13,-6,19,1,1,0
40,37,3,1,1,0
-1,-8,7,1,1,0
-59,-45,-14,0,1,1
-4,-8,4,1,1,0
31,43,-12,0,1,1
-2,-1,-1,0,1,1
-17,-13,-4,0,1,1
27,34,-7,0,1,1
20,18,2,1,1,0
10,30,-20,0,1,1
39,30,9,1,1,0
-48,-37,-11,0,0,0
-31,-13,-18,0,0,0
-10,7,-17,0,0,0
27,14,13,1,0,1
34,16,18,1,0,1
-20,-4,-16,0,0,0
25,42,-17,0,0,0
-11,-28,17,1,0,1
-55,-40,-15,0,1,1
-12,2,-14,0,1,1
3,6,-3,0,1,1
10,9,1,1,1,0
-54,-39,-15,0,1,1
9,28,-19,0,1,1
33,28,5,1,1,0
3,15,-12,0,1,1
-28,-45,17,1,1,0
6,5,1,1,0,1
-14,-19,5,1,0,1
-40,-24,-16,0,0,0
18,23,-5,0,0,0
-32,-37,5,1,0,1
30,31,-1,0,0,0
19,13,6,1,0,1
-26,-31,5,1,0,1
-36,-43,7,1,0,1
-45,-25,-20,0,0,0
12,19,-7,0,0,0
4,-6,10,1,0,1
-33,-32,-1,0,0,0
14,1,13,1,0,1
-26,-26,0,0,0,0
-32,-28,-4,0,0,0
-64,-44,-20,0,0,0
9,18,-9,0,0,0
-7,-14,7,1,0,1
1,-14,15,1,0,1
12,30,-18,0,0,0
20,2,18,1,1,0
7,10,-3,0,1,1
15,29,-14,0,1,1
40,37,3,1,1,0
40,36,4,1,1,0
11,21,-10,0,1,1
13,15,-2,0,1,1
-14,5,-19,0,1,1
39,35,4,1,1,0
27,27,0,0,1,1
16,30,-14,0,1,1
37,37,0,0,1,1
-21,-32,11,1,1,0
-6,-22,16,1,1,0
1,-9,10,1,1,0
25,19,6,1,0,1
-8,-4,-4,0,0,0
57,43,14,1,0,1
7,17,-10,0,0,0
-45,-25,-20,0,0,0
39,30,9,1,0,1
47,27,20,1,0,1
27,10,17,1,0,1
-6,-18,12,1,0,1
-39,-38,-1,0,0,0
18,37,-19,0,0,0
8,-7,15,1,0,1
39,23,16,1,0,1
-16,-7,-9,0,0,0
24,12,12,1,0,1
-25,-37,12,1,0,1
-20,-8,-12,0,0,0
49,36,13,1,0,1
-2,-20,18,1,0,1
-13,-33,20,1,0,1
14,-4,18,1,0,1
16,1,15,1,1,0
-38,-31,-7,0,1,1
-16,-20,4,1,1,0
26,6,20,1,1,0
-52,-35,-17,0,1,1
25,8,17,1,1,0
-32,-31,-1,0,1,1
-11,-27,16,1,1,0
-16,-14,-2,0,1,1
-16,-5,-11,0,1,1
4,-8,12,1,1,0
-23,-33,10,1,1,0
27,25,2,1,1,0
41,32,9,1,1,0
46,34,12,1,1,0
6,18,-12,0,1,1
-26,-41,15,1,1,0
-40,-33,-7,0,0,0
-21,-15,-6,0,0,0
50,31,19,1,0,1
35,19,16,1,0,1
-6,-22,16,1,0,1
-44,-45,1,1,0,1
-16,-18,2,1,0,1
55,40,15,1,0,1
-8,7,-15,0,0,0
23,9,14,1,0,1
23,19,4,1,0,1
2,3,-1,0,0,0
-3,16,-19,0,0,0
10,0,10,1,0,1
-10,3,-13,0,0,0
-33,-17,-16,0,1,1
-42,-25,-17,0,1,1
28,40,-12,0,1,1
35,30,5,1,1,0
7,19,-12,0,1,1
28,13,15,1,1,0
14,13,1,1,1,0
-14,-11,-3,0,1,1
-27,-13,-14,0,0,0
-24,-44,20,1,0,1
0,1,-1,0,0,0
-2,-19,17,1,0,1
30,23,7,1,0,1
14,18,-4,0,0,0
36,21,15,1,0,1
-10,10,-20,0,0,0
26,36,-10,0,0,0
30,37,-7,0,0,0
-30,-21,-9,0,0,0
-8,-15,7,1,0,1
-15,-35,20,1,0,1
-51,-38,-13,0,0,0
6,-3,9,1,0,1
-28,-14,-14,0,0,0
-6,11,-17,0,0,0
24,30,-6,0,1,1
29,42,-13,0,1,1
-21,-16,-5,0,1,1
27,7,20,1,1,0
-53,-39,-14,0,1,1
-14,5,-19,0,1,1
-50,-35,-15,0,1,1
21,8,13,1,1,0
53,35,18,1,1,0
16,7,9,1,1,0
41,41,0,0,1,1
19,12,7,1,1,0
-22,-5,-17,0,1,1
-52,-43,-9,0,1,1
-23,-3,-20,0,0,0
7,-7,14,1,0,1
-39,-28,-11,0,0,0
42,39,3,1,0,1
-60,-40,-20,0,0,0
-57,-37,-20,0,0,0
-34,-16,-18,0,0,0
-13,-20,7,1,0,1
24,32,-8,0,0,0
51,31,20,1,0,1
-12,8,-20,0,0,0
-19,-1,-18,0,0,0
-7,-21,14,1,0,1
2,8,-6,0,0,0
-35,-41,6,1,1,0
21,39,-18,0,1,1
32,19,13,1,1,0
5,12,-7,0,1,1
40,44,-4,0,1,1
0,9,-9,0,1,1
-3,-4,1,1,1,0
-6,-19,13,1,1,0
-29,-21,-8,0,1,1
-33,-41,8,1,1,0
-30,-26,-4,0,1,1
0,-7,7,1,1,0
51,31,20,1,1,0
-4,13,-17,0,1,1
34,16,18,1,1,0
-17,-3,-14,0,1,1
-6,3,-9,0,1,1
17,36,-19,0,1,1
-5,4,-9,0,0,0
32,23,9,1,0,1
-6,-13,7,1,0,1
-42,-32,-10,0,0,0
27,25,2,1,0,1
-34,-18,-16,0,0,0
-8,-1,-7,0,0,0
0,4,-4,0,0,0
15,29,-14,0,0,0
-2,-17,15,1,0,1
4,-10,14,1,0,1
16,8,8,1,0,1
-9,-29,20,1,0,1
-32,-18,-14,0,0,0
13,8,5,1,0,1
-7,-17,10,1,0,1
-34,-21,-13,0,0,0
-32,-38,6,1,0,1
2,-11,13,1,0,1
-12,2,-14,0,0,0
-7,-5,-2,0,0,0
-5,-21,16,1,1,0
-20,-34,14,1,1,0
49,34,15,1,1,0
-29,-43,14,1,1,0
30,36,-6,0,1,1
13,13,0,0,1,1
11,-9,20,1,1,0
-13,-30,17,1,1,0
-1,-13,12,1,1,0
17,31,-14,0,1,1
17,27,-10,0,1,1
-13,3,-16,0,1,1
4,14,-10,0,1,1
-14,-21,7,1,1,0
-22,-39,17,1,1,0
-6,-9,3,1,1,0
30,16,14,1,1,0
-22,-19,-3,0,1,1
23,15,8,1,1,0
6,11,-5,0,1,1
2,6,-4,0,1,1
-21,-24,3,1,0,1
-22,-35,13,1,0,1
-10,-28,18,1,0,1
-38,-33,-5,0,0,0
35,44,-9,0,0,0
-12,-6,-6,0,0,0
34,32,2,1,0,1
25,35,-10,0,0,0
22,20,2,1,0,1
47,27,20,1,0,1
42,26,16,1,0,1
36,26,10,1,0,1
28,35,-7,0,0,0
52,37,15,1,0,1
58,40,18,1,0,1
11,14,-3,0,0,0
-3,17,-20,0,0,0
-8,-4,-4,0,1,1
10,26,-16,0,1,1
34,14,20,1,1,0
15,6,9,1,1,0
0,14,-14,0,1,1
-30,-27,-3,0,1,1
-14,-12,-2,0,1,1
-17,-10,-7,0,1,1
33,14,19,1,0,1
-16,-6,-10,0,0,0
-29,-31,2,1,0,1
-41,-29,-12,0,0,0
-10,-8,-2,0,0,0
-19,0,-19,0,0,0
52,44,8,1,0,1
-5,-5,0,0,0,0
11,22,-11,0,0,0
-61,-41,-20,0,0,0
-8,-28,20,1,0,1
8,-3,11,1,0,1
-38,-44,6,1,0,1
-21,-35,14,1,0,1
16,33,-17,0,0,0
34,35,-1,0,0,0
16,2,14,1,0,1
-28,-32,4,1,0,1
22,41,-19,0,0,0
-38,-30,-8,0,0,0
35,42,-7,0,0,0
-20,-30,10,1,1,0
-23,-23,0,0,1,1
26,41,-15,0,1,1
43,31,12,1,1,0
10,9,1,1,1,0
36,17,19,1,1,0
-2,13,-15,0,1,1
-52,-35,-17,0,1,1
24,6,18,1,1,0
-45,-41,-4,0,1,1
-22,-7,-15,0,1,1
11,22,-11,0,1,1
27,29,-2,0,1,1
26,9,17,1,1,0
-28,-36,8,1,1,0
-57,-42,-15,0,1,1
6,5,1,1,1,0
14,28,-14,0,1,1
-53,-43,-10,0,1,1
42,30,12,1,0,1
13,19,-6,0,0,0
-16,-5,-11,0,0,0
39,27,12,1,0,1
28,35,-7,0,0,0
18,33,-15,0,0,0
34,18,16,1,0,1
-40,-32,-8,0,0,0
0,-11,11,1,0,1
-25,-45,20,1,0,1
19,27,-8,0,0,0
1,10,-9,0,1,1
11,15,-4,0,1,1
-24,-8,-16,0,1,1
-59,-45,-14,0,1,1
-6,9,-15,0,1,1
-15,5,-20,0,1,1
19,31,-12,0,1,1
-22,-8,-14,0,1,1
5,25,-20,0,1,1
-40,-27,-13,0,1,1
-34,-45,11,1,1,0
3,21,-18,0,1,1
-33,-18,-15,0,1,1
16,26,-10,0,1,1
31,25,6,1,1,0
14,-4,18,1,1,0
-10,7,-17,0,1,1
-33,-34,1,1,1,0
25,33,-8,0,1,1
28,10,18,1,0,1
-9,5,-14,0,0,0
-27,-26,-1,0,0,0
-30,-14,-16,0,0,0
26,6,20,1,0,1
-26,-27,1,1,0,1
-11,-30,19,1,0,1
-37,-31,-6,0,0,0
-27,-41,14,1,0,1
-8,-3,-5,0,0,0
20,26,-6,0,0,0
18,26,-8,0,0,0
-27,-20,-7,0,0,0
-8,-18,10,1,0,1
44,44,0,0,1,1
0,7,-7,0,1,1
17,34,-17,0,1,1
-58,-45,-13,0,1,1
49,41,8,1,1,0
-2,-16,14,1,1,0
-29,-38,9,1,1,0
28,31,-3,0,1,1
-36,-26,-10,0,1,1
12,20,-8,0,1,1
9,5,4,1,1,0
40,23,17,1,1,0
27,16,11,1,1,0
-41,-44,3,1,1,0
25,42,-17,0,1,1
15,9,6,1,1,0
1,1,0,0,1,1
37,39,-2,0,0,0
0,-7,7,1,0,1
-36,-22,-14,0,0,0
45,28,17,1,0,1
-14,-5,-9,0,0,0
-29,-43,14,1,0,1
-5,-18,13,1,0,1
-34,-14,-20,0,0,0
34,31,3,1,0,1
9,-5,14,1,0,1
-40,-25,-15,0,0,0
5,12,-7,0,1,1
-56,-39,-17,0,1,1
-24,-29,5,1,1,0
-32,-29,-3,0,1,1
-3,15,-18,0,1,1
-43,-32,-11,0,1,1
15,-1,16,1,1,0
46,37,9,1,1,0
14,25,-11,0,1,1
0,-20,20,1,1,0
-31,-29,-2,0,1,1
-51,-35,-16,0,1,1
-20,-9,-11,0,0,0
27,8,19,1,0,1
-30,-12,-18,0,0,0
13,-7,20,1,0,1
-62,-45,-17,0,0,0
45,32,13,1,0,1
-30,-14,-16,0,0,0
-9,2,-11,0,0,0
-51,-36,-15,0,0,0
12,5,7,1,1,0
20,18,2,1,1,0
24,12,12,1,1,0
43,35,8,1,1,0
4,-14,18,1,1,0
-31,-25,-6,0,1,1
18,29,-11,0,1,1
-14,-11,-3,0,1,1
-24,-44,20,1,1,0
12,2,10,1,0,1
-28,-36,8,1,0,1
15,3,12,1,0,1
-20,-20,0,0,0,0
7,26,-19,0,0,0
41,38,3,1,0,1
-10,7,-17,0,0,0
12,-4,16,1,0,1
-29,-41,12,1,0,1
22,18,4,1,0,1
-31,-16,-15,0,0,0
-4,11,-15,0,0,0
-48,-36,-12,0,0,0
-16,2,-18,0,1,1
0,8,-8,0,1,1
14,22,-8,0,1,1
-39,-24,-15,0,1,1
14,22,-8,0,1,1
-47,-29,-18,0,1,1
-1,-1,0,0,1,1
-26,-36,10,1,1,0
-36,-37,1,1,0,1
14,2,12,1,0,1
-42,-38,-4,0,0,0
16,9,7,1,0,1
0,4,-4,0,0,0
43,31,12,1,0,1
-6,12,-18,0,0,0
-6,-1,-5,0,0,0
11,28,-17,0,0,0
28,19,9,1,0,1
-24,-15,-9,0,0,0
-27,-30,3,1,0,1
-10,-16,6,1,0,1
10,19,-9,0,0,0
-4,5,-9,0,0,0
38,40,-2,0,0,0
-15,5,-20,0,0,0
-46,-42,-4,0,0,0
38,39,-1,0,0,0
-28,-32,4,1,0,1
28,9,19,1,0,1
38,34,4,1,1,0
15,13,2,1,1,0
1,-2,3,1,1,0
17,27,-10,0,1,1
-3,-13,10,1,1,0
-16,1,-17,0,1,1
32,20,12,1,1,0
-9,-16,7,1,1,0
50,44,6,1,1,0
-1,13,-14,0,1,1
62,42,20,1,0,1
51,34,17,1,0,1
-24,-26,2,1,0,1
33,14,19,1,0,1
-18,0,-18,0,0,0
-8,11,-19,0,0,0
-24,-9,-15,0,0,0
44,35,9,1,0,1
-1,7,-8,0,0,0
-16,-7,-9,0,0,0
1,-10,11,1,0,1
-45,-26,-19,0,0,0
-34,-30,-4,0,0,0
-3,3,-6,0,0,0
-37,-22,-15,0,1,1
-32,-13,-19,0,1,1
-1,4,-5,0,1,1
0,-2,2,1,1,0
8,-6,14,1,1,0
0,20,-20,0,1,1
20,29,-9,0,1,1
-8,-12,4,1,1,0
-32,-21,-11,0,1,1
34,35,-1,0,1,1
33,19,14,1,1,0
20,40,-20,0,0,0
-36,-42,6,1,0,1
-61,-42,-19,0,0,0
22,28,-6,0,0,0
-17,-21,4,1,0,1
34,14,20,1,0,1
-26,-7,-19,0,0,0
-16,-9,-7,0,0,0
-2,13,-15,0,0,0
-1,13,-14,0,0,0
-30,-36,6,1,0,1
-22,-39,17,1,0,1
56,38,18,1,0,1
-5,13,-18,0,0,0
-2,-11,9,1,0,1
19,0,19,1,0,1
-24,-20,-4,0,0,0
2,18,-16,0,0,0
-28,-36,8,1,1,0
31,30,1,1,1,0
37,17,20,1,1,0
-5,-13,8,1,1,0
-24,-16,-8,0,1,1
31,30,1,1,1,0
-32,-24,-8,0,1,1
48,43,5,1,1,0
-29,-14,-15,0,1,1
14,14,0,0,1,1
35,15,20,1,1,0
-19,-26,7,1,1,0
9,7,2,1,1,0
9,-7,16,1,1,0
24,15,9,1,0,1
23,31,-8,0,0,0
11,6,5,1,0,1
-17,-22,5,1,0,1
14,26,-12,0,0,0
-6,-25,19,1,0,1
52,40,12,1,0,1
-32,-29,-3,0,0,0
2,-3,5,1,0,1
18,9,9,1,0,1
23,15,8,1,0,1
56,43,13,1,0,1
16,8,8,1,0,1
-16,-33,17,1,0,1
46,37,9,1,0,1
-5,-12,7,1,0,1
-40,-30,-10,0,0,0
39,23,16,1,0,1
-18,-30,12,1,0,1
19,28,-9,0,0,0
-25,-9,-16,0,0,0
-26,-26,0,0,1,1
26,26,0,0,1,1
-36,-39,3,1,1,0
-38,-44,6,1,1,0
-2,-5,3,1,1,0
-7,13,-20,0,1,1
4,-12,16,1,1,0
18,24,-6,0,1,1
16,25,-9,0,1,1
-33,-36,3,1,1,0
-9,-29,20,1,1,0
-16,-23,7,1,1,0
27,8,19,1,1,0
-23,-35,12,1,1,0
28,31,-3,0,1,1
-23,-29,6,1,1,0
-55,-40,-15,0,1,1
-7,-9,2,1,1,0
-12,-18,6,1,1,0
-1,-7,6,1,1,0
-15,-13,-2,0,1,1
-21,-20,-1,0,0,0
29,13,16,1,0,1
57,38,19,1,0,1
-32,-34,2,1,0,1
21,8,13,1,0,1
-39,-20,-19,0,0,0
39,31,8,1,0,1
18,19,-1,0,0,0
-27,-15,-12,0,0,0
-13,-30,17,1,0,1
-53,-38,-15,0,0,0
-15,2,-17,0,1,1
7,-9,16,1,1,0
10,4,6,1,1,0
-12,-11,-1,0,1,1
26,21,5,1,1,0
-20,-34,14,1,1,0
5,2,3,1,1,0
-50,-42,-8,0,1,1
-3,-11,8,1,1,0
55,39,16,1,1,0
55,38,17,1,1,0
-12,-22,10,1,1,0
-43,-33,-10,0,0,0
-46,-44,-2,0,0,0
0,-13,13,1,0,1
-40,-40,0,0,0,0
-5,-9,4,1,0,1
22,3,19,1,0,1
-24,-44,20,1,0,1
-12,7,-19,0,0,0
51,32,19,1,0,1
-34,-17,-17,0,0,0
-25,-36,11,1,0,1
26,23,3,1,0,1
-20,-12,-8,0,0,0
-11,-19,8,1,0,1
30,22,8,1,1,0
-36,-24,-12,0,1,1
8,-6,14,1,1,0
-53,-36,-17,0,1,1
46,27,19,1,1,0
-9,1,-10,0,1,1
25,20,5,1,1,0
-13,-19,6,1,1,0
38,33,5,1,1,0
9,5,4,1,1,0
-27,-39,12,1,1,0
-5,-24,19,1,1,0
-9,-20,11,1,1,0
30,29,1,1,1,0
-34,-20,-14,0,1,1
-2,-7,5,1,1,0
19,15,4,1,1,0
4,17,-13,0,1,1
32,42,-10,0,1,1
-21,-6,-15,0,1,1
34,38,-4,0,1,1
28,41,-13,0,0,0
23,26,-3,0,0,0
-37,-34,-3,0,0,0
6,23,-17,0,0,0
-8,4,-12,0,0,0
-14,-6,-8,0,0,0
-8,-23,15,1,0,1
-23,-17,-6,0,0,0
10,7,3,1,0,1
-4,11,-15,0,1,1
13,2,11,1,1,0
-7,-17,10,1,1,0
13,5,8,1,1,0
-3,-9,6,1,1,0
18,37,-19,0,1,1
27,14,13,1,1,0
9,26,-17,0,1,1
4,21,-17,0,1,1
-24,-12,-12,0,1,1
-24,-25,1,1,1,0
12,3,9,1,1,0
-17,-28,11,1,1,0
0,18,-18,0,1,1
-18,-22,4,1,1,0
-11,-8,-3,0,1,1
-11,-19,8,1,1,0
-31,-34,3,1,1,0
2,-17,19,1,1,0
-41,-43,2,1,1,0
-18,-11,-7,0,1,1
-14,-15,1,1,0,1
34,33,1,1,0,1
-4,-2,-2,0,0,0
1,6,-5,0,0,0
29,30,-1,0,0,0
48,28,20,1,0,1
-6,2,-8,0,0,0
-2,-11,9,1,0,1
21,12,9,1,0,1
-34,-25,-9,0,1,1
-14,-33,19,1,1,0
37,39,-2,0,1,1
14,1,13,1,1,0
26,38,-12,0,1,1
-4,11,-15,0,1,1
-43,-39,-4,0,1,1
42,30,12,1,1,0
16,23,-7,0,1,1
-1,-7,6,1,1,0
-29,-42,13,1,1,0
-24,-32,8,1,1,0
-7,-14,7,1,1,0
56,42,14,1,1,0
39,23,16,1,1,0
24,19,5,1,0,1
3,-17,20,1,0,1
-12,5,-17,0,0,0
-38,-30,-8,0,0,0
