first_image,second_image,answers,correct_answer,rule,action
11,-3,14,1,1,0
27,-10,37,1,1,0
8,-5,13,1,1,0
62,22,40,1,1,0
-10,26,-36,0,1,1
20,27,-7,0,1,1
17,8,9,1,1,0
-32,-23,-9,0,1,1
43,37,6,1,1,0
-6,-10,4,1,1,0
-13,-22,9,1,1,0
-47,-3,-44,0,1,1
-6,7,-13,0,1,1
-38,-40,2,1,1,0
35,23,12,1,1,0
24,-11,35,1,1,0
-27,6,-33,0,1,1
17,38,-21,0,1,1
61,37,24,1,1,0
-28,-10,-18,0,1,1
27,-7,34,1,1,0
-46,-28,-18,0,0,0
-2,18,-20,0,0,0
0,-4,4,1,0,1
-17,19,-36,0,0,0
-67,-33,-34,0,0,0
62,41,21,1,0,1
-64,-33,-31,0,0,0
-66,-25,-41,0,0,0
-12,23,-35,0,0,0
46,33,13,1,0,1
-19,-18,-1,0,0,0
-5,-45,40,1,1,0
-19,9,-28,0,1,1
52,44,8,1,1,0
-2,-15,13,1,1,0
45,4,41,1,1,0
20,-10,30,1,1,0
-12,15,-27,0,1,1
-13,16,-29,0,1,1
0,-35,35,1,1,0
-37,-1,-36,0,1,1
-38,4,-42,0,1,1
44,5,39,1,1,0
1,-43,44,1,1,0
33,12,21,1,1,0
17,-28,45,1,1,0
11,-26,37,1,1,0
-12,2,-14,0,1,1
-54,-44,-10,0,1,1
16,-21,37,1,1,0
-15,-3,-12,0,0,0
-26,12,-38,0,0,0
85,44,41,1,0,1
10,17,-7,0,0,0
4,-40,44,1,0,1
-21,17,-38,0,0,0
-15,-25,10,1,0,1
28,31,-3,0,0,0
8,18,-10,0,0,0
-5,-1,-4,0,0,0
-17,2,-19,0,0,0
47,21,26,1,1,0
21,29,-8,0,1,1
7,44,-37,0,1,1
64,28,36,1,1,0
-12,-8,-4,0,1,1
21,36,-15,0,1,1
-81,-39,-42,0,1,1
62,42,20,1,1,0
-62,-17,-45,0,1,1
3,-19,22,1,1,0
13,-7,20,1,1,0
54,23,31,1,0,1
13,17,-4,0,0,0
32,7,25,1,0,1
-52,-41,-11,0,0,0
-25,18,-43,0,0,0
-12,18,-30,0,0,0
35,4,31,1,0,1
-49,-21,-28,0,0,0
-35,-44,9,1,1,0
-27,-11,-16,0,1,1
-63,-25,-38,0,1,1
-17,12,-29,0,1,1
27,26,1,1,1,0
0,-10,10,1,1,0
-11,4,-15,0,1,1
-15,-42,27,1,1,0
-58,-45,-13,0,1,1
-73,-40,-33,0,1,1
-37,3,-40,0,1,1
-15,27,-42,0,1,1
45,31,14,1,1,0
-33,-34,1,1,1,0
-46,-11,-35,0,1,1
-8,7,-15,0,1,1
35,9,26,1,1,0
-42,-39,-3,0,1,1
-3,16,-19,0,0,0
-6,-14,8,1,0,1
18,16,2,1,0,1
-38,-5,-33,0,0,0
6,-21,27,1,0,1
22,31,-9,0,0,0
52,23,29,1,0,1
-50,-28,-22,0,0,0
-6,-29,23,1,0,1
-29,-20,-9,0,0,0
0,2,-2,0,0,0
-49,-6,-43,0,0,0
11,30,-19,0,0,0
60,26,34,1,0,1
-25,-24,-1,0,1,1
19,-6,25,1,1,0
31,9,22,1,1,0
-14,25,-39,0,1,1
42,18,24,1,1,0
-15,-12,-3,0,1,1
-8,-10,2,1,1,0
37,42,-5,0,1,1
14,-9,23,1,1,0
-67,-43,-24,0,1,1
61,16,45,1,1,0
30,43,-13,0,1,1
-31,8,-39,0,1,1
-10,-28,18,1,1,0
-66,-22,-44,0,1,1
38,37,1,1,1,0
33,40,-7,0,1,1
26,39,-13,0,1,1
29,17,12,1,1,0
43,32,11,1,1,0
45,28,17,1,1,0
47,28,19,1,0,1
82,37,45,1,0,1
-29,-32,3,1,0,1
-20,-43,23,1,0,1
-3,-30,27,1,0,1
12,-27,39,1,0,1
-22,-21,-1,0,0,0
-47,-24,-23,0,0,0
-53,-43,-10,0,0,0
16,-11,27,1,0,1
52,36,16,1,0,1
-11,-31,20,1,0,1
18,35,-17,0,0,0
-9,-2,-7,0,0,0
1,-37,38,1,0,1
19,21,-2,0,0,0
-36,-22,-14,0,0,0
-78,-40,-38,0,0,0
-41,-12,-29,0,0,0
-54,-36,-18,0,0,0
-51,-43,-8,0,0,0
-19,-1,-18,0,1,1
-32,-34,2,1,1,0
-14,-30,16,1,1,0
-39,-21,-18,0,1,1
-58,-31,-27,0,1,1
40,18,22,1,1,0
-26,-10,-16,0,1,1
15,17,-2,0,1,1
-27,-20,-7,0,1,1
-8,3,-11,0,1,1
5,36,-31,0,1,1
36,6,30,1,1,0
22,44,-22,0,1,1
23,32,-9,0,1,1
-15,30,-45,0,1,1
-51,-44,-7,0,0,0
2,16,-14,0,0,0
-45,-2,-43,0,0,0
-17,-5,-12,0,0,0
48,22,26,1,0,1
-14,26,-40,0,0,0
15,37,-22,0,0,0
-15,-45,30,1,0,1
28,6,22,1,0,1
24,9,15,1,0,1
47,29,18,1,0,1
-87,-42,-45,0,0,0
-16,-5,-11,0,0,0
-37,3,-40,0,0,0
29,-11,40,1,0,1
-11,-35,24,1,0,1
-10,-24,14,1,1,0
-16,-12,-4,0,1,1
8,19,-11,0,1,1
28,-7,35,1,1,0
16,-11,27,1,1,0
-48,-41,-7,0,1,1
50,20,30,1,1,0
-29,-25,-4,0,1,1
-48,-29,-19,0,0,0
-43,-34,-9,0,0,0
15,6,9,1,0,1
12,-13,25,1,0,1
-12,-26,14,1,0,1
7,2,5,1,0,1
59,24,35,1,0,1
33,18,15,1,0,1
25,19,6,1,0,1
15,3,12,1,0,1
-46,-36,-10,0,0,0
39,32,7,1,1,0
-17,-13,-4,0,1,1
12,41,-29,0,1,1
27,-1,28,1,1,0
-61,-45,-16,0,1,1
72,29,43,1,1,0
81,39,42,1,1,0
5,43,-38,0,1,1
46,13,33,1,1,0
22,-16,38,1,1,0
76,44,32,1,1,0
22,26,-4,0,0,0
-17,-31,14,1,0,1
10,-26,36,1,0,1
28,31,-3,0,0,0
-18,-27,9,1,0,1
31,0,31,1,0,1
-16,5,-21,0,0,0
81,40,41,1,0,1
5,0,5,1,0,1
-70,-30,-40,0,0,0
-11,19,-30,0,0,0
38,43,-5,0,0,0
-13,-8,-5,0,0,0
-44,-32,-12,0,0,0
-48,-15,-33,0,0,0
-41,-12,-29,0,0,0
-31,-22,-9,0,0,0
-24,-34,10,1,1,0
-32,-42,10,1,1,0
-15,-22,7,1,1,0
-32,7,-39,0,1,1
-47,-45,-2,0,1,1
18,-16,34,1,1,0
22,-11,33,1,1,0
3,0,3,1,1,0
1,-5,6,1,1,0
34,29,5,1,1,0
-4,-5,1,1,1,0
-54,-9,-45,0,1,1
0,0,0,0,1,1
55,35,20,1,1,0
43,39,4,1,1,0
-10,-8,-2,0,1,1
-56,-24,-32,0,1,1
12,-31,43,1,1,0
-44,-21,-23,0,1,1
24,39,-15,0,1,1
-74,-44,-30,0,1,1
-7,-5,-2,0,0,0
65,44,21,1,0,1
30,8,22,1,0,1
20,-7,27,1,0,1
26,-17,43,1,0,1
32,22,10,1,0,1
13,-11,24,1,0,1
-45,-17,-28,0,0,0
14,-5,19,1,1,0
-22,15,-37,0,1,1
-55,-27,-28,0,1,1
-17,6,-23,0,1,1
20,36,-16,0,1,1
44,35,9,1,1,0
87,44,43,1,1,0
-83,-39,-44,0,1,1
-21,6,-27,0,1,1
-8,8,-16,0,1,1
-23,-20,-3,0,1,1
40,17,23,1,0,1
5,-18,23,1,0,1
-30,-21,-9,0,0,0
43,37,6,1,0,1
27,39,-12,0,0,0
69,25,44,1,0,1
46,17,29,1,0,1
-48,-44,-4,0,0,0
-7,36,-43,0,0,0
-20,-22,2,1,0,1
15,-18,33,1,0,1
-2,-41,39,1,0,1
17,44,-27,0,0,0
-15,-5,-10,0,0,0
42,10,32,1,0,1
49,4,45,1,0,1
33,-11,44,1,0,1
56,26,30,1,0,1
24,40,-16,0,0,0
29,8,21,1,0,1
-7,-3,-4,0,0,0
-67,-30,-37,0,1,1
-2,43,-45,0,1,1
6,37,-31,0,1,1
0,-37,37,1,1,0
18,-3,21,1,1,0
-8,-45,37,1,1,0
27,42,-15,0,1,1
45,28,17,1,1,0
72,34,38,1,1,0
-54,-11,-43,0,0,0
-50,-6,-44,0,0,0
-58,-41,-17,0,0,0
6,40,-34,0,0,0
-59,-33,-26,0,0,0
31,-7,38,1,0,1
-8,30,-38,0,0,0
44,29,15,1,0,1
-38,-41,3,1,0,1
26,-1,27,1,0,1
44,-1,45,1,1,0
-6,-20,14,1,1,0
15,28,-13,0,1,1
-21,1,-22,0,1,1
2,4,-2,0,1,1
6,37,-31,0,1,1
-36,-35,-1,0,1,1
1,-43,44,1,1,0
54,10,44,1,1,0
0,-18,18,1,0,1
17,33,-16,0,0,0
-68,-34,-34,0,0,0
25,10,15,1,0,1
-28,5,-33,0,0,0
35,14,21,1,0,1
51,24,27,1,0,1
56,34,22,1,0,1
22,27,-5,0,0,0
8,6,2,1,1,0
-12,-37,25,1,1,0
8,-8,16,1,1,0
-52,-41,-11,0,1,1
23,32,-9,0,1,1
-26,-29,3,1,1,0
49,5,44,1,1,0
70,33,37,1,1,0
-24,-39,15,1,1,0
-59,-22,-37,0,1,1
-24,1,-25,0,1,1
17,-20,37,1,1,0
-57,-26,-31,0,1,1
13,-1,14,1,1,0
14,2,12,1,1,0
14,27,-13,0,1,1
56,12,44,1,1,0
-11,-44,33,1,0,1
42,11,31,1,0,1
-4,-1,-3,0,0,0
46,28,18,1,0,1
-45,-18,-27,0,0,0
52,12,40,1,0,1
-11,-20,9,1,0,1
10,30,-20,0,0,0
87,43,44,1,0,1
4,-8,12,1,0,1
56,31,25,1,0,1
21,43,-22,0,0,0
-64,-42,-22,0,0,0
53,19,34,1,0,1
66,27,39,1,0,1
25,-19,44,1,0,1
-47,-38,-9,0,0,0
20,9,11,1,0,1
5,22,-17,0,1,1
11,27,-16,0,1,1
-33,-39,6,1,1,0
-45,-17,-28,0,1,1
-67,-40,-27,0,1,1
-40,1,-41,0,1,1
-43,-32,-11,0,1,1
19,6,13,1,1,0
7,-36,43,1,0,1
-16,-20,4,1,0,1
-41,-27,-14,0,0,0
46,17,29,1,0,1
-12,-25,13,1,0,1
17,-9,26,1,0,1
2,-19,21,1,0,1
73,30,43,1,0,1
5,-10,15,1,0,1
57,29,28,1,1,0
-24,-14,-10,0,1,1
-57,-18,-39,0,1,1
45,39,6,1,1,0
6,3,3,1,1,0
14,30,-16,0,1,1
-66,-23,-43,0,1,1
-9,32,-41,0,1,1
25,1,24,1,1,0
43,37,6,1,1,0
-38,-39,1,1,1,0
68,24,44,1,1,0
17,44,-27,0,0,0
7,-27,34,1,0,1
10,39,-29,0,0,0
-56,-13,-43,0,0,0
36,21,15,1,0,1
-29,10,-39,0,0,0
-63,-41,-22,0,0,0
49,41,8,1,0,1
-34,-39,5,1,0,1
-32,-11,-21,0,0,0
6,-1,7,1,0,1
-27,-14,-13,0,0,0
-3,-5,2,1,0,1
-6,26,-32,0,0,0
-80,-39,-41,0,0,0
25,-13,38,1,1,0
12,33,-21,0,1,1
-66,-27,-39,0,1,1
8,-15,23,1,1,0
8,-34,42,1,1,0
-15,-42,27,1,1,0
35,19,16,1,1,0
-39,1,-40,0,1,1
-1,17,-18,0,0,0
21,17,4,1,0,1
-7,-8,1,1,0,1
-14,-24,10,1,0,1
-51,-18,-33,0,0,0
30,21,9,1,0,1
-56,-37,-19,0,0,0
14,-17,31,1,0,1
-34,-34,0,0,0,0
-39,-28,-11,0,0,0
-10,26,-36,0,0,0
15,11,4,1,0,1
-31,-7,-24,0,0,0
-14,20,-34,0,0,0
40,34,6,1,0,1
-37,4,-41,0,0,0
-73,-41,-32,0,0,0
13,-4,17,1,0,1
-21,14,-35,0,0,0
-40,0,-40,0,0,0
-11,11,-22,0,0,0
-37,-24,-13,0,1,1
38,12,26,1,1,0
-13,15,-28,0,1,1
74,32,42,1,1,0
-7,-5,-2,0,1,1
32,42,-10,0,1,1
-45,-30,-15,0,1,1
61,16,45,1,1,0
-38,-32,-6,0,1,1
-18,-30,12,1,1,0
-2,14,-16,0,1,1
-9,-17,8,1,1,0
-3,-41,38,1,1,0
20,15,5,1,1,0
37,29,8,1,1,0
-48,-41,-7,0,1,1
20,-6,26,1,1,0
-17,9,-26,0,0,0
-12,1,-13,0,0,0
-19,-11,-8,0,0,0
-9,20,-29,0,0,0
-16,-40,24,1,0,1
-24,-24,0,0,0,0
49,11,38,1,0,1
-20,-44,24,1,0,1
67,23,44,1,0,1
-9,-43,34,1,0,1
-49,-8,-41,0,0,0
28,-12,40,1,0,1
-51,-35,-16,0,0,0
-4,28,-32,0,0,0
24,41,-17,0,0,0
-14,18,-32,0,1,1
4,-12,16,1,1,0
38,22,16,1,1,0
-36,-28,-8,0,1,1
31,-9,40,1,1,0
9,-25,34,1,1,0
46,28,18,1,1,0
-23,-28,5,1,1,0
-78,-42,-36,0,1,1
-17,-18,1,1,1,0
-58,-14,-44,0,1,1
35,-6,41,1,1,0
-31,6,-37,0,1,1
9,30,-21,0,0,0
16,-8,24,1,0,1
12,32,-20,0,0,0
7,26,-19,0,0,0
-19,-26,7,1,0,1
-15,21,-36,0,0,0
48,41,7,1,0,1
9,22,-13,0,0,0
45,42,3,1,0,1
26,15,11,1,0,1
6,25,-19,0,0,0
-20,-40,20,1,0,1
47,38,9,1,0,1
14,10,4,1,0,1
-14,-15,1,1,0,1
-29,-11,-18,0,0,0
5,5,0,0,0,0
-6,-9,3,1,0,1
-18,15,-33,0,1,1
14,43,-29,0,1,1
12,-5,17,1,1,0
10,-15,25,1,1,0
53,27,26,1,1,0
-12,-14,2,1,1,0
28,-7,35,1,1,0
29,-2,31,1,1,0
37,-1,38,1,1,0
10,41,-31,0,1,1
-35,-2,-33,0,1,1
11,12,-1,0,1,1
34,20,14,1,1,0
63,29,34,1,1,0
21,-22,43,1,1,0
2,-29,31,1,1,0
36,33,3,1,1,0
34,20,14,1,1,0
73,40,33,1,1,0
24,21,3,1,1,0
7,-13,20,1,0,1
-20,-41,21,1,0,1
37,0,37,1,0,1
-6,-11,5,1,0,1
15,33,-18,0,0,0
21,13,8,1,0,1
53,23,30,1,0,1
22,-9,31,1,0,1
81,38,43,1,0,1
11,-5,16,1,0,1
-38,-34,-4,0,0,0
-40,-18,-22,0,0,0
4,30,-26,0,0,0
-61,-36,-25,0,0,0
41,14,27,1,0,1
54,36,18,1,0,1
8,-20,28,1,0,1
40,33,7,1,0,1
31,33,-2,0,0,0
-4,31,-35,0,0,0
34,28,6,1,0,1
38,23,15,1,1,0
40,8,32,1,1,0
-49,-24,-25,0,1,1
37,43,-6,0,1,1
3,20,-17,0,1,1
44,15,29,1,1,0
28,14,14,1,1,0
36,31,5,1,1,0
9,10,-1,0,1,1
22,-7,29,1,1,0
16,-5,21,1,1,0
25,19,6,1,1,0
3,-18,21,1,1,0
19,28,-9,0,0,0
-40,-30,-10,0,0,0
-23,21,-44,0,0,0
-24,6,-30,0,0,0
-7,-14,7,1,0,1
-5,-12,7,1,0,1
31,37,-6,0,0,0
0,-32,32,1,0,1
-47,-26,-21,0,0,0
25,-2,27,1,0,1
38,-5,43,1,0,1
-22,9,-31,0,0,0
-1,-30,29,1,0,1
27,-13,40,1,0,1
47,15,32,1,0,1
-35,-6,-29,0,0,0
23,21,2,1,0,1
11,-15,26,1,0,1
85,43,42,1,0,1
12,-9,21,1,1,0
61,37,24,1,1,0
-3,20,-23,0,1,1
37,28,9,1,1,0
27,10,17,1,1,0
-7,-1,-6,0,1,1
-51,-26,-25,0,1,1
26,9,17,1,1,0
33,7,26,1,1,0
50,44,6,1,0,1
-39,-35,-4,0,0,0
0,33,-33,0,0,0
-17,-14,-3,0,0,0
-16,28,-44,0,0,0
29,-14,43,1,0,1
-49,-20,-29,0,0,0
-16,-10,-6,0,0,0
54,15,39,1,1,0
10,30,-20,0,1,1
-65,-38,-27,0,1,1
-41,-18,-23,0,1,1
-27,-13,-14,0,1,1
-12,-37,25,1,1,0
-61,-18,-43,0,1,1
-23,-26,3,1,1,0
20,20,0,0,1,1
-3,40,-43,0,1,1
18,36,-18,0,0,0
36,39,-3,0,0,0
-66,-45,-21,0,0,0
61,20,41,1,0,1
-59,-35,-24,0,0,0
-40,-16,-24,0,0,0
31,42,-11,0,0,0
7,44,-37,0,0,0
-25,-29,4,1,0,1
19,1,18,1,1,0
53,18,35,1,1,0
-46,-38,-8,0,1,1
-33,-3,-30,0,1,1
-11,-21,10,1,1,0
-67,-43,-24,0,1,1
0,-19,19,1,1,0
52,43,9,1,1,0
3,36,-33,0,1,1
24,-12,36,1,0,1
-48,-5,-43,0,0,0
-78,-38,-40,0,0,0
-4,-44,40,1,0,1
-56,-44,-12,0,0,0
39,5,34,1,0,1
76,39,37,1,0,1
-63,-42,-21,0,0,0
-6,-10,4,1,0,1
74,29,45,1,0,1
13,-18,31,1,1,0
66,35,31,1,1,0
-1,-42,41,1,1,0
50,21,29,1,1,0
45,28,17,1,1,0
39,37,2,1,1,0
-6,31,-37,0,1,1
-3,20,-23,0,1,1
53,8,45,1,1,0
-14,-33,19,1,1,0
-3,-10,7,1,1,0
1,-36,37,1,1,0
-1,-14,13,1,1,0
-21,-34,13,1,1,0
35,34,1,1,1,0
-7,-39,32,1,1,0
-4,-7,3,1,1,0
-39,-45,6,1,1,0
-38,-24,-14,0,1,1
-86,-45,-41,0,1,1
-28,-23,-5,0,1,1
-37,7,-44,0,0,0
58,29,29,1,0,1
9,-32,41,1,0,1
-17,8,-25,0,0,0
-6,-24,18,1,0,1
0,-26,26,1,0,1
-37,-20,-17,0,0,0
10,38,-28,0,0,0
58,25,33,1,0,1
7,-30,37,1,0,1
-34,-28,-6,0,0,0
-39,-19,-20,0,0,0
-31,-4,-27,0,0,0
-65,-44,-21,0,0,0
28,-7,35,1,0,1
48,27,21,1,0,1
42,10,32,1,0,1
-21,15,-36,0,0,0
-25,-5,-20,0,0,0
-28,-13,-15,0,0,0
21,1,20,1,0,1
-1,0,-1,0,1,1
40,-3,43,1,1,0
-52,-22,-30,0,1,1
16,13,3,1,1,0
-16,16,-32,0,1,1
-4,13,-17,0,1,1
51,13,38,1,1,0
34,-9,43,1,1,0
-6,12,-18,0,1,1
1,-20,21,1,0,1
-23,12,-35,0,0,0
46,8,38,1,0,1
-32,-21,-11,0,0,0
78,38,40,1,0,1
17,31,-14,0,0,0
9,27,-18,0,0,0
8,-28,36,1,0,1
8,-10,18,1,0,1
50,18,32,1,0,1
-64,-29,-35,0,0,0
5,21,-16,0,0,0
13,40,-27,0,0,0
2,21,-19,0,0,0
10,17,-7,0,0,0
-6,-1,-5,0,0,0
53,18,35,1,0,1
14,-5,19,1,0,1
45,19,26,1,0,1
-30,-12,-18,0,0,0
7,-3,10,1,0,1
-18,20,-38,0,1,1
-78,-33,-45,0,1,1
-73,-44,-29,0,1,1
-45,-13,-32,0,1,1
37,32,5,1,1,0
-78,-33,-45,0,1,1
9,36,-27,0,1,1
28,11,17,1,1,0
9,5,4,1,1,0
-19,24,-43,0,1,1
34,35,-1,0,0,0
-41,-26,-15,0,0,0
21,-14,35,1,0,1
-50,-43,-7,0,0,0
-11,29,-40,0,0,0
-41,-25,-16,0,0,0
-4,-34,30,1,0,1
24,-19,43,1,0,1
-66,-24,-42,0,0,0
75,34,41,1,0,1
-21,-30,9,1,0,1
-3,-23,20,1,0,1
27,18,9,1,0,1
-10,-20,10,1,0,1
-31,-41,10,1,0,1
15,23,-8,0,0,0
-73,-35,-38,0,0,0
60,20,40,1,0,1
-47,-23,-24,0,0,0
31,14,17,1,0,1
-84,-44,-40,0,0,0
-71,-40,-31,0,1,1
-48,-3,-45,0,1,1
-41,1,-42,0,1,1
-71,-29,-42,0,1,1
79,38,41,1,1,0
27,16,11,1,1,0
3,1,2,1,1,0
-41,3,-44,0,1,1
-1,-7,6,1,1,0
37,29,8,1,1,0
-35,-16,-19,0,1,1
72,35,37,1,1,0
22,-22,44,1,1,0
-81,-38,-43,0,1,1
21,27,-6,0,1,1
-63,-39,-24,0,1,1
-12,15,-27,0,1,1
3,11,-8,0,0,0
1,-10,11,1,0,1
60,28,32,1,0,1
-15,-35,20,1,0,1
72,38,34,1,0,1
9,11,-2,0,0,0
3,-37,40,1,0,1
-67,-39,-28,0,0,0
68,41,27,1,0,1
9,6,3,1,1,0
14,39,-25,0,1,1
-80,-40,-40,0,1,1
-58,-14,-44,0,1,1
-20,-37,17,1,1,0
-5,4,-9,0,1,1
24,31,-7,0,1,1
41,2,39,1,1,0
27,4,23,1,1,0
-1,-8,7,1,1,0
29,44,-15,0,1,1
75,34,41,1,0,1
11,28,-17,0,0,0
18,7,11,1,0,1
-43,-44,1,1,0,1
-2,37,-39,0,0,0
45,33,12,1,0,1
-5,-45,40,1,0,1
34,2,32,1,0,1
23,43,-20,0,0,0
8,37,-29,0,0,0
-54,-34,-20,0,0,0
26,-2,28,1,0,1
86,43,43,1,0,1
-15,-30,15,1,0,1
-7,-21,14,1,0,1
24,13,11,1,0,1
6,-33,39,1,0,1
-16,-18,2,1,0,1
58,21,37,1,1,0
17,30,-13,0,1,1
-2,-34,32,1,1,0
4,40,-36,0,1,1
-6,-2,-4,0,1,1
-31,-38,7,1,1,0
21,-7,28,1,1,0
16,18,-2,0,1,1
33,18,15,1,1,0
1,35,-34,0,1,1
-87,-44,-43,0,1,1
27,-9,36,1,1,0
48,29,19,1,1,0
16,-19,35,1,0,1
-3,-6,3,1,0,1
12,-3,15,1,0,1
45,5,40,1,0,1
-1,-27,26,1,0,1
19,24,-5,0,0,0
0,-1,1,1,0,1
-13,5,-18,0,0,0
18,-12,30,1,0,1
-49,-14,-35,0,0,0
57,40,17,1,0,1
43,34,9,1,0,1
28,35,-7,0,0,0
-14,24,-38,0,0,0
-10,16,-26,0,0,0
31,-5,36,1,0,1
-49,-27,-22,0,0,0
77,37,40,1,0,1
-65,-33,-32,0,0,0
-13,-23,10,1,0,1
22,-5,27,1,0,1
-55,-27,-28,0,1,1
32,5,27,1,1,0
26,41,-15,0,1,1
-41,-5,-36,0,1,1
28,36,-8,0,1,1
-33,-1,-32,0,1,1
45,16,29,1,1,0
-48,-33,-15,0,1,1
41,14,27,1,1,0
-50,-20,-30,0,1,1
77,39,38,1,1,0
53,16,37,1,1,0
-77,-39,-38,0,1,1
-1,-18,17,1,0,1
-41,-1,-40,0,0,0
64,28,36,1,0,1
51,31,20,1,0,1
-18,-14,-4,0,0,0
65,21,44,1,0,1
-26,7,-33,0,0,0
11,44,-33,0,0,0
-14,18,-32,0,0,0
3,30,-27,0,0,0
-18,15,-33,0,0,0
-53,-39,-14,0,0,0
37,25,12,1,0,1
15,37,-22,0,0,0
58,38,20,1,0,1
-15,6,-21,0,0,0
12,3,9,1,0,1
2,-19,21,1,0,1
-15,12,-27,0,0,0
61,29,32,1,0,1
48,36,12,1,0,1
-50,-22,-28,0,1,1
16,-3,19,1,1,0
-23,-32,9,1,1,0
-28,-15,-13,0,1,1
30,-8,38,1,1,0
68,43,25,1,1,0
-48,-20,-28,0,1,1
44,-1,45,1,1,0
8,-35,43,1,0,1
20,-7,27,1,0,1
52,17,35,1,0,1
2,2,0,0,0,0
22,-22,44,1,0,1
15,12,3,1,0,1
-35,3,-38,0,0,0
0,-4,4,1,0,1
13,8,5,1,0,1
-7,12,-19,0,0,0
32,32,0,0,1,1
-37,4,-41,0,1,1
-45,-45,0,0,1,1
20,32,-12,0,1,1
-39,-5,-34,0,1,1
-67,-22,-45,0,1,1
-33,-13,-20,0,1,1
-8,-15,7,1,1,0
78,41,37,1,1,0
19,5,14,1,1,0
35,41,-6,0,1,1
21,-5,26,1,1,0
-76,-41,-35,0,1,1
-47,-35,-12,0,1,1
15,-9,24,1,1,0
-34,-2,-32,0,1,1
-3,-20,17,1,0,1
-4,-3,-1,0,0,0
-79,-44,-35,0,0,0
28,42,-14,0,0,0
26,11,15,1,0,1
-23,-39,16,1,0,1
47,31,16,1,0,1
-23,12,-35,0,0,0
10,38,-28,0,0,0
-3,19,-22,0,0,0
28,40,-12,0,0,0
12,-8,20,1,0,1
4,34,-30,0,0,0
-24,-23,-1,0,0,0
3,36,-33,0,0,0
-56,-22,-34,0,0,0
60,38,22,1,0,1
-34,-34,0,0,0,0
3,20,-17,0,0,0
-25,14,-39,0,0,0
-13,15,-28,0,0,0
37,26,11,1,1,0
16,-28,44,1,1,0
2,-12,14,1,1,0
30,26,4,1,1,0
52,22,30,1,1,0
-6,23,-29,0,1,1
-12,-39,27,1,1,0
-42,-28,-14,0,1,1
-10,19,-29,0,1,1
67,33,34,1,1,0
-29,-15,-14,0,1,1
-9,-23,14,1,1,0
-33,-13,-20,0,1,1
57,29,28,1,1,0
69,28,41,1,1,0
-50,-7,-43,0,1,1
22,41,-19,0,0,0
-11,0,-11,0,0,0
11,41,-30,0,0,0
31,21,10,1,0,1
-1,2,-3,0,0,0
58,44,14,1,0,1
18,17,1,1,0,1
-59,-34,-25,0,0,0
20,5,15,1,0,1
66,30,36,1,0,1
1,-24,25,1,0,1
10,34,-24,0,0,0
59,31,28,1,0,1
13,-10,23,1,0,1
4,31,-27,0,0,0
9,8,1,1,0,1
-43,-20,-23,0,0,0
61,18,43,1,0,1
15,2,13,1,0,1
48,18,30,1,0,1
59,35,24,1,1,0
19,-10,29,1,1,0
-19,-20,1,1,1,0
-5,19,-24,0,1,1
-69,-25,-44,0,1,1
22,4,18,1,1,0
-37,-8,-29,0,1,1
-4,-23,19,1,1,0
-27,-10,-17,0,1,1
75,42,33,1,1,0
-18,-43,25,1,1,0
-45,-26,-19,0,0,0
-16,-23,7,1,0,1
4,25,-21,0,0,0
16,25,-9,0,0,0
30,10,20,1,0,1
62,23,39,1,0,1
-45,-10,-35,0,0,0
11,-8,19,1,0,1
15,24,-9,0,0,0
-23,9,-32,0,0,0
19,-18,37,1,0,1
-45,-13,-32,0,0,0
-28,10,-38,0,0,0
-55,-29,-26,0,0,0
23,26,-3,0,0,0
76,40,36,1,0,1
1,6,-5,0,0,0
-77,-45,-32,0,0,0
25,30,-5,0,0,0
-35,-25,-10,0,0,0
-18,-42,24,1,0,1
-30,-16,-14,0,1,1
-2,-20,18,1,1,0
-10,-9,-1,0,1,1
-5,-22,17,1,1,0
59,44,15,1,1,0
-57,-27,-30,0,1,1
22,19,3,1,1,0
-35,7,-42,0,1,1
2,-34,36,1,1,0
-45,-43,-2,0,1,1
-38,-36,-2,0,1,1
34,38,-4,0,1,1
8,0,8,1,1,0
28,24,4,1,0,1
-5,-21,16,1,0,1
-31,-35,4,1,0,1
-56,-28,-28,0,0,0
56,27,29,1,0,1
-63,-43,-20,0,0,0
50,17,33,1,0,1
33,24,9,1,0,1
38,5,33,1,0,1
14,1,13,1,0,1
-62,-21,-41,0,0,0
-21,17,-38,0,0,0
8,32,-24,0,0,0
6,23,-17,0,0,0
-4,-33,29,1,0,1
-18,-38,20,1,0,1
60,18,42,1,0,1
-68,-32,-36,0,0,0
45,1,44,1,0,1
-17,-4,-13,0,0,0
-2,-44,42,1,0,1
-38,-37,-1,0,1,1
3,31,-28,0,1,1
-29,-41,12,1,1,0
1,15,-14,0,1,1
-25,-21,-4,0,1,1
-24,-29,5,1,1,0
-48,-20,-28,0,1,1
-86,-44,-42,0,1,1
35,34,1,1,1,0
-45,-23,-22,0,1,1
17,-2,19,1,1,0
-34,-21,-13,0,1,1
9,-28,37,1,0,1
-23,-6,-17,0,0,0
-20,-41,21,1,0,1
83,40,43,1,0,1
42,10,32,1,0,1
-3,-42,39,1,0,1
-42,-14,-28,0,0,0
-27,-32,5,1,0,1
-75,-34,-41,0,0,0
-39,-2,-37,0,0,0
14,27,-13,0,0,0
-40,-9,-31,0,0,0
-17,-22,5,1,0,1
39,14,25,1,0,1
-27,-22,-5,0,0,0
-22,-41,19,1,0,1
-37,-41,4,1,1,0
17,15,2,1,1,0
-15,-44,29,1,1,0
-17,26,-43,0,1,1
81,43,38,1,1,0
35,43,-8,0,1,1
2,-40,42,1,1,0
70,42,28,1,1,0
-4,38,-42,0,1,1
0,-9,9,1,1,0
54,19,35,1,1,0
-19,-22,3,1,1,0
57,36,21,1,1,0
21,23,-2,0,1,1
37,10,27,1,1,0
-22,8,-30,0,1,1
-47,-35,-12,0,1,1
39,31,8,1,1,0
16,34,-18,0,1,1
19,-16,35,1,1,0
5,34,-29,0,1,1
-53,-33,-20,0,0,0
-7,9,-16,0,0,0
29,1,28,1,0,1
-40,-2,-38,0,0,0
-54,-10,-44,0,0,0
41,-4,45,1,0,1
39,6,33,1,0,1
-5,-33,28,1,0,1
39,17,22,1,0,1
-28,-8,-20,0,0,0
-23,-31,8,1,0,1
-27,-27,0,0,0,0
55,16,39,1,0,1
-3,14,-17,0,0,0
43,30,13,1,0,1
-30,-18,-12,0,1,1
5,-28,33,1,1,0
71,40,31,1,1,0
48,11,37,1,1,0
19,24,-5,0,1,1
-67,-40,-27,0,1,1
-7,10,-17,0,1,1
-27,-21,-6,0,1,1
-37,-45,8,1,1,0
27,0,27,1,0,1
29,35,-6,0,0,0
16,1,15,1,0,1
-9,-2,-7,0,0,0
-17,-2,-15,0,0,0
52,11,41,1,0,1
56,36,20,1,0,1
9,19,-10,0,0,0
14,30,-16,0,0,0
52,24,28,1,0,1
-20,14,-34,0,0,0
-88,-44,-44,0,1,1
1,27,-26,0,1,1
14,31,-17,0,1,1
8,-13,21,1,1,0
-5,-45,40,1,1,0
26,35,-9,0,1,1
-29,6,-35,0,1,1
-16,-3,-13,0,1,1
-69,-32,-37,0,1,1
-10,31,-41,0,1,1
38,7,31,1,1,0
-18,-5,-13,0,1,1
-19,-16,-3,0,1,1
-18,10,-28,0,1,1
15,-6,21,1,1,0
41,-3,44,1,1,0
22,0,22,1,1,0
18,34,-16,0,1,1
4,28,-24,0,1,1
11,-11,22,1,1,0
-39,5,-44,0,1,1
-35,-45,10,1,0,1
40,38,2,1,0,1
61,23,38,1,0,1
14,21,-7,0,0,0
-39,4,-43,0,0,0
2,11,-9,0,0,0
-21,-16,-5,0,0,0
-46,-7,-39,0,0,0
-29,16,-45,0,0,0
-45,-29,-16,0,1,1
59,40,19,1,1,0
0,-37,37,1,1,0
4,-18,22,1,1,0
67,37,30,1,1,0
-39,-15,-24,0,1,1
46,28,18,1,1,0
59,37,22,1,1,0
-36,-32,-4,0,0,0
16,-8,24,1,0,1
31,12,19,1,0,1
45,23,22,1,0,1
4,-38,42,1,0,1
-1,27,-28,0,0,0
31,26,5,1,0,1
24,6,18,1,0,1
-17,-35,18,1,0,1
-11,29,-40,0,0,0
67,33,34,1,1,0
26,40,-14,0,1,1
-5,-3,-2,0,1,1
23,-6,29,1,1,0
-12,23,-35,0,1,1
-38,-40,2,1,1,0
-5,12,-17,0,1,1
25,25,0,0,1,1
-41,-12,-29,0,1,1
-23,-29,6,1,1,0
-42,-16,-26,0,1,1
-16,-32,16,1,1,0
6,-21,27,1,1,0
49,23,26,1,0,1
-11,12,-23,0,0,0
-16,-3,-13,0,0,0
-30,-36,6,1,0,1
32,18,14,1,0,1
-34,2,-36,0,0,0
27,-6,33,1,0,1
24,31,-7,0,0,0
65,44,21,1,0,1
-4,13,-17,0,0,0
8,29,-21,0,0,0
-58,-43,-15,0,0,0
6,37,-31,0,0,0
-11,-24,13,1,0,1
-19,-1,-18,0,0,0
-6,-18,12,1,0,1
-38,2,-40,0,0,0
-28,-33,5,1,0,1
9,-31,40,1,0,1
19,4,15,1,0,1
6,41,-35,0,1,1
36,44,-8,0,1,1
42,12,30,1,1,0
29,-16,45,1,1,0
-16,-3,-13,0,1,1
-25,-17,-8,0,1,1
-63,-40,-23,0,1,1
-55,-32,-23,0,1,1
37,21,16,1,1,0
1,37,-36,0,1,1
-1,-43,42,1,1,0
-3,26,-29,0,1,1
52,39,13,1,1,0
-71,-45,-26,0,1,1
-29,-31,2,1,1,0
-63,-32,-31,0,1,1
23,43,-20,0,1,1
-41,-30,-11,0,1,1
-4,34,-38,0,1,1
-19,22,-41,0,1,1
-41,-16,-25,0,0,0
68,38,30,1,0,1
-84,-42,-42,0,0,0
-8,4,-12,0,0,0
14,28,-14,0,0,0
12,8,4,1,0,1
36,41,-5,0,0,0
-31,-31,0,0,0,0
34,17,17,1,0,1
35,20,15,1,0,1
-23,1,-24,0,1,1
-18,27,-45,0,1,1
-84,-39,-45,0,1,1
-13,-7,-6,0,1,1
-7,-18,11,1,1,0
-80,-38,-42,0,1,1
7,-32,39,1,1,0
18,18,0,0,1,1
-10,-28,18,1,1,0
54,44,10,1,1,0
-3,-4,1,1,1,0
5,-3,8,1,1,0
20,31,-11,0,1,1
-12,-29,17,1,1,0
42,30,12,1,1,0
-27,0,-27,0,1,1
-13,-2,-11,0,1,1
-37,-7,-30,0,1,1
75,40,35,1,0,1
-52,-26,-26,0,0,0
-33,-7,-26,0,0,0
11,-23,34,1,0,1
-24,-19,-5,0,0,0
66,27,39,1,0,1
27,0,27,1,0,1
38,14,24,1,0,1
42,19,23,1,0,1
22,-4,26,1,0,1
-7,-37,30,1,1,0
9,-9,18,1,1,0
-23,-27,4,1,1,0
-29,-35,6,1,1,0
19,11,8,1,1,0
46,17,29,1,1,0
19,7,12,1,1,0
-6,-1,-5,0,1,1
-10,-28,18,1,1,0
-63,-27,-36,0,1,1
-31,-37,6,1,1,0
-2,-26,24,1,1,0
-14,-5,-9,0,1,1
41,29,12,1,1,0
19,-24,43,1,1,0
-23,14,-37,0,1,1
8,18,-10,0,0,0
-18,-24,6,1,0,1
-13,-40,27,1,0,1
26,2,24,1,0,1
39,-3,42,1,0,1
-25,-7,-18,0,0,0
2,34,-32,0,0,0
42,9,33,1,0,1
19,-16,35,1,0,1
-55,-33,-22,0,0,0
62,33,29,1,1,0
-33,-7,-26,0,1,1
-58,-20,-38,0,1,1
32,31,1,1,1,0
-46,-26,-20,0,1,1
27,6,21,1,1,0
7,-31,38,1,1,0
19,33,-14,0,1,1
16,18,-2,0,1,1
-33,12,-45,0,0,0
5,42,-37,0,0,0
24,19,5,1,0,1
-46,-23,-23,0,0,0
69,40,29,1,0,1
-25,-16,-9,0,0,0
-39,-31,-8,0,0,0
0,19,-19,0,0,0
71,38,33,1,0,1
-22,-37,15,1,0,1
67,28,39,1,0,1
20,26,-6,0,0,0
2,-32,34,1,0,1
-33,-41,8,1,0,1
73,43,30,1,0,1
2,-11,13,1,0,1
-49,-28,-21,0,0,0
2,17,-15,0,0,0
38,13,25,1,0,1
-17,-20,3,1,0,1
-14,-22,8,1,0,1
62,18,44,1,1,0
16,-7,23,1,1,0
-56,-40,-16,0,1,1
33,33,0,0,1,1
24,40,-16,0,1,1
-9,28,-37,0,1,1
-17,-5,-12,0,1,1
0,-34,34,1,1,0
-37,-22,-15,0,1,1
43,37,6,1,1,0
3,-10,13,1,1,0
28,30,-2,0,1,1
-53,-36,-17,0,0,0
-16,-14,-2,0,0,0
62,19,43,1,0,1
-30,9,-39,0,0,0
-23,-1,-22,0,0,0
47,43,4,1,0,1
-13,11,-24,0,0,0
-59,-34,-25,0,0,0
6,36,-30,0,1,1
45,12,33,1,1,0
-38,3,-41,0,1,1
28,35,-7,0,1,1
4,13,-9,0,1,1
18,30,-12,0,1,1
30,4,26,1,1,0
49,38,11,1,1,0
6,-6,12,1,1,0
-56,-30,-26,0,1,1
-7,2,-9,0,1,1
31,41,-10,0,1,1
-4,15,-19,0,1,1
25,-13,38,1,1,0
-44,-24,-20,0,1,1
78,36,42,1,1,0
-11,32,-43,0,1,1
-10,19,-29,0,1,1
40,25,15,1,1,0
-3,40,-43,0,1,1
42,31,11,1,0,1
73,37,36,1,0,1
14,-14,28,1,0,1
3,7,-4,0,0,0
34,27,7,1,0,1
65,23,42,1,0,1
-55,-12,-43,0,0,0
16,41,-25,0,0,0
-19,-2,-17,0,0,0
20,36,-16,0,0,0
-25,10,-35,0,0,0
-20,-10,-10,0,0,0
60,20,40,1,0,1
46,1,45,1,0,1
35,39,-4,0,0,0
-10,32,-42,0,0,0
18,-17,35,1,0,1
-19,-4,-15,0,0,0
32,10,22,1,0,1
37,29,8,1,0,1
1,13,-12,0,0,0
-33,-12,-21,0,1,1
33,4,29,1,1,0
-3,27,-30,0,1,1
52,20,32,1,1,0
-16,24,-40,0,1,1
-36,-11,-25,0,1,1
48,33,15,1,1,0
22,40,-18,0,1,1
-14,11,-25,0,1,1
-32,-28,-4,0,1,1
23,40,-17,0,1,1
8,26,-18,0,1,1
52,11,41,1,0,1
-30,-14,-16,0,0,0
18,29,-11,0,0,0
30,11,19,1,0,1
48,37,11,1,0,1
8,-20,28,1,0,1
-7,-24,17,1,0,1
-16,-41,25,1,0,1
54,39,15,1,0,1
70,33,37,1,0,1
-5,-41,36,1,0,1
-62,-19,-43,0,1,1
-11,-13,2,1,1,0
39,2,37,1,1,0
-7,6,-13,0,1,1
33,-3,36,1,1,0
-23,-13,-10,0,1,1
44,28,16,1,1,0
18,-17,35,1,1,0
-11,-17,6,1,1,0
40,7,33,1,1,0
-37,-37,0,0,1,1
-68,-26,-42,0,1,1
16,20,-4,0,1,1
-28,-26,-2,0,1,1
-70,-37,-33,0,1,1
-21,-13,-8,0,1,1
11,43,-32,0,1,1
17,34,-17,0,1,1
-52,-44,-8,0,1,1
20,36,-16,0,1,1
-55,-30,-25,0,1,1
-27,-31,4,1,0,1
-53,-42,-11,0,0,0
-7,30,-37,0,0,0
-21,12,-33,0,0,0
16,27,-11,0,0,0
-40,-16,-24,0,0,0
-19,-31,12,1,0,1
-15,29,-44,0,0,0
-59,-15,-44,0,0,0
-12,-23,11,1,0,1
23,9,14,1,0,1
-22,3,-25,0,0,0
15,-3,18,1,0,1
-31,-1,-30,0,0,0
-25,-25,0,0,1,1
-63,-41,-22,0,1,1
6,-11,17,1,1,0
-51,-26,-25,0,1,1
-52,-20,-32,0,1,1
-4,2,-6,0,1,1
-17,-14,-3,0,1,1
34,43,-9,0,1,1
8,29,-21,0,1,1
-23,4,-27,0,0,0
41,1,40,1,0,1
2,28,-26,0,0,0
18,11,7,1,0,1
-25,-11,-14,0,0,0
1,-22,23,1,0,1
32,33,-1,0,0,0
19,23,-4,0,0,0
-58,-36,-22,0,0,0
67,33,34,1,0,1
-26,-13,-13,0,1,1
23,21,2,1,1,0
5,27,-22,0,1,1
-8,35,-43,0,1,1
18,7,11,1,1,0
75,36,39,1,1,0
4,-2,6,1,1,0
39,26,13,1,1,0
29,5,24,1,1,0
17,-5,22,1,1,0
44,21,23,1,1,0
3,-33,36,1,0,1
8,2,6,1,0,1
18,31,-13,0,0,0
46,10,36,1,0,1
17,-12,29,1,0,1
10,14,-4,0,0,0
-46,-28,-18,0,0,0
45,28,17,1,0,1
-33,-1,-32,0,0,0
42,33,9,1,0,1
-9,-6,-3,0,1,1
-28,-8,-20,0,1,1
19,10,9,1,1,0
72,29,43,1,1,0
-36,-20,-16,0,1,1
-3,8,-11,0,1,1
41,9,32,1,1,0
64,34,30,1,1,0
-43,-16,-27,0,1,1
-4,-33,29,1,1,0
-42,-30,-12,0,1,1
-15,-20,5,1,1,0
77,42,35,1,1,0
0,41,-41,0,1,1
15,26,-11,0,1,1
27,-4,31,1,1,0
29,28,1,1,1,0
-12,31,-43,0,1,1
-41,-38,-3,0,1,1
50,8,42,1,1,0
30,16,14,1,0,1
36,44,-8,0,0,0
-37,-27,-10,0,0,0
7,1,6,1,0,1
-6,-44,38,1,0,1
37,39,-2,0,0,0
-4,19,-23,0,0,0
-12,9,-21,0,0,0
-39,-38,-1,0,0,0
-23,22,-45,0,0,0
19,20,-1,0,0,0
-65,-27,-38,0,0,0
-45,-5,-40,0,1,1
31,-10,41,1,1,0
23,28,-5,0,1,1
-41,-11,-30,0,1,1
-53,-33,-20,0,1,1
-34,10,-44,0,1,1
7,-38,45,1,1,0
8,-20,28,1,1,0
-21,2,-23,0,1,1
-23,-11,-12,0,1,1
-1,13,-14,0,1,1
9,-12,21,1,1,0
57,19,38,1,1,0
-15,-35,20,1,1,0
-25,-25,0,0,1,1
-51,-33,-18,0,1,1
-21,-7,-14,0,1,1
-35,-23,-12,0,1,1
9,1,8,1,1,0
-14,2,-16,0,0,0
4,43,-39,0,0,0
38,-3,41,1,0,1
-33,-19,-14,0,0,0
-33,-37,4,1,0,1
-9,27,-36,0,0,0
-13,20,-33,0,0,0
57,12,45,1,0,1
-29,-4,-25,0,0,0
34,-3,37,1,0,1
-53,-21,-32,0,0,0
-2,-30,28,1,0,1
73,37,36,1,0,1
-42,0,-42,0,0,0
-25,-33,8,1,0,1
-54,-34,-20,0,0,0
5,3,2,1,0,1
-26,-29,3,1,1,0
64,42,22,1,1,0
-16,-23,7,1,1,0
70,30,40,1,1,0
31,15,16,1,1,0
-57,-25,-32,0,1,1
-32,-9,-23,0,1,1
43,5,38,1,1,0
39,25,14,1,1,0
14,17,-3,0,1,1
-11,-19,8,1,1,0
48,20,28,1,1,0
51,17,34,1,0,1
32,44,-12,0,0,0
-55,-21,-34,0,0,0
49,33,16,1,0,1
-63,-32,-31,0,0,0
-25,-36,11,1,0,1
61,30,31,1,0,1
-7,-41,34,1,0,1
-20,-33,13,1,0,1
48,10,38,1,0,1
76,31,45,1,0,1
-59,-35,-24,0,0,0
-12,28,-40,0,0,0
53,27,26,1,0,1
41,24,17,1,0,1
-12,-5,-7,0,0,0
-32,-11,-21,0,0,0
-7,1,-8,0,0,0
26,43,-17,0,0,0
25,7,18,1,0,1
-6,-6,0,0,0,0
40,20,20,1,1,0
65,25,40,1,1,0
50,43,7,1,1,0
-31,-14,-17,0,1,1
-57,-27,-30,0,1,1
-32,12,-44,0,1,1
-45,-29,-16,0,1,1
55,32,23,1,1,0
-69,-44,-25,0,1,1
2,-21,23,1,1,0
23,-3,26,1,1,0
1,-43,44,1,1,0
-17,9,-26,0,1,1
54,30,24,1,0,1
-27,2,-29,0,0,0
61,43,18,1,0,1
-16,8,-24,0,0,0
0,-1,1,1,0,1
66,36,30,1,0,1
-1,43,-44,0,0,0
-19,22,-41,0,0,0
-46,-23,-23,0,0,0
-29,-11,-18,0,0,0
-37,-13,-24,0,0,0
70,29,41,1,0,1
57,44,13,1,0,1
49,20,29,1,0,1
11,14,-3,0,0,0
-8,-1,-7,0,0,0
67,28,39,1,0,1
-27,-9,-18,0,0,0
22,-16,38,1,1,0
-29,-44,15,1,1,0
16,10,6,1,1,0
-34,-23,-11,0,1,1
12,-5,17,1,1,0
-13,-22,9,1,1,0
-31,2,-33,0,1,1
28,30,-2,0,1,1
24,-8,32,1,1,0
6,10,-4,0,0,0
-22,0,-22,0,0,0
17,39,-22,0,0,0
-25,2,-27,0,0,0
17,12,5,1,0,1
-15,-9,-6,0,0,0
9,28,-19,0,0,0
-37,-32,-5,0,0,0
7,4,3,1,0,1
16,17,-1,0,0,0
-13,22,-35,0,0,0
-10,-34,24,1,0,1
-21,-11,-10,0,0,0
-48,-43,-5,0,0,0
73,31,42,1,0,1
3,1,2,1,0,1
18,31,-13,0,0,0
5,30,-25,0,0,0
27,6,21,1,0,1
15,41,-26,0,0,0
3,-21,24,1,0,1
9,-1,10,1,1,0
34,0,34,1,1,0
6,-20,26,1,1,0
-56,-24,-32,0,1,1
24,21,3,1,1,0
-62,-32,-30,0,1,1
-17,-7,-10,0,1,1
-32,-7,-25,0,1,1
16,29,-13,0,1,1
-13,-9,-4,0,1,1
23,-14,37,1,0,1
-13,-18,5,1,0,1
-8,26,-34,0,0,0
-22,15,-37,0,0,0
-15,29,-44,0,0,0
30,32,-2,0,0,0
-28,-9,-19,0,0,0
66,30,36,1,0,1
20,43,-23,0,0,0
-74,-34,-40,0,0,0
49,13,36,1,0,1
32,26,6,1,1,0
-14,-30,16,1,1,0
-1,38,-39,0,1,1
-23,-16,-7,0,1,1
9,-33,42,1,1,0
4,2,2,1,1,0
-15,-38,23,1,1,0
-7,10,-17,0,1,1
70,29,41,1,1,0
-10,-8,-2,0,1,1
-18,11,-29,0,1,1
72,39,33,1,1,0
63,38,25,1,0,1
-77,-37,-40,0,0,0
-11,-19,8,1,0,1
-69,-43,-26,0,0,0
40,43,-3,0,0,0
7,-9,16,1,0,1
17,-13,30,1,0,1
80,37,43,1,0,1
-22,21,-43,0,1,1
25,2,23,1,1,0
75,39,36,1,1,0
-5,-42,37,1,1,0
-16,10,-26,0,1,1
-70,-31,-39,0,1,1
26,31,-5,0,1,1
-15,-5,-10,0,1,1
17,34,-17,0,1,1
-70,-29,-41,0,0,0
-60,-18,-42,0,0,0
54,21,33,1,0,1
-49,-37,-12,0,0,0
-38,-24,-14,0,0,0
-59,-23,-36,0,0,0
10,31,-21,0,0,0
44,0,44,1,0,1
-33,4,-37,0,0,0
54,35,19,1,0,1
-55,-33,-22,0,0,0
-8,-30,22,1,0,1
-60,-29,-31,0,0,0
67,31,36,1,0,1
-20,-10,-10,0,0,0
-67,-43,-24,0,0,0
19,33,-14,0,0,0
-27,0,-27,0,0,0
36,-8,44,1,0,1
69,31,38,1,0,1
-20,-11,-9,0,1,1
-33,7,-40,0,1,1
-51,-30,-21,0,1,1
5,-28,33,1,1,0
23,7,16,1,1,0
29,29,0,0,1,1
-34,-31,-3,0,1,1
-21,10,-31,0,1,1
-29,-36,7,1,1,0
68,28,40,1,1,0
-4,-36,32,1,1,0
5,0,5,1,1,0
-36,5,-41,0,0,0
1,-44,45,1,0,1
32,7,25,1,0,1
-10,19,-29,0,0,0
65,43,22,1,0,1
37,37,0,0,0,0
-4,24,-28,0,0,0
-30,-26,-4,0,0,0
-27,15,-42,0,0,0
-62,-41,-21,0,0,0
-15,-23,8,1,0,1
-23,0,-23,0,0,0
-66,-31,-35,0,0,0
38,19,19,1,0,1
21,11,10,1,0,1
-33,-23,-10,0,0,0
74,43,31,1,0,1
79,37,42,1,0,1
-6,-21,15,1,0,1
-8,-21,13,1,0,1
66,44,22,1,0,1
28,3,25,1,1,0
13,30,-17,0,1,1
5,28,-23,0,1,1
-64,-35,-29,0,1,1
-61,-45,-16,0,1,1
48,38,10,1,1,0
-15,-31,16,1,1,0
-23,-39,16,1,1,0
8,-37,45,1,1,0
23,44,-21,0,1,1
24,0,24,1,1,0
-35,-16,-19,0,1,1
75,31,44,1,1,0
9,-19,28,1,0,1
-27,1,-28,0,0,0
40,39,1,1,0,1
-60,-45,-15,0,0,0
-51,-14,-37,0,0,0
29,26,3,1,0,1
31,-8,39,1,0,1
37,24,13,1,0,1
-32,-8,-24,0,0,0
-19,-10,-9,0,0,0
-33,-30,-3,0,0,0
-4,41,-45,0,0,0
43,16,27,1,0,1
-16,-26,10,1,0,1
-19,17,-36,0,0,0
-4,-24,20,1,0,1
13,-9,22,1,0,1
-16,-15,-1,0,0,0
-2,28,-30,0,0,0
-8,27,-35,0,0,0
46,8,38,1,0,1
-9,-23,14,1,1,0
45,38,7,1,1,0
23,-15,38,1,1,0
-16,12,-28,0,1,1
-65,-32,-33,0,1,1
-10,27,-37,0,1,1
-12,14,-26,0,1,1
19,26,-7,0,1,1
30,7,23,1,1,0
12,-1,13,1,1,0
-28,-20,-8,0,0,0
13,36,-23,0,0,0
56,38,18,1,0,1
28,42,-14,0,0,0
19,-17,36,1,0,1
48,23,25,1,0,1
44,20,24,1,0,1
52,26,26,1,0,1
-1,-15,14,1,0,1
-6,24,-30,0,0,0
-6,-9,3,1,0,1
-34,-32,-2,0,0,0
-28,-7,-21,0,0,0
37,33,4,1,0,1
2,-11,13,1,0,1
-25,-7,-18,0,0,0
1,18,-17,0,0,0
-33,-35,2,1,0,1
59,19,40,1,0,1
-26,8,-34,0,0,0
-2,40,-42,0,0,0
15,-1,16,1,1,0
24,-3,27,1,1,0
36,18,18,1,1,0
-1,9,-10,0,1,1
13,34,-21,0,1,1
-34,-17,-17,0,1,1
8,34,-26,0,1,1
-8,-39,31,1,1,0
-7,33,-40,0,0,0
-1,30,-31,0,0,0
-45,-42,-3,0,0,0
12,1,11,1,0,1
-53,-24,-29,0,0,0
13,41,-28,0,0,0
49,39,10,1,0,1
38,-7,45,1,0,1
13,31,-18,0,0,0
17,-19,36,1,0,1
16,-11,27,1,0,1
66,41,25,1,0,1
56,30,26,1,0,1
35,-7,42,1,0,1
-2,38,-40,0,0,0
44,23,21,1,0,1
42,10,32,1,0,1
35,29,6,1,0,1
-1,-26,25,1,0,1
-9,-8,-1,0,0,0
15,33,-18,0,0,0
4,10,-6,0,1,1
-50,-24,-26,0,1,1
9,16,-7,0,1,1
-53,-14,-39,0,1,1
-50,-5,-45,0,1,1
-15,-36,21,1,1,0
-47,-7,-40,0,1,1
64,23,41,1,1,0
26,32,-6,0,1,1
17,-5,22,1,1,0
21,4,17,1,1,0
47,19,28,1,1,0
-31,-37,6,1,1,0
-62,-32,-30,0,1,1
-7,-14,7,1,1,0
10,-34,44,1,1,0
43,0,43,1,1,0
3,16,-13,0,1,1
10,-4,14,1,1,0
19,37,-18,0,1,1
-40,4,-44,0,1,1
20,23,-3,0,0,0
-16,-5,-11,0,0,0
-45,-45,0,0,0,0
65,34,31,1,0,1
-5,25,-30,0,0,0
-14,28,-42,0,0,0
3,-4,7,1,0,1
16,0,16,1,0,1
-60,-33,-27,0,0,0
-13,27,-40,0,0,0
-5,-14,9,1,0,1
-35,9,-44,0,0,0
10,4,6,1,0,1
34,32,2,1,1,0
-38,-27,-11,0,1,1
73,43,30,1,1,0
7,42,-35,0,1,1
-11,-8,-3,0,1,1
-9,17,-26,0,1,1
-14,-3,-11,0,1,1
3,12,-9,0,1,1
4,40,-36,0,1,1
-21,-21,0,0,1,1
14,3,11,1,1,0
11,-31,42,1,1,0
-2,-36,34,1,1,0
16,25,-9,0,1,1
-42,-34,-8,0,0,0
65,33,32,1,0,1
-11,13,-24,0,0,0
-8,5,-13,0,0,0
-40,-13,-27,0,0,0
-29,-12,-17,0,0,0
-6,-20,14,1,0,1
-28,-8,-20,0,0,0
-51,-26,-25,0,0,0
-29,-4,-25,0,0,0
-38,-15,-23,0,0,0
67,32,35,1,0,1
41,18,23,1,0,1
-46,-9,-37,0,0,0
52,14,38,1,0,1
-54,-25,-29,0,0,0
44,25,19,1,0,1
10,-28,38,1,0,1
29,21,8,1,0,1
-11,-40,29,1,0,1
5,-37,42,1,0,1
56,18,38,1,1,0
-68,-23,-45,0,1,1
-15,23,-38,0,1,1
42,23,19,1,1,0
3,41,-38,0,1,1
-54,-23,-31,0,1,1
-28,-15,-13,0,1,1
8,2,6,1,1,0
-55,-32,-23,0,1,1
-21,17,-38,0,1,1
-2,3,-5,0,1,1
36,25,11,1,1,0
0,-29,29,1,1,0
-55,-17,-38,0,1,1
-3,42,-45,0,1,1
-20,-20,0,0,1,1
-5,17,-22,0,0,0
9,39,-30,0,0,0
-75,-36,-39,0,0,0
1,-16,17,1,0,1
-59,-18,-41,0,0,0
-42,-27,-15,0,0,0
-5,3,-8,0,0,0
48,6,42,1,0,1
-21,18,-39,0,0,0
-39,0,-39,0,0,0
-1,-45,44,1,0,1
-33,-24,-9,0,0,0
-16,-32,16,1,0,1
22,14,8,1,0,1
-35,-42,7,1,0,1
-4,10,-14,0,1,1
-20,-34,14,1,1,0
1,-13,14,1,1,0
-68,-32,-36,0,1,1
-38,-2,-36,0,1,1
-5,14,-19,0,1,1
6,44,-38,0,1,1
-27,-38,11,1,1,0
-3,22,-25,0,0,0
13,-27,40,1,0,1
11,-24,35,1,0,1
21,-2,23,1,0,1
9,44,-35,0,0,0
-17,-13,-4,0,0,0
-50,-23,-27,0,0,0
42,27,15,1,0,1
-22,-29,7,1,0,1
52,16,36,1,0,1
-20,-32,12,1,0,1
63,27,36,1,1,0
9,2,7,1,1,0
-73,-45,-28,0,1,1
-48,-9,-39,0,1,1
35,35,0,0,1,1
-34,-45,11,1,1,0
60,41,19,1,1,0
-7,3,-10,0,1,1
11,-34,45,1,1,0
17,-4,21,1,1,0
-43,-24,-19,0,1,1
-31,-24,-7,0,1,1
-2,9,-11,0,1,1
6,35,-29,0,1,1
35,40,-5,0,1,1
-59,-37,-22,0,1,1
27,-6,33,1,1,0
-47,-11,-36,0,1,1
-20,-21,1,1,1,0
-30,-25,-5,0,0,0
-24,-39,15,1,0,1
28,30,-2,0,0,0
-5,-14,9,1,0,1
26,-19,45,1,0,1
-37,0,-37,0,0,0
-5,26,-31,0,0,0
-9,-27,18,1,0,1
15,41,-26,0,1,1
-84,-45,-39,0,1,1
51,14,37,1,1,0
-18,-22,4,1,1,0
10,25,-15,0,1,1
17,32,-15,0,1,1
33,27,6,1,1,0
2,44,-42,0,1,1
16,-25,41,1,1,0
-56,-40,-16,0,1,1
-24,-42,18,1,1,0
84,40,44,1,1,0
-26,3,-29,0,1,1
41,41,0,0,0,0
21,-1,22,1,0,1
41,9,32,1,0,1
8,-15,23,1,0,1
10,-12,22,1,0,1
11,-28,39,1,0,1
8,15,-7,0,0,0
-3,-42,39,1,0,1
27,-6,33,1,0,1
33,30,3,1,0,1
-30,-35,5,1,0,1
-16,9,-25,0,0,0
64,34,30,1,0,1
-69,-34,-35,0,0,0
46,37,9,1,0,1
-54,-17,-37,0,0,0
-1,-15,14,1,0,1
-51,-18,-33,0,0,0
72,30,42,1,0,1
3,-23,26,1,0,1
39,35,4,1,0,1
-73,-42,-31,0,1,1
4,3,1,1,1,0
-22,-43,21,1,1,0
2,-5,7,1,1,0
-30,-39,9,1,1,0
-39,-14,-25,0,1,1
77,44,33,1,1,0
4,42,-38,0,1,1
4,18,-14,0,1,1
10,-13,23,1,1,0
-24,3,-27,0,1,1
31,18,13,1,1,0
-73,-39,-34,0,1,1
45,4,41,1,1,0
46,6,40,1,1,0
-46,-27,-19,0,1,1
8,35,-27,0,1,1
27,35,-8,0,1,1
-42,-21,-21,0,1,1
-27,16,-43,0,1,1
8,35,-27,0,1,1
-20,-33,13,1,0,1
-13,-34,21,1,0,1
9,11,-2,0,0,0
-28,9,-37,0,0,0
40,8,32,1,0,1
-72,-45,-27,0,0,0
-59,-15,-44,0,0,0
-23,10,-33,0,0,0
-5,27,-32,0,0,0
25,7,18,1,0,1
6,-8,14,1,0,1
-75,-30,-45,0,0,0
-10,12,-22,0,0,0
-10,9,-19,0,0,0
-72,-41,-31,0,1,1
29,-9,38,1,1,0
-11,-31,20,1,1,0
28,-11,39,1,1,0
2,31,-29,0,1,1
39,-3,42,1,1,0
35,23,12,1,1,0
-2,-8,6,1,1,0
8,-10,18,1,1,0
5,-19,24,1,1,0
13,-6,19,1,1,0
-3,-13,10,1,1,0
14,-12,26,1,1,0
-23,-17,-6,0,1,1
41,27,14,1,0,1
21,-4,25,1,0,1
-15,16,-31,0,0,0
23,28,-5,0,0,0
-6,1,-7,0,0,0
-35,-8,-27,0,0,0
36,-2,38,1,0,1
-17,-11,-6,0,0,0
-37,-43,6,1,1,0
13,-11,24,1,1,0
8,18,-10,0,1,1
-69,-43,-26,0,1,1
63,39,24,1,1,0
-38,-35,-3,0,1,1
60,43,17,1,1,0
-57,-36,-21,0,1,1
-52,-31,-21,0,1,1
-15,16,-31,0,1,1
22,41,-19,0,1,1
27,13,14,1,1,0
-56,-33,-23,0,1,1
33,5,28,1,0,1
-38,-20,-18,0,0,0
23,-20,43,1,0,1
60,36,24,1,0,1
36,41,-5,0,0,0
-4,41,-45,0,0,0
58,19,39,1,0,1
11,10,1,1,0,1
-37,-37,0,0,0,0
7,33,-26,0,0,0
-36,6,-42,0,0,0
45,37,8,1,0,1
26,10,16,1,0,1
73,28,45,1,1,0
-35,6,-41,0,1,1
-40,1,-41,0,1,1
-1,-37,36,1,1,0
-21,-26,5,1,1,0
2,32,-30,0,1,1
-25,-13,-12,0,1,1
-26,2,-28,0,1,1
-8,-18,10,1,1,0
8,-8,16,1,1,0
-62,-32,-30,0,1,1
10,18,-8,0,1,1
-5,-45,40,1,1,0
-53,-11,-42,0,1,1
-36,-35,-1,0,1,1
-60,-40,-20,0,1,1
10,-26,36,1,0,1
-3,30,-33,0,0,0
22,21,1,1,0,1
-6,-2,-4,0,0,0
-15,17,-32,0,0,0
-2,-37,35,1,0,1
61,16,45,1,0,1
-10,10,-20,0,0,0
52,35,17,1,0,1
53,35,18,1,0,1
-37,-29,-8,0,1,1
22,42,-20,0,1,1
-42,-4,-38,0,1,1
41,22,19,1,1,0
2,-23,25,1,1,0
1,-36,37,1,1,0
-29,-3,-26,0,1,1
-20,-14,-6,0,1,1
13,24,-11,0,1,1
-14,10,-24,0,1,1
-34,-28,-6,0,1,1
16,7,9,1,1,0
62,25,37,1,1,0
15,-27,42,1,1,0
36,-9,45,1,1,0
-32,-20,-12,0,1,1
1,10,-9,0,1,1
11,2,9,1,1,0
-3,-43,40,1,1,0
-17,-36,19,1,1,0
-12,11,-23,0,1,1
3,-1,4,1,0,1
-23,5,-28,0,0,0
-37,-42,5,1,0,1
13,35,-22,0,0,0
16,31,-15,0,0,0
-12,8,-20,0,0,0
24,-18,42,1,0,1
43,13,30,1,0,1
12,36,-24,0,0,0
65,39,26,1,0,1
29,21,8,1,0,1
27,-9,36,1,1,0
12,21,-9,0,1,1
13,-8,21,1,1,0
-5,18,-23,0,1,1
4,-7,11,1,1,0
-36,7,-43,0,1,1
-26,15,-41,0,1,1
-1,5,-6,0,1,1
-13,-13,0,0,1,1
-19,-27,8,1,0,1
-71,-31,-40,0,0,0
27,7,20,1,0,1
22,37,-15,0,0,0
2,-10,12,1,0,1
53,40,13,1,0,1
29,35,-6,0,0,0
-32,-29,-3,0,0,0
-12,-40,28,1,0,1
-7,-2,-5,0,0,0
-6,31,-37,0,0,0
-10,-40,30,1,0,1
-18,-16,-2,0,0,0
41,7,34,1,0,1
65,32,33,1,0,1
-2,-43,41,1,1,0
22,44,-22,0,1,1
61,27,34,1,1,0
56,21,35,1,1,0
28,-5,33,1,1,0
-61,-25,-36,0,1,1
-3,-44,41,1,1,0
-2,-13,11,1,1,0
3,4,-1,0,1,1
83,38,45,1,1,0
66,30,36,1,1,0
-1,-13,12,1,0,1
-40,-7,-33,0,0,0
-7,-19,12,1,0,1
-61,-28,-33,0,0,0
-24,-39,15,1,0,1
42,20,22,1,0,1
-24,-1,-23,0,0,0
-56,-26,-30,0,0,0
-28,-1,-27,0,0,0
30,-1,31,1,1,0
9,24,-15,0,1,1
-41,-19,-22,0,1,1
27,20,7,1,1,0
-45,-39,-6,0,1,1
-68,-40,-28,0,1,1
-8,23,-31,0,1,1
-25,17,-42,0,1,1
-28,15,-43,0,1,1
-21,-14,-7,0,1,1
-38,-37,-1,0,1,1
53,37,16,1,1,0
-1,19,-20,0,1,1
5,-37,42,1,1,0
-1,7,-8,0,1,1
59,27,32,1,1,0
20,21,-1,0,1,1
-26,10,-36,0,1,1
8,-24,32,1,1,0
22,22,0,0,1,1
-17,18,-35,0,1,1
-53,-15,-38,0,0,0
56,36,20,1,0,1
-16,-42,26,1,0,1
39,16,23,1,0,1
-43,-23,-20,0,0,0
-19,16,-35,0,0,0
-48,-14,-34,0,0,0
-41,-8,-33,0,0,0
44,3,41,1,0,1
-7,1,-8,0,0,0
40,25,15,1,0,1
-42,-30,-12,0,0,0
-36,-5,-31,0,0,0
-71,-29,-42,0,0,0
45,31,14,1,0,1
21,-12,33,1,0,1
51,33,18,1,0,1
-35,1,-36,0,0,0
11,32,-21,0,0,0
-44,-20,-24,0,0,0
18,16,2,1,0,1
23,-18,41,1,1,0
-4,-30,26,1,1,0
2,37,-35,0,1,1
2,40,-38,0,1,1
-15,-3,-12,0,1,1
-47,-10,-37,0,1,1
50,37,13,1,1,0
-36,-38,2,1,1,0
-79,-40,-39,0,1,1
-38,-1,-37,0,1,1
-45,-10,-35,0,1,1
23,10,13,1,1,0
12,16,-4,0,1,1
56,33,23,1,1,0
10,-14,24,1,1,0
4,-24,28,1,1,0
60,24,36,1,1,0
47,20,27,1,0,1
60,28,32,1,0,1
-34,-2,-32,0,0,0
23,34,-11,0,0,0
-83,-43,-40,0,0,0
15,-30,45,1,0,1
19,-10,29,1,0,1
46,7,39,1,0,1
-14,-12,-2,0,0,0
20,-18,38,1,0,1
65,24,41,1,1,0
33,8,25,1,1,0
6,43,-37,0,1,1
19,-5,24,1,1,0
63,18,45,1,1,0
11,-32,43,1,1,0
-70,-34,-36,0,1,1
-70,-26,-44,0,1,1
20,2,18,1,1,0
16,-18,34,1,1,0
5,39,-34,0,0,0
-1,44,-45,0,0,0
-54,-17,-37,0,0,0
-3,-10,7,1,0,1
32,44,-12,0,0,0
7,8,-1,0,0,0
4,-6,10,1,0,1
-20,16,-36,0,0,0
24,-13,37,1,0,1
64,25,39,1,0,1
76,36,40,1,0,1
-61,-17,-44,0,0,0
19,8,11,1,0,1
-17,-25,8,1,0,1
-7,18,-25,0,0,0
17,-8,25,1,0,1
2,-34,36,1,0,1
39,0,39,1,0,1
-34,-12,-22,0,0,0
1,26,-25,0,0,0
2,20,-18,0,0,0
-3,36,-39,0,1,1
2,12,-10,0,1,1
35,25,10,1,1,0
19,-26,45,1,1,0
12,-13,25,1,1,0
10,-30,40,1,1,0
34,37,-3,0,1,1
-27,-9,-18,0,1,1
-11,18,-29,0,1,1
-27,-24,-3,0,1,1
-8,16,-24,0,1,1
-22,-30,8,1,1,0
9,23,-14,0,1,1
-12,25,-37,0,1,1
-43,-24,-19,0,0,0
-54,-21,-33,0,0,0
51,29,22,1,0,1
-4,37,-41,0,0,0
-51,-32,-19,0,0,0
-19,-20,1,1,0,1
-2,6,-8,0,0,0
22,12,10,1,0,1
46,29,17,1,0,1
-78,-38,-40,0,0,0
62,24,38,1,0,1
14,13,1,1,0,1
0,-35,35,1,1,0
-26,-14,-12,0,1,1
-67,-22,-45,0,1,1
-9,16,-25,0,1,1
-25,-27,2,1,1,0
7,12,-5,0,1,1
-51,-39,-12,0,1,1
-41,4,-45,0,1,1
-8,-39,31,1,1,0
10,-5,15,1,1,0
5,-21,26,1,1,0
13,-13,26,1,1,0
-29,-17,-12,0,1,1
-4,-38,34,1,1,0
41,38,3,1,1,0
-73,-42,-31,0,1,1
66,37,29,1,1,0
-21,-45,24,1,1,0
22,-17,39,1,1,0
57,44,13,1,1,0
-56,-39,-17,0,1,1
-1,-12,11,1,0,1
-1,33,-34,0,0,0
6,-21,27,1,0,1
9,25,-16,0,0,0
49,19,30,1,0,1
-8,-13,5,1,0,1
-17,-32,15,1,0,1
45,4,41,1,0,1
15,-28,43,1,0,1
-7,-39,32,1,0,1
-51,-31,-20,0,0,0
-28,3,-31,0,0,0
-6,-17,11,1,0,1
3,-16,19,1,0,1
-37,-9,-28,0,0,0
51,41,10,1,0,1
29,-16,45,1,0,1
1,0,1,1,0,1
-1,-28,27,1,0,1
3,-9,12,1,0,1
-41,2,-43,0,0,0
2,-36,38,1,1,0
-64,-30,-34,0,1,1
-85,-44,-41,0,1,1
-55,-22,-33,0,1,1
66,27,39,1,1,0
50,38,12,1,1,0
-23,22,-45,0,1,1
65,32,33,1,1,0
14,-5,19,1,1,0
25,-13,38,1,1,0
-54,-15,-39,0,0,0
-22,-17,-5,0,0,0
-19,-36,17,1,0,1
28,-1,29,1,0,1
56,33,23,1,0,1
40,39,1,1,0,1
2,8,-6,0,0,0
11,7,4,1,0,1
-54,-19,-35,0,0,0
-41,-4,-37,0,0,0
2,26,-24,0,0,0
45,1,44,1,0,1
0,28,-28,0,0,0
68,43,25,1,0,1
27,-8,35,1,0,1
-30,-20,-10,0,1,1
78,39,39,1,1,0
-22,6,-28,0,1,1
19,-12,31,1,1,0
-32,-5,-27,0,1,1
2,-10,12,1,1,0
21,36,-15,0,1,1
-46,-33,-13,0,1,1
-54,-24,-30,0,1,1
21,32,-11,0,1,1
3,31,-28,0,1,1
5,6,-1,0,1,1
9,-19,28,1,1,0
59,39,20,1,0,1
19,44,-25,0,0,0
-13,-37,24,1,0,1
-43,-7,-36,0,0,0
31,37,-6,0,0,0
5,-8,13,1,0,1
31,9,22,1,0,1
-37,3,-40,0,0,0
-43,-30,-13,0,1,1
61,19,42,1,1,0
-6,1,-7,0,1,1
69,32,37,1,1,0
4,14,-10,0,1,1
-6,23,-29,0,1,1
1,11,-10,0,1,1
-44,-3,-41,0,1,1
33,0,33,1,1,0
-39,-5,-34,0,1,1
48,15,33,1,0,1
-32,2,-34,0,0,0
-59,-30,-29,0,0,0
-17,-5,-12,0,0,0
-44,-29,-15,0,0,0
-80,-36,-44,0,0,0
-18,-4,-14,0,0,0
-3,36,-39,0,0,0
20,19,1,1,0,1
-30,-40,10,1,0,1
-11,25,-36,0,0,0
69,40,29,1,0,1
-28,12,-40,0,1,1
-54,-26,-28,0,1,1
36,8,28,1,1,0
-61,-38,-23,0,1,1
-19,15,-34,0,1,1
45,32,13,1,1,0
-24,-3,-21,0,1,1
-64,-29,-35,0,1,1
-2,14,-16,0,1,1
-23,17,-40,0,1,1
-4,-16,12,1,1,0
-52,-42,-10,0,1,1
52,39,13,1,1,0
-46,-20,-26,0,1,1
-10,-20,10,1,0,1
-56,-17,-39,0,0,0
-19,3,-22,0,0,0
47,25,22,1,0,1
-17,-11,-6,0,0,0
4,40,-36,0,0,0
38,31,7,1,0,1
-37,-12,-25,0,0,0
4,-32,36,1,0,1
-21,23,-44,0,0,0
32,43,-11,0,0,0
-46,-32,-14,0,0,0
-43,-18,-25,0,0,0
49,32,17,1,0,1
5,-18,23,1,0,1
9,-16,25,1,0,1
10,44,-34,0,0,0
-26,-1,-25,0,0,0
-37,-37,0,0,0,0
-62,-33,-29,0,1,1
25,7,18,1,1,0
25,-16,41,1,1,0
4,32,-28,0,1,1
-25,-17,-8,0,1,1
-3,-42,39,1,1,0
58,24,34,1,1,0
28,34,-6,0,1,1
9,23,-14,0,1,1
-8,8,-16,0,1,1
22,37,-15,0,1,1
-79,-40,-39,0,1,1
40,-4,44,1,1,0
2,17,-15,0,1,1
30,40,-10,0,1,1
47,2,45,1,1,0
36,-1,37,1,1,0
8,-20,28,1,1,0
2,42,-40,0,1,1
-7,-18,11,1,1,0
-10,-33,23,1,0,1
-58,-40,-18,0,0,0
7,-21,28,1,0,1
-34,-2,-32,0,0,0
-39,-8,-31,0,0,0
-67,-29,-38,0,0,0
-22,-16,-6,0,0,0
38,-5,43,1,0,1
7,-35,42,1,0,1
14,-9,23,1,0,1
75,42,33,1,0,1
71,40,31,1,0,1
0,44,-44,0,0,0
24,19,5,1,0,1
39,20,19,1,0,1
45,42,3,1,0,1
-22,-5,-17,0,0,0
37,9,28,1,0,1
44,33,11,1,0,1
13,-17,30,1,0,1
-2,30,-32,0,0,0
83,38,45,1,1,0
-24,-40,16,1,1,0
27,40,-13,0,1,1
19,29,-10,0,1,1
47,39,8,1,1,0
-1,-38,37,1,1,0
42,12,30,1,1,0
-23,-31,8,1,1,0
52,9,43,1,1,0
38,19,19,1,1,0
-34,3,-37,0,1,1
6,-34,40,1,0,1
23,16,7,1,0,1
43,41,2,1,0,1
75,33,42,1,0,1
3,14,-11,0,0,0
-72,-38,-34,0,0,0
24,-7,31,1,0,1
2,-25,27,1,0,1
-7,1,-8,0,0,0
30,41,-11,0,0,0
-25,-3,-22,0,0,0
0,0,0,0,0,0
48,13,35,1,0,1
-74,-39,-35,0,0,0
-21,3,-24,0,0,0
21,35,-14,0,0,0
5,-37,42,1,0,1
-45,-15,-30,0,0,0
36,36,0,0,0,0
23,7,16,1,0,1
27,14,13,1,0,1
-21,5,-26,0,1,1
19,30,-11,0,1,1
-2,-33,31,1,1,0
-11,2,-13,0,1,1
-2,-4,2,1,1,0
36,11,25,1,1,0
-43,-18,-25,0,1,1
48,28,20,1,1,0
-55,-23,-32,0,0,0
-32,3,-35,0,0,0
-11,-15,4,1,0,1
10,-11,21,1,0,1
-22,-17,-5,0,0,0
53,10,43,1,0,1
-12,11,-23,0,0,0
54,29,25,1,0,1
-71,-39,-32,0,0,0
-12,7,-19,0,0,0
41,-3,44,1,0,1
-56,-39,-17,0,0,0
57,37,20,1,1,0
61,27,34,1,1,0
67,36,31,1,1,0
1,19,-18,0,1,1
-28,-35,7,1,1,0
-30,-19,-11,0,1,1
48,18,30,1,1,0
10,37,-27,0,1,1
-9,-40,31,1,0,1
8,4,4,1,0,1
55,14,41,1,0,1
17,43,-26,0,0,0
-4,-14,10,1,0,1
-7,37,-44,0,0,0
-11,21,-32,0,0,0
48,32,16,1,0,1
-12,7,-19,0,0,0
65,32,33,1,0,1
-28,17,-45,0,1,1
-15,-30,15,1,1,0
10,-8,18,1,1,0
41,13,28,1,1,0
25,8,17,1,1,0
4,12,-8,0,1,1
-26,-43,17,1,1,0
-8,-13,5,1,1,0
34,9,25,1,1,0
63,31,32,1,1,0
-46,-45,-1,0,1,1
-37,-37,0,0,1,1
-8,0,-8,0,1,1
-58,-32,-26,0,1,1
-4,36,-40,0,1,1
-6,-26,20,1,1,0
-16,21,-37,0,1,1
25,38,-13,0,1,1
9,27,-18,0,1,1
39,42,-3,0,1,1
9,33,-24,0,1,1
-11,6,-17,0,0,0
-8,-21,13,1,0,1
6,-35,41,1,0,1
25,13,12,1,0,1
21,-17,38,1,0,1
-43,-22,-21,0,0,0
11,-7,18,1,0,1
-24,-1,-23,0,0,0
-41,-34,-7,0,0,0
-27,-40,13,1,1,0
7,-28,35,1,1,0
-7,-5,-2,0,1,1
-50,-13,-37,0,1,1
-81,-39,-42,0,1,1
39,18,21,1,1,0
47,22,25,1,1,0
-1,18,-19,0,1,1
-39,-36,-3,0,1,1
-23,-25,2,1,1,0
0,-5,5,1,0,1
41,25,16,1,0,1
31,8,23,1,0,1
32,6,26,1,0,1
-28,-19,-9,0,0,0
77,37,40,1,0,1
-6,-5,-1,0,0,0
67,30,37,1,0,1
-8,33,-41,0,0,0
-38,-40,2,1,0,1
21,-6,27,1,0,1
12,22,-10,0,0,0
2,9,-7,0,0,0
-17,-11,-6,0,0,0
-12,18,-30,0,0,0
-35,-32,-3,0,0,0
-75,-30,-45,0,0,0
-18,-14,-4,0,0,0
46,3,43,1,0,1
-17,-17,0,0,0,0
65,42,23,1,0,1
-19,-13,-6,0,1,1
-38,-32,-6,0,1,1
12,2,10,1,1,0
-21,-43,22,1,1,0
-13,21,-34,0,1,1
26,-7,33,1,1,0
32,30,2,1,1,0
-51,-16,-35,0,1,1
22,37,-15,0,1,1
-37,2,-39,0,1,1
19,18,1,1,1,0
-41,-41,0,0,1,1
71,42,29,1,1,0
-25,-38,13,1,1,0
26,-9,35,1,1,0
68,44,24,1,1,0
1,-18,19,1,1,0
-77,-43,-34,0,1,1
49,29,20,1,1,0
-2,-15,13,1,1,0
-5,-37,32,1,1,0
77,42,35,1,0,1
-7,-16,9,1,0,1
1,40,-39,0,0,0
-4,-9,5,1,0,1
38,28,10,1,0,1
31,-5,36,1,0,1
33,34,-1,0,0,0
22,42,-20,0,0,0
-40,-16,-24,0,0,0
25,-18,43,1,0,1
-44,-45,1,1,0,1
-16,-9,-7,0,0,0
-3,35,-38,0,0,0
-67,-41,-26,0,0,0
-42,-26,-16,0,0,0
43,34,9,1,0,1
-13,-24,11,1,0,1
-13,-32,19,1,0,1
-78,-36,-42,0,0,0
45,15,30,1,0,1
-35,-2,-33,0,0,0
-37,-18,-19,0,1,1
-9,33,-42,0,1,1
-8,-11,3,1,1,0
59,29,30,1,1,0
-35,-4,-31,0,1,1
-41,-44,3,1,1,0
-20,-37,17,1,1,0
47,33,14,1,1,0
-14,-23,9,1,1,0
-18,-28,10,1,1,0
53,23,30,1,1,0
-14,16,-30,0,1,1
-9,-34,25,1,1,0
23,26,-3,0,1,1
32,34,-2,0,0,0
-69,-45,-24,0,0,0
13,-29,42,1,0,1
-71,-37,-34,0,0,0
-29,-2,-27,0,0,0
-25,-6,-19,0,0,0
-63,-29,-34,0,0,0
-3,-15,12,1,0,1
9,24,-15,0,0,0
-42,-33,-9,0,0,0
-60,-40,-20,0,0,0
-42,3,-45,0,0,0
39,17,22,1,0,1
51,16,35,1,0,1
2,-37,39,1,1,0
42,12,30,1,1,0
32,40,-8,0,1,1
-11,31,-42,0,1,1
-8,-3,-5,0,1,1
-28,-36,8,1,1,0
-68,-32,-36,0,1,1
65,41,24,1,1,0
-12,22,-34,0,0,0
-5,16,-21,0,0,0
55,31,24,1,0,1
-21,-10,-11,0,0,0
30,16,14,1,0,1
-17,-5,-12,0,0,0
-4,16,-20,0,0,0
-54,-32,-22,0,0,0
48,17,31,1,0,1
20,1,19,1,1,0
2,38,-36,0,1,1
-32,-31,-1,0,1,1
-17,-19,2,1,1,0
-12,25,-37,0,1,1
-12,-37,25,1,1,0
-71,-26,-45,0,1,1
-8,12,-20,0,1,1
49,22,27,1,1,0
-35,-39,4,1,1,0
15,34,-19,0,1,1
-73,-31,-42,0,1,1
-90,-45,-45,0,1,1
29,23,6,1,1,0
-34,-1,-33,0,1,1
57,30,27,1,1,0
33,-6,39,1,1,0
-38,4,-42,0,1,1
18,4,14,1,1,0
-18,-4,-14,0,1,1
-42,-18,-24,0,1,1
-4,-13,9,1,0,1
-15,26,-41,0,0,0
24,-13,37,1,0,1
-29,-28,-1,0,0,0
71,41,30,1,0,1
6,30,-24,0,0,0
-37,-43,6,1,0,1
-21,-16,-5,0,0,0
-59,-20,-39,0,0,0
2,5,-3,0,0,0
25,5,20,1,0,1
8,-12,20,1,0,1
10,-12,22,1,0,1
29,-12,41,1,0,1
43,1,42,1,0,1
20,-2,22,1,1,0
-8,-40,32,1,1,0
45,14,31,1,1,0
-4,37,-41,0,1,1
-31,-10,-21,0,1,1
56,15,41,1,1,0
7,-10,17,1,1,0
-29,12,-41,0,1,1
-53,-37,-16,0,1,1
-37,-4,-33,0,1,1
8,3,5,1,1,0
43,36,7,1,1,0
13,5,8,1,1,0
-21,-33,12,1,1,0
-54,-26,-28,0,0,0
-3,-21,18,1,0,1
-36,8,-44,0,0,0
33,-1,34,1,0,1
-75,-32,-43,0,0,0
70,26,44,1,0,1
46,34,12,1,0,1
8,-21,29,1,0,1
48,32,16,1,0,1
-2,37,-39,0,0,0
-2,41,-43,0,0,0
50,19,31,1,0,1
-83,-41,-42,0,1,1
30,37,-7,0,1,1
-13,-16,3,1,1,0
23,-11,34,1,1,0
5,-30,35,1,1,0
62,23,39,1,1,0
-42,-38,-4,0,1,1
18,0,18,1,1,0
53,37,16,1,1,0
41,-1,42,1,1,0
-63,-24,-39,0,1,1
37,-7,44,1,1,0
41,43,-2,0,1,1
-29,7,-36,0,1,1
-27,-7,-20,0,1,1
83,40,43,1,1,0
89,44,45,1,1,0
0,-39,39,1,1,0
-4,11,-15,0,0,0
-22,-21,-1,0,0,0
19,35,-16,0,0,0
-41,-44,3,1,0,1
-71,-40,-31,0,0,0
60,20,40,1,0,1
-73,-40,-33,0,0,0
-6,-1,-5,0,0,0
42,26,16,1,1,0
-43,-21,-22,0,1,1
-24,13,-37,0,1,1
4,40,-36,0,1,1
35,3,32,1,1,0
-74,-35,-39,0,1,1
3,-19,22,1,1,0
29,5,24,1,1,0
-49,-26,-23,0,1,1
-31,5,-36,0,1,1
-55,-14,-41,0,1,1
-43,-31,-12,0,1,1
11,0,11,1,1,0
-50,-20,-30,0,1,1
73,43,30,1,1,0
-40,-30,-10,0,1,1
6,-25,31,1,0,1
28,43,-15,0,0,0
3,-31,34,1,0,1
-4,-23,19,1,0,1
15,34,-19,0,0,0
6,1,5,1,0,1
26,-6,32,1,0,1
-20,-29,9,1,0,1
-36,-34,-2,0,0,0
12,-24,36,1,0,1
16,23,-7,0,0,0
18,-2,20,1,0,1
51,39,12,1,0,1
-19,-34,15,1,0,1
-58,-15,-43,0,0,0
52,24,28,1,0,1
26,40,-14,0,0,0
58,29,29,1,0,1
33,22,11,1,0,1
-45,-10,-35,0,0,0
-29,9,-38,0,0,0
46,25,21,1,1,0
-9,20,-29,0,1,1
6,-1,7,1,1,0
36,32,4,1,1,0
4,-35,39,1,1,0
-11,-40,29,1,1,0
-37,-3,-34,0,1,1
-17,-32,15,1,1,0
35,14,21,1,0,1
-66,-25,-41,0,0,0
-52,-44,-8,0,0,0
-52,-20,-32,0,0,0
-20,19,-39,0,0,0
-50,-11,-39,0,0,0
-49,-30,-19,0,0,0
-25,-4,-21,0,0,0
-5,-24,19,1,0,1
7,-22,29,1,0,1
25,20,5,1,0,1
-84,-43,-41,0,1,1
74,43,31,1,1,0
1,14,-13,0,1,1
-66,-32,-34,0,1,1
34,-10,44,1,1,0
5,37,-32,0,1,1
-58,-18,-40,0,1,1
-45,-33,-12,0,1,1
21,-20,41,1,0,1
-6,28,-34,0,0,0
26,5,21,1,0,1
-35,7,-42,0,0,0
62,36,26,1,0,1
-20,-31,11,1,0,1
-58,-22,-36,0,0,0
30,26,4,1,0,1
56,33,23,1,0,1
30,-3,33,1,0,1
-36,-4,-32,0,0,0
-20,-28,8,1,0,1
-13,-41,28,1,0,1
60,44,16,1,1,0
41,28,13,1,1,0
-35,-31,-4,0,1,1
38,31,7,1,1,0
-74,-35,-39,0,1,1
0,-40,40,1,1,0
32,44,-12,0,1,1
15,3,12,1,1,0
46,24,22,1,1,0
-75,-41,-34,0,1,1
26,20,6,1,1,0
-37,-6,-31,0,1,1
16,-25,41,1,1,0
-42,-42,0,0,1,1
6,-4,10,1,1,0
-5,-40,35,1,1,0
73,40,33,1,1,0
24,-14,38,1,0,1
-7,36,-43,0,0,0
-21,19,-40,0,0,0
-46,-14,-32,0,0,0
14,10,4,1,0,1
7,-2,9,1,0,1
-58,-38,-20,0,0,0
60,26,34,1,0,1
-38,4,-42,0,0,0
36,35,1,1,0,1
44,13,31,1,1,0
18,-26,44,1,1,0
28,-15,43,1,1,0
-35,3,-38,0,1,1
-26,-31,5,1,1,0
-8,-34,26,1,1,0
74,41,33,1,1,0
-14,16,-30,0,1,1
13,-21,34,1,1,0
-40,-5,-35,0,1,1
-46,-42,-4,0,1,1
41,21,20,1,1,0
14,-14,28,1,1,0
-19,-44,25,1,0,1
17,-25,42,1,0,1
-34,-9,-25,0,0,0
-7,-21,14,1,0,1
51,24,27,1,0,1
-22,-34,12,1,0,1
-46,-40,-6,0,0,0
-49,-33,-16,0,0,0
25,5,20,1,0,1
6,-9,15,1,0,1
-7,-4,-3,0,0,0
-17,-36,19,1,0,1
-11,17,-28,0,1,1
47,24,23,1,1,0
-3,-37,34,1,1,0
-69,-35,-34,0,1,1
-37,5,-42,0,1,1
-36,0,-36,0,1,1
42,10,32,1,1,0
-16,-21,5,1,1,0
36,25,11,1,1,0
35,-5,40,1,1,0
-22,19,-41,0,1,1
63,18,45,1,1,0
31,-4,35,1,0,1
-30,-33,3,1,0,1
-23,-28,5,1,0,1
8,-35,43,1,0,1
-11,33,-44,0,0,0
18,23,-5,0,0,0
45,22,23,1,0,1
57,31,26,1,0,1
-27,16,-43,0,1,1
64,36,28,1,1,0
48,44,4,1,1,0
-55,-17,-38,0,1,1
-61,-23,-38,0,1,1
-54,-14,-40,0,1,1
43,31,12,1,1,0
22,-13,35,1,1,0
17,26,-9,0,1,1
6,27,-21,0,1,1
-73,-39,-34,0,1,1
29,-2,31,1,1,0
6,-14,20,1,0,1
32,34,-2,0,0,0
5,-23,28,1,0,1
36,32,4,1,0,1
-1,-22,21,1,0,1
12,39,-27,0,0,0
25,-7,32,1,0,1
8,-4,12,1,0,1
-54,-9,-45,0,0,0
-25,-9,-16,0,0,0
-30,9,-39,0,0,0
-4,27,-31,0,0,0
14,-11,25,1,0,1
-5,21,-26,0,0,0
31,2,29,1,0,1
44,41,3,1,0,1
17,-2,19,1,0,1
16,17,-1,0,0,0
-57,-42,-15,0,0,0
-19,-11,-8,0,0,0
13,-21,34,1,0,1
-37,8,-45,0,1,1
58,19,39,1,1,0
16,7,9,1,1,0
